category_list,funding_total_usd,country_code,funding_rounds,Num_of_investor,funding_duration,first_funding_at_UTC,last_funding_at_UTC,label
Curated Web,2000000.0,CHN,1,1,0,13957,13957,0
Games,41250.0,HKG,1,1,0,16252,16252,0
Analytics,33600000.0,USA,4,14,1040,15708,16748,0
Mobile,1150050.0,USA,3,13,931,15175,16106,0
E-Commerce,40000.0,CHL,1,1,0,15754,15754,0
Apps|Cable|Distribution|Software,5000000.0,USA,1,1,0,16511,16511,1
Search,40000.0,USA,1,1,0,15209,15209,0
Art|E-Commerce|Marketplaces,500000.0,USA,1,3,0,14379,14379,1
Curated Web,2535000.0,USA,2,13,411,14610,15021,1
Curated Web,6795451.0,USA,9,13,2221,14531,16752,0
Local Businesses|Restaurants,10661772.8991108,FRA,5,17,1054,15689,16743,0
Cosmetics|Marketplaces,8900000.0,FRA,1,5,0,16625,16625,0
Games|Media,10000000.0,CHN,3,4,1307,14975,16282,0
Hospitality,3000000.0,CHN,2,2,949,13885,14834,0
Education,4500000.0,CHN,2,2,243,13149,13392,0
Health Care|Health Care Information Technology|Hospitals,4000000.0,USA,2,6,328,16400,16728,0
Analytics,1250000.0,USA,2,4,28,15280,15308,1
Software,35000000.0,USA,1,1,0,14676,14676,1
E-Commerce|Mobile Commerce|Social Commerce,1600000.0,USA,2,2,189,16009,16198,0
Biotechnology|Technology,55000000.0,USA,1,3,0,16447,16447,0
Social Travel,20000000.0,CHN,1,1,0,16188,16188,0
Enterprise Software,1800000.0,USA,1,1,0,15055,15055,0
Health and Wellness|Personal Health,935000.0,USA,1,5,0,16400,16400,0
Audio|Mobile|Music,440000.0,AUS,3,3,425,15461,15886,0
Health Diagnostics|Medical Devices|Personalization|Pharmaceuticals|Politics|Software|Technology,794000.0,USA,6,7,695,15376,16071,0
E-Commerce|SaaS,1000000.0,ROM,2,1,1992,14610,16602,0
Software,378812.0,GBR,1,1,0,16147,16147,0
Publishing|Services,130636.0,FRA,1,1,0,15414,15414,0
Mobile|Service Providers|Software,1809056.0,KOR,1,1,0,16415,16415,0
Manufacturing,71450000.0,USA,9,19,2569,13965,16534,0
Augmented Reality|Computer Vision|Games|iPad|Mobile,700000.0,SWE,1,1,0,15506,15506,1
Advertising|Big Data Analytics|Interest Graph,5500000.0,USA,2,6,666,14426,15092,0
Advertising|Entertainment|Real Time|Social Media|Sports|Video,500000.0,USA,1,1,0,14734,14734,0
Software,3400000.0,USA,3,14,1005,15340,16345,0
Public Transportation,16000000.0,CHN,1,2,0,16591,16591,0
Software,14000000.0,USA,1,1,0,11793,11793,1
Internet,5250000.0,USA,2,2,239,16484,16723,0
Travel,84440319.0,CHN,3,5,2239,13879,16118,0
Education|Language Learning,135000000.0,USA,5,15,1510,14975,16485,0
Finance|FinTech,9478511.0,CHN,3,3,2738,13149,15887,0
Clean Technology|Residential Solar,5000000.0,USA,1,1,0,14651,14651,0
Games|Software|Video Games,200000000.0,RUS,1,1,0,15250,15250,0
Health Care|Insurance|Medical,2500000.0,USA,1,1,0,16552,16552,0
Geospatial|Maps|Outdoors,40000.0,NOR,1,1,0,15441,15441,0
Health and Wellness|Health Care|Internet|SMS,37639.0,COL,1,1,0,16211,16211,0
Doctors|Health Care|Health Care Information Technology|Video|Video Chat,1700000.0,USA,2,13,1441,15196,16637,1
Health and Wellness|Mobile Health,2100000.0,USA,3,5,760,15775,16535,0
E-Commerce,4163132.0,CHN,2,3,380,15949,16329,0
Health and Wellness|Health Care|Services,30000000.0,USA,1,5,0,15785,15785,0
Social Media,500000.0,USA,1,2,0,15922,15922,0
Financial Services|FinTech,10000000.0,USA,1,2,0,16197,16197,0
E-Commerce,117000000.0,USA,5,7,1406,15281,16687,0
E-Commerce,750000.0,USA,1,1,0,15614,15614,0
Analytics|Big Data|Enterprise Software|Market Research|Mobile|Software,4000000.0,USA,3,6,772,15888,16660,0
Games,1660000.0,FRA,1,2,0,14049,14049,0
Design|Health and Wellness|Health Care|Hospitals|Medical Devices,204189.0,BEL,1,3,0,16246,16246,0
Biotechnology|Health Diagnostics,4345427.0,USA,3,1,1130,15608,16738,0
Mobile,29750000.0,IRL,1,1,0,14064,14064,0
News,51507046.0,USA,7,9,1943,14826,16769,0
Curated Web|Education|Parenting|Publishing,1236454.0,ITA,3,7,563,15659,16222,0
Technology,2220000.0,USA,2,5,151,16405,16556,0
Art|E-Commerce|Social Commerce,2800000.0,USA,2,17,304,14518,14822,0
Advertising|Direct Marketing|Social Media,50000.0,USA,2,1,0,15706,15706,0
Delivery|Hospitality|Manufacturing,1464128.0,CHN,1,2,0,14631,14631,0
E-Commerce,6369507.0,IND,1,2,0,15659,15659,0
Big Data|Bitcoin|Hardware + Software|Technology,121050000.0,USA,2,10,478,16026,16504,0
Software,2580000.0,SWE,1,1,0,13241,13241,0
Software|Web Hosting,396000000.0,CHN,5,8,2486,13922,16408,1
Android|Apps|Internet|iPhone|Mobile|Sales and Marketing|Software|Web Development|Web Tools,250000.0,ISR,1,1,0,15993,15993,0
Software,1610541.0,CHN,2,1,153,14730,14883,0
Mobile,615000.0,SGP,1,1,0,14985,14985,0
Biotechnology|Search,227049900.0,USA,8,23,3530,13089,16619,0
Blogging Platforms|Software,50000.0,CAN,1,3,0,15201,15201,0
Finance,3452941.0,USA,3,2,422,14907,15329,0
News,1209701.0,SWE,2,2,122,14123,14245,0
EdTech|Education|Systems,4000000.0,IND,1,1,0,13823,13823,0
Hardware + Software,600000.0,USA,1,3,0,15649,15649,0
Internet,2000000.0,NLD,1,1,0,16535,16535,0
Clean Technology,16000000.0,USA,1,3,0,14837,14837,0
Software,50000.0,USA,1,1,0,15118,15118,0
Software|Textbooks,2942768.88931116,ESP,3,3,938,14902,15840,0
Services,1856561.0,CHN,2,2,199,16066,16265,0
DIY|Electronics|Software,25000.0,USA,1,1,0,14635,14635,0
Software,2000000.0,CHN,1,1,0,12753,12753,0
E-Commerce|Finance|Marketplaces,118000.0,USA,1,1,0,15477,15477,0
Presentations|Software,250000.0,USA,2,4,60,13879,13939,1
E-Commerce|Mobile Commerce|Payments|Software,10000000.0,SGP,3,4,1577,14975,16552,0
Credit Cards|Mobile,8300000.0,RUS,3,8,1173,15584,16757,0
E-Commerce,72000000.0,USA,2,3,426,16267,16693,0
Clean Technology,474116.56105524,GBR,4,2,0,16367,16367,0
Discounts|Entertainment|Internet|Ticketing,33457.0,FRA,1,1,0,14791,14791,0
Curated Web,966728.0,BEL,2,3,459,15194,15653,0
Internet of Things|M2M|Software,4000000.0,USA,1,1,0,16444,16444,1
Application Platforms|Health and Wellness|Mobile|Mobile Health|Software,300000.0,USA,2,1,305,16205,16510,0
Software,85000000.0,USA,1,1,0,12872,12872,1
Cloud Infrastructure|Corporate IT|Enterprise Software,37644420.0,USA,4,5,1043,15314,16357,0
Landscaping|Natural Resources,20000.0,USA,1,1,0,15795,15795,0
SaaS|Technology|Telecommunications,3167062.0,IRL,1,1,0,11992,11992,0
Curated Web|Online Dating|Social Network Media,2300000.0,USA,1,6,0,16358,16358,0
Messaging,939000.0,USA,1,1,0,13818,13818,0
EdTech|Education|Software,95875000.0,USA,6,24,1671,14328,15999,1
Curated Web,162000000.0,USA,5,24,1288,10896,12184,1
Biotechnology,128477567.0,USA,7,13,2856,13655,16511,0
Apps|Creative|Design|Finance|Mobile|Photography|Software,25000.0,USA,1,1,0,15845,15845,0
Advertising|Advertising Platforms|Content Discovery|Internet|Social Media|Social Media Platforms|Social Network Media,25654560.0,USA,5,17,1259,14281,15540,0
Information Technology|Retail|Software,15000000.0,USA,2,4,1031,11323,12354,1
Consumer Electronics|Software,17800000.0,USA,1,3,0,16293,16293,0
Biotechnology|Life Sciences|Media|News|Pharmaceuticals,5000000.0,CHN,1,1,0,14396,14396,0
Software,7650000.0,CAN,1,2,0,15720,15720,0
Communities|Corporate Training|Education,1543920.0,FRA,1,2,0,15978,15978,0
Enterprise Software,1623640.0,CHN,1,1,0,15765,15765,0
Data Centers|Information Technology|Internet|Services,16000000.0,USA,1,2,0,16323,16323,0
Artificial Intelligence|Fashion|Technology,609229.0,ESP,4,4,275,15309,15584,0
Android|Apps|iPhone|Mobile|Sports,6700000.0,GBR,2,5,609,15733,16342,0
Blogging Platforms|Internet|Public Relations|Social Media|Startups,1573976.0,CHN,3,3,1658,15065,16723,0
Bitcoin,525000.0,USA,2,4,78,16144,16222,0
Mobile,1629549.0,CHN,1,1,0,16130,16130,0
Health and Wellness,3750000.0,CHN,2,2,365,13208,13573,0
Networking|Online Travel|Travel,1719583.0,CHE,2,3,1074,15187,16261,0
Cloud Computing|Communications Hardware|Contact Centers|Customer Service|Internet|Software|VoIP|Web Development,75000.0,BRA,1,1,0,15715,15715,0
Babies|Big Data Analytics|E-Commerce|Fashion|Kids,35000.0,USA,1,1,0,16617,16617,0
Customer Service|Sales and Marketing|Software|Telephony,9311190.0,USA,4,6,904,15719,16623,0
Enterprise Software,7289000.0,USA,3,7,922,14600,15522,1
Biotechnology,1465000.0,USA,2,1,1219,14522,15741,0
Services,16674.0,NLD,1,1,0,16616,16616,0
3D Printing|Collaborative Consumption|Local|Marketplaces,4500000.0,NLD,2,6,371,15944,16315,0
3D Printing|Health and Wellness|Health Care,7500.0,USA,1,1,0,16205,16205,0
3D|3D Technology|E-Commerce|Internet|Online Shopping,240000.0,USA,2,1,134,16071,16205,0
Drones|Manufacturing,99000000.0,USA,4,25,899,15649,16548,0
Software,169500000.0,USA,3,1,271,16085,16356,1
Health Care,16399999.0,IRL,1,1,0,16623,16623,0
Business Services|Video Games,701760.0,FRA,1,1,0,14407,14407,0
3D|Medical|Physicians,1880000.0,USA,4,2,842,15797,16639,0
3D Technology|Human Computer Interaction|Sensors,50000.0,SVN,1,1,0,16008,16008,0
3D|Computer Vision|Kinect|Robotics|Software,2670000.0,RUS,2,3,639,14975,15614,0
3D Printing|3D Technology|Printing,30000.0,JOR,1,1,0,16071,16071,0
3D Printing,4247128.0,USA,3,2,505,16166,16671,0
Biotechnology,7436500.0,USA,2,1,1182,14393,15575,0
3D|Mobile,2065000.0,IND,2,2,974,13848,14822,0
Android|B2B|Brand Marketing|iPhone|Mobile|Music|Video Streaming,1700000.0,HUN,2,2,547,14975,15522,0
Software,2249999.0,USA,2,6,733,15429,16162,1
Music,20000000.0,USA,1,1,0,13243,13243,0
Mobile,746185.0,CHN,2,3,337,13208,13545,0
Semiconductors,13708150.0,CHN,3,5,924,13745,14669,0
Messaging|SMS,4000000.0,USA,1,2,0,13695,13695,0
Web Hosting,65000000.0,USA,3,11,1360,12784,14144,1
iOS|Location Based Services|Mobile|Online Dating|Social Media,500000.0,GBR,2,1,527,16199,16726,0
Biotechnology|Pharmaceuticals,4783500.0,ESP,2,2,221,13693,13914,0
Cloud Data Services|Services|Software,148000000.0,USA,3,12,1380,11078,12458,1
Consulting|Software,25920000.0,USA,4,2,1224,14638,15862,0
Software,1011601.0,USA,3,1,620,14648,15268,0
Curated Web,1500000.0,USA,1,1,0,13430,13430,0
Clean Technology,50000000.0,GBR,1,1,0,15044,15044,0
Curated Web|Tourism|Travel,1500000.0,CHN,2,2,446,15015,15461,0
Game,1000000.0,JPN,1,3,0,16280,16280,0
Mobile,1394250.0,FRA,1,2,0,14197,14197,0
Developer APIs|Enterprise Software|Infrastructure|Services|Software,5000000.0,USA,2,6,1100,14719,15819,0
Biotechnology,7063012.0,USA,4,7,1192,15217,16409,0
Physical Security|Security,13000000.0,USA,1,1,0,11897,11897,0
Manufacturing,13780000.0,FRA,1,1,0,14384,14384,0
Clean Technology,15152514.0,GBR,1,1,0,16132,16132,0
Software,1670000.0,USA,1,7,0,16540,16540,0
Clean Technology,15000000.0,USA,3,2,904,13761,14665,1
Software,272000.0,IRL,1,1,0,13634,13634,0
Coupons|Online Shopping|Payments|Retail Technology,50958896.6114209,IRL,2,4,2313,13452,15765,1
Security,64567194.0,USA,7,13,3283,13165,16448,0
Databases|Electronics|Storage,26000000.0,USA,1,4,0,12094,12094,1
Flash Storage|Security,3393925.0,USA,2,2,826,13929,14755,0
E-Commerce,2374979.0,USA,6,9,1347,15156,16503,0
Creative Industries|Entertainment|Television,228187.78333316397,GBR,1,1,0,15887,15887,0
Messaging,750000.0,USA,1,4,0,15166,15166,0
Security,38064570.0,USA,4,10,2165,13276,15441,1
Commercial Real Estate|Real Estate,17400000.0,USA,4,20,518,15218,15736,0
Web Hosting,2258720.0,SWE,1,1,0,13192,13192,1
Internet|Telecommunications,485841.245076705,SWE,2,5,769,15576,16345,0
Biotechnology,49656999.0,USA,5,4,1221,15384,16605,0
Clean Technology|Enterprise Software,1160000.0,USA,2,1,535,15584,16119,0
Biotechnology,500000.0,CAN,1,1,0,16759,16759,0
Automotive|Clean Energy|Cloud Computing|Internet|Software|Wireless,9416354.0,USA,6,2,1282,13361,14643,1
Ad Targeting|Big Data Analytics|Mobile Advertising,320288000.0,USA,8,31,3440,12843,16283,0
E-Commerce,500000.0,JPN,1,1,0,16295,16295,1
Hardware + Software,60000000.0,USA,5,8,3756,12951,16707,0
Human Resources|Recruiting|Social Recruiting,10511317.0,DEU,1,3,0,12193,12193,0
Apps|Education|Kids|Religion,50000.0,USA,1,1,0,15943,15943,0
Advertising|Software,1121078.0,GBR,4,6,889,15043,15932,0
Office Space,3607956.0,GBR,1,3,0,16407,16407,0
Pets,762500.0,BRA,1,1,0,15946,15946,0
Aerospace,95445.0,GBR,1,1,0,16102,16102,0
Internet|Mobile,15000.0,USA,1,1,0,16289,16289,0
Games,3500000.0,CHN,1,1,0,14599,14599,0
Software,740000.0,USA,2,1,285,15428,15713,0
E-Commerce|Enterprise Software|Loyalty Programs|Social Media,12900000.0,USA,6,31,1183,14593,15776,1
Apps|Internet|Photography|Promotional|Sales and Marketing,22325000.0,CAN,7,20,1509,15128,16637,0
E-Commerce|Online Shopping|Software,5000.0,NGA,1,1,0,16040,16040,0
Software,27000000.0,CHN,3,8,426,13269,13695,0
E-Commerce,9300000.0,CHN,3,6,1370,12478,13848,0
Finance,10000000.0,CHN,2,3,546,13149,13695,0
E-Commerce,1158814.0,CHN,2,2,275,15400,15675,0
Curated Web,10000000.0,CHN,1,2,0,13720,13720,0
Education,65100000.0,CHN,4,4,1057,15309,16366,0
Games,1500000.0,CHN,2,3,852,13970,14822,0
Internet,65000000.0,CHN,3,6,1131,15340,16471,0
Games,1000000.0,CHN,1,1,0,14579,14579,0
Art|Creative|Creative Industries,234705.0,DEU,3,3,0,16556,16556,0
E-Commerce,200000000.0,CHN,2,4,212,14944,15156,0
Photography,30000000.0,CHN,2,8,183,13665,13848,1
Curated Web|Internet|Software,876780000.0,CHN,6,6,3068,13180,16248,1
Curated Web,10000000.0,CHN,1,2,0,16042,16042,0
Mobile|Software|Web Design|Web Development,5100000.0,GBR,1,1,0,16233,16233,0
Mobile|Technology|Wireless,6100000.0,USA,2,1,370,16021,16391,1
Music|Ticketing|Web Development,368750.0,ESP,1,6,0,14527,14527,0
Education|Games|Video,12800000.0,USA,3,3,844,13604,14448,1
Art|Curated Web|Photography|Social Media,15873.0,GBR,1,1,0,15418,15418,0
Games,3987693.0,KOR,2,2,1098,14853,15951,1
Mobile,7000000.0,USA,1,1,0,14043,14043,1
Games|Mobile|Mobile Games|Online Gaming,3000000.0,USA,1,2,0,16267,16267,0
Advertising|Internet|Internet Marketing,17129760.0,USA,4,5,511,14412,14923,1
Accounting|Business Development|Finance|Software|Web Development,1300000.0,GBR,3,3,569,14424,14993,1
Browser Extensions|Curated Web|Social Media,100000.0,USA,1,1,0,14883,14883,0
Software,3050000.0,USA,3,2,122,16241,16363,1
Web Hosting,3019139.0,USA,2,2,598,15209,15807,0
Information Services|Information Technology|Internet Marketing|SEO,100000.0,USA,1,1,0,16372,16372,0
Enterprise Software,37143865.0,USA,5,3,1774,14844,16618,0
Concentrated Solar Power|Manufacturing|Solar,5714285.71428571,CAN,1,2,0,13708,13708,1
Mobile,1000000.0,CHN,2,3,212,16071,16283,0
Photography,30500000.0,CHN,3,6,1887,13453,15340,0
B2B|Predictive Analytics|Sales and Marketing,32000000.0,USA,3,7,672,15813,16485,0
Health and Wellness|Specialty Foods,8000000.0,USA,2,7,1,16324,16325,0
Finance,3134880.0,ITA,1,1,0,15413,15413,0
Software,6700000.0,USA,2,3,446,13098,13544,1
Social Network Media,1556687.0,GBR,3,1,365,16384,16749,0
Android|Apps|Cloud Computing|Collaboration|Email|Finance|Home & Garden|Internet|iOS|iPad|iPhone|Mac|Productivity Software|Software|Synchronization|Task Management|Web Development,23857750.0,DEU,5,7,1057,14964,16021,1
Analytics|E-Commerce|Software,6528902.0,USA,3,1,1250,14284,15534,0
Enterprise Software,295000.0,JPN,1,2,0,15883,15883,0
Development Platforms|Games|Online Gaming,150000.0,ISR,1,2,0,16023,16023,0
Games,10000000.0,USA,1,1,0,14804,14804,0
Bicycles|Communities,15000000.0,CHN,1,3,0,16520,16520,0
Analytics|Network Security|Shipping|Small and Medium Businesses|Startups,2450000.0,USA,5,6,810,15419,16229,0
Advertising|Consumers|E-Commerce|Mobile Commerce|Retail|SaaS|Software,1500000.0,USA,2,2,311,15273,15584,0
Clean Technology,16036000.0,USA,6,2,1291,15321,16612,0
Social Media,47570.0,GBR,1,1,0,15437,15437,0
Content Creators|Content Delivery|Licensing|Music|Music Services|Technology,20068328.451591,GBR,4,3,3007,13027,16034,1
Games,1136548.0,CHN,2,3,893,14730,15623,0
Analytics|B2B|Big Data|Business Intelligence|Enterprises|Enterprise Software|Finance|Mobile|SaaS,3000000.0,USA,1,1,0,16673,16673,0
Web Hosting,9850000.0,USA,4,7,1018,14975,15993,0
Brand Marketing|Communities|Consulting|Semantic Search|SEO,600000.0,USA,3,2,1581,14610,16191,0
Publishing,269260.0,NLD,2,4,84,15797,15881,0
Apps,500000.0,GBR,1,1,0,16517,16517,0
Design|Internet|Shared Services,4500000.0,USA,2,1,396,15887,16283,0
Finance Technology|FinTech|Mobile|Personal Finance|Technology|Wealth Management,17000000.0,HKG,2,8,941,15343,16284,0
Advertising|Email|Loyalty Programs|Mobile|SaaS|Sales and Marketing|Social Media|Software,2100000.0,CAN,1,1,0,14463,14463,0
Home Decor|Interior Design|Internet,25000.0,USA,2,2,348,14398,14746,0
Services,77000000.0,USA,2,15,560,10925,11485,0
Crowdsourcing|Design|Graphics,25000.0,USA,3,3,469,15273,15742,0
Entertainment|Games|Media,55398.0,ESP,1,1,0,16191,16191,0
Advertising|Content Discovery,140000.0,GBR,2,8,150,16102,16252,0
Games|Virtual Worlds,12250000.0,USA,2,2,1013,13939,14952,0
Exercise|Fitness|Tracking,2730000.0,USA,3,3,551,16127,16678,0
Messaging|Public Relations|Social Media,1500000.0,ISR,2,4,0,13879,13879,0
Clean Technology,30000000.0,USA,1,1,0,16238,16238,0
Music,5279980.0,USA,3,6,958,15639,16597,0
Travel,24600000.0,CHN,1,2,0,16022,16022,0
Analytics|Apps|Big Data|E-Commerce|Education|Enterprise Software|Internet of Things|Media|Mobile|Payments|SaaS|Social Media,150000.0,SGP,1,1,0,16040,16040,0
Consulting,4500000.0,USA,2,1,54,15897,15951,0
Manufacturing,29300000.0,USA,4,14,973,15588,16561,0
Media|News|Publishing|Soccer|Sports,38800000.0,GBR,3,9,882,15832,16714,0
Mobile,20000000.0,CHN,1,2,0,15309,15309,0
Mobile,30000000.0,CHN,1,3,0,15309,15309,1
Food Processing,3000000.0,USA,2,2,349,16394,16743,0
Social Media,4502251.0,CHN,1,1,0,14944,14944,0
Application Platforms|Development Platforms|Mass Customization,9000000.0,CHN,1,5,0,16518,16518,0
Finance,63590263.0,CHN,1,1,0,15034,15034,0
Curated Web|Finance,19790000.0,CHN,3,7,989,15248,16237,0
Mobile,1000000.0,IND,1,1,0,16372,16372,0
Mobile|Publishing,10450000.0,USA,3,15,1019,14982,16001,0
Local Businesses,2160000.0,SGP,2,7,268,16196,16464,0
E-Commerce|Payments,83574271.0,CHN,5,5,2681,13007,15688,1
E-Commerce Platforms|Manufacturing|Material Science,500000.0,USA,2,2,373,16008,16381,0
Crowdsourcing|Design|Marketplaces|Online Shopping,45000000.0,USA,2,6,1448,15092,16540,0
Fashion|File Sharing,105651.0,AUS,2,4,63,15429,15492,0
E-Commerce|Trading|Video Games,100000.0,USA,1,1,0,16375,16375,0
Automotive,75000000.0,CHN,1,2,0,15553,15553,0
Apps|Logistics|Postal and Courier Services,442943.0,BRA,1,1,0,16301,16301,0
E-Commerce|Social Commerce,20000.0,IND,1,1,0,15584,15584,0
Manufacturing,7575757.0,CHN,1,1,0,14975,14975,0
Android|iOS|Mobile|Mobile Payments|SaaS|Taxis,25000000.0,BRA,3,8,642,15891,16533,0
Software,210000.0,IND,3,1,964,14944,15908,0
E-Commerce,9600000.0,CHN,2,3,1095,12784,13879,0
Social Media,2800000.0,HKG,2,8,440,15111,15551,0
Business Analytics|Enterprise Software|SaaS|Software,7200000.0,USA,3,5,533,15960,16493,0
Software|Technology,900000.0,USA,1,6,0,16013,16013,0
Enterprises|Enterprise Software|iPad|Presentations|SaaS|Training,925000.0,USA,2,3,126,15855,15981,1
Games|Virtual Worlds,100000000.0,CHN,1,1,0,13958,13958,0
Digital Media|News|Social Media,3500000.0,USA,1,2,0,16513,16513,0
Chemicals,2500000.0,USA,1,4,0,16489,16489,0
Innovation Engineering|Manufacturing|Water Purification,110000000.0,USA,1,1,0,16311,16311,0
Games|Social Games,10312103.0,USA,2,12,375,14683,15058,0
Games,560248.0,ESP,1,3,0,16405,16405,0
E-Commerce,50000.0,USA,1,1,0,15431,15431,0
Biotechnology,2100002.0,USA,2,3,1692,13034,14726,0
Clean Technology,115837966.0,GBR,1,1,0,15085,15085,0
Consumer Goods|Manufacturing|New Product Development,5000000.0,CHN,1,1,0,16457,16457,0
Mobile,14300000.0,USA,3,2,1036,12965,14001,0
Games,9300000.0,USA,1,1,0,15299,15299,0
Charity|Financial Services|Medical,50000.0,USA,1,1,0,16008,16008,0
Finance,6410000.0,IND,1,2,0,14131,14131,0
Pets,569355.0,GBR,1,1,0,16344,16344,0
Android|Business Productivity|CRM|iOS|iPad|iPhone|Mobile|Point of Sale|Productivity Software,20000.0,USA,2,1,140,16357,16497,0
Cloud Computing|Communications Hardware|Hardware|Networking|Optimization|Security|SEO|Technology|Virtualization|Web Hosting,118000000.0,USA,4,13,3197,12784,15981,1
Batteries|Clean Technology|Energy Storage|Mobile,502860000.0,USA,8,12,2410,13088,15498,1
Music,50000000.0,CHN,2,5,433,12692,13125,1
Curated Web,1623640.0,CHN,2,1,214,15765,15979,0
Mobile,16474.0,CHN,1,1,0,16102,16102,0
Biotechnology,500000.0,USA,1,1,0,14977,14977,0
Search,6000000.0,USA,2,12,639,13514,14153,1
Application Platforms|Communications Infrastructure|Storage,14000000.0,USA,3,5,758,11535,12293,1
Consulting|Recruiting,3100000.0,IND,2,2,43,16420,16463,0
Human Resources,20000000.0,USA,1,1,0,16225,16225,0
Biotechnology,40000000.0,USA,1,1,0,15408,15408,1
Telecommunications,180000000.0,USA,1,4,0,12370,12370,0
Social Media,442457.0,BRA,3,2,489,15337,15826,0
Mobile,4260000.0,FIN,1,1,0,14398,14398,0
Health Care Information Technology|Medical|Therapeutics,12000000.0,FRA,1,2,0,16175,16175,0
Finance,4900000.0,NGA,1,1,0,16120,16120,0
Advertising|Analytics|E-Commerce|Optimization|Testing,1412834.0,FRA,1,2,0,16336,16336,0
EdTech|Education,3356695.0,ESP,1,1,0,16280,16280,0
Software,3409315.0,GBR,1,1,0,15918,15918,0
SaaS|Software,3500000.0,USA,2,14,301,16071,16372,0
Digital Media|Sales and Marketing|Social Media,41250.0,HKG,1,1,0,16071,16071,0
Music|Video Editing|Web Development,263400.0,IRL,1,2,0,13514,13514,0
Software,1770000.0,FRA,1,2,0,13095,13095,1
Software,4540000.0,DEU,1,3,0,13216,13216,0
Curated Web,4400000.0,USA,2,5,1095,13273,14368,0
E-Commerce|Fashion|Women,875000.0,USA,5,3,346,15916,16262,1
Business Services,375000.0,RUS,1,1,0,15609,15609,0
Biotechnology,2000000.0,CAN,1,1,0,16188,16188,0
Biotechnology,805908.0,GBR,1,2,0,13777,13777,0
Biotechnology,10207905.0,GBR,4,8,1454,15119,16573,0
Health Care,2012700.0,USA,1,1,0,15308,15308,0
Biotechnology,12850000.0,USA,3,1,589,16055,16644,0
E-Commerce,19148000.0,USA,5,21,1319,14789,16108,0
Health Care,583000000.0,USA,4,5,2671,13496,16167,0
Curated Web|Health and Wellness|Health Care|Internet|Medical|Psychology|Teachers|Technology|Therapeutics|VoIP|Web Development,21000000.0,USA,3,8,756,15839,16595,0
Curated Web|Privacy,6467283.0,USA,1,2,0,15167,15167,0
Health Care|Health Diagnostics,12853396.0,GBR,3,2,1191,15425,16616,0
Biotechnology|Robotics|Technology,50000.0,USA,1,2,0,16469,16469,0
Cloud Computing|Cloud Infrastructure|Cloud Management|M2M|Open Source|Software|Virtualization|Web Hosting,26898770.0,USA,10,13,2778,13879,16657,0
Accounting|Consulting|CRM|Marketing Automation|Project Management,500000.0,USA,1,1,0,14160,14160,0
Innovation Engineering|Medical|Medical Devices,21800000.0,USA,1,7,0,13711,13711,1
Biotechnology,42980577.0,USA,7,4,1408,15343,16751,0
Collaboration|Credit|Curated Web|Entrepreneur|Finance|FinTech|Small and Medium Businesses,17500000.0,USA,4,27,1352,15320,16672,0
M2M|Software,50000.0,USA,1,1,0,15579,15579,0
Biotechnology,12000000.0,USA,1,2,0,14764,14764,0
Local|Services|Translation,250000.0,USA,1,1,0,16450,16450,0
Big Data|Cloud Computing|Infrastructure|Mobile|Wireless,3000000.0,CHN,1,2,0,16102,16102,0
Biotechnology,186036236.0,BEL,6,17,4340,11955,16295,1
Real Estate|Search,2518000.0,USA,4,8,843,15709,16552,0
Clean Technology|Solar,510000000.0,USA,2,5,162,14796,14958,0
Big Data|Consumers|Personal Finance|Retirement,3000000.0,USA,2,1,202,16506,16708,0
Curated Web|Identity|Identity Management,17087500.0,USA,3,9,1631,14600,16231,0
Contact Management|Curated Web|Events,4439407.0,USA,6,2,1453,15095,16548,0
Curated Web,7618249.0,USA,3,1,232,14209,14441,0
Software,13600000.0,USA,2,9,470,12465,12935,0
Information Security|Security,1737170.0,CHE,1,1,0,12677,12677,0
Health and Wellness,2810000.0,USA,3,4,721,15679,16400,0
Financial Services,14000000.0,USA,2,10,189,16499,16688,0
Advertising|Digital Media|Education|Media|News|Publishing,422000000.0,BRA,1,1,0,13277,13277,0
Education,50000.0,USA,1,1,0,14903,14903,0
Clean Technology,4500000.0,USA,2,4,1249,14784,16033,0
Clean Technology|Energy|Oil,661000.0,SWE,1,2,0,14741,14741,0
Analytics,20000000.0,USA,1,1,0,15575,15575,0
Software,200000.0,USA,1,1,0,16199,16199,0
Crowdsourcing|Curated Web|Sports,1220000.0,IND,2,2,519,15243,15762,0
Biotechnology,1663801.11900538,GBR,2,3,865,15904,16769,0
Health Care,28364818.0,USA,10,7,1644,14523,16167,0
B2B|Internet Service Providers|Security|Software,1300000.0,USA,1,1,0,16010,16010,0
Apps|Gamification|iOS|Mobile,15000.0,USA,1,1,0,15480,15480,0
Web Hosting,23000000.0,USA,2,4,520,15320,15840,0
Software,762000.0,USA,1,1,0,15793,15793,0
Biotechnology,33500000.0,GBR,2,4,887,15064,15951,0
Business Services|Intellectual Asset Management|Licensing,255100000.0,USA,3,1,4474,10917,15391,1
Semiconductors,368000.0,PRT,1,1,0,12937,12937,0
Social Media,17800000.0,USA,4,10,2155,13819,15974,0
Advertising|Education|Lead Generation|Portals,10000000.0,USA,1,1,0,14245,14245,0
Education,2000000.0,USA,1,4,0,12631,12631,1
Biotechnology|Health Care,126385000.0,USA,3,8,3565,12142,15707,1
Clean Technology,16424363.0,GBR,3,12,924,14216,15140,0
Information Technology,10720178.0,GBR,1,1,0,16224,16224,0
EdTech|Education|Entrepreneur|Technology,142367.0,ARG,3,5,92,15979,16071,0
Health Care,4710960.0,DNK,1,1,0,15779,15779,0
Audio|Entertainment|Music|Social Media|Social Media Platforms,5000000.0,SWE,2,2,462,16111,16573,0
Energy|Mining Technologies,25090000.0,IND,1,1,0,13969,13969,0
E-Commerce,25478613.0,USA,1,1,0,16302,16302,0
Business Services|Enterprises|Mobile|Networking|Telecommunications,31040000.0,CAN,3,8,1609,13216,14825,0
Hardware + Software|Television,1270000.0,SWE,1,1,0,13683,13683,0
Diagnostics|Health Care|Health Diagnostics|Medical Devices,25000.0,USA,3,3,1069,15380,16449,0
Health Care|Hospitals|Medical,13500000.0,USA,2,3,161,13697,13858,1
Mobile|Technology|Wireless,3033472.0,USA,2,2,457,15371,15828,0
Health Care,150000.0,USA,1,1,0,15478,15478,0
Medical|Medical Devices|Technology,32000000.0,USA,1,2,0,12424,12424,0
Clean Energy|Nanotechnology|Technology,25000000.0,USA,1,6,0,13493,13493,0
Enterprise Software,4045500.0,USA,3,1,1437,14739,16176,1
Biotechnology,113701127.0,USA,6,15,1969,13362,15331,1
Apps|Finance|Mobile|Sports,457282.0,USA,7,6,703,13879,14582,0
Consumer Electronics|Electronics|Manufacturing,60000000.0,USA,1,10,0,11645,11645,0
Enterprise Software|Security,13410901.0,USA,2,1,65,15343,15408,0
Logistics|Software|Storage|Supply Chain Management|Transportation,28500000.0,USA,2,3,1477,14152,15629,0
Analytics|Cloud Computing|Cloud Management|Networking|SaaS|Security|Virtualization,25000000.0,USA,2,3,1674,13787,15461,0
Software,1560000.0,IND,1,1,0,12808,12808,0
Mobile|Mobile Analytics,3000000.0,FRA,1,2,0,16447,16447,0
Semiconductors,20209960.0,BRA,2,2,1548,13346,14894,0
Domains|Internet|Ticketing,9280000.0,GBR,4,7,671,15400,16071,0
Software,4500000.0,USA,2,1,533,13769,14302,1
Career Management|Software,25305000.0,USA,4,4,1915,13042,14957,1
Software,3020000.0,USA,3,4,743,15126,15869,0
Biotechnology,138581610.0,USA,5,4,3326,12677,16003,0
Credit Cards|Fraud Detection|Security,7131124.0,USA,3,1,700,14033,14733,1
Health Care,13793098.0,USA,3,5,943,14671,15614,1
Health and Wellness|Health Care|Services,58500000.0,USA,2,2,159,16549,16708,0
News,7380000.0,USA,2,2,243,14426,14669,0
Security,30000000.0,USA,1,2,0,15379,15379,0
Health Care,46900000.0,USA,1,1,0,15718,15718,0
Advertising|Distribution|Mobile|Sales and Marketing|Social Media,24250000.0,USA,3,5,1520,13459,14979,0
Business Services|Customer Service|Services,1300000.0,USA,1,1,0,15431,15431,0
Accounting|Advice|Finance|Software,80157014.0,GBR,1,1,0,15063,15063,0
Enterprise Software,45000000.0,USA,2,2,0,15779,15779,0
Computers|Internet|Networking,16000000.0,USA,1,8,0,11562,11562,0
Clean Technology,4500000.0,USA,1,1,0,16769,16769,0
Financial Services|Nonprofits|Social Fundraising,23000000.0,USA,2,2,202,15315,15517,0
Aerospace|Manufacturing|New Product Development,2000000.0,USA,1,9,0,16440,16440,0
Advertising|Internet|Services,5500000.0,USA,3,9,3147,9648,12795,0
Analytics|Career Management|Recruiting|Social Recruiting,90000.0,USA,2,3,67,15492,15559,0
Biotechnology|Medical,35000000.0,USA,1,4,0,13626,13626,1
Development Platforms|Health Care|Software,5000000.0,USA,1,1,0,12620,12620,1
Hardware + Software,10000000.0,USA,1,3,0,13545,13545,1
Semiconductors,33331814.0,USA,3,1,1280,14867,16147,0
Health and Wellness|Health Care|Healthcare Services,96244444.0,USA,6,9,3087,13545,16632,0
3D|Social Media|Technology,20600000.0,USA,2,5,156,16237,16393,0
Consulting,4000000.0,USA,1,1,0,13236,13236,1
Big Data Analytics|Health Care Information Technology|SaaS,150000.0,USA,1,1,0,16253,16253,0
B2B|Cloud Computing|Enterprises|Health and Wellness|Health Care|Network Security|SaaS,158000.0,USA,2,2,382,15918,16300,0
Cloud Computing|SaaS,8500000.0,JPN,2,6,573,15826,16399,0
Credit|Finance|Financial Services|Personal Finance,34072000.0,USA,4,12,1300,12639,13939,0
Colleges|Education|Recruiting,150000.0,USA,2,2,127,15831,15958,0
Software,5500000.0,USA,1,1,0,16533,16533,0
Medical Devices,15470704.0,USA,2,1,1590,14914,16504,0
Enterprise Software,32000000.0,USA,2,2,1390,14644,16034,0
Software,3315000.0,USA,1,1,0,14063,14063,0
Biotechnology,6650000.0,USA,2,3,2181,13665,15846,0
Health and Wellness,1495000.0,USA,2,2,248,16514,16762,0
Information Technology,1000000.0,USA,1,1,0,16616,16616,0
Health Care|Hospitals,6700000.0,USA,1,1,0,15126,15126,0
Biotechnology,110640466.0,USA,9,28,3759,12188,15947,1
Mobile|Mobile Payments|Mobile Security|Security,12050000.0,SWE,4,6,1637,13879,15516,0
Health Care|Health Diagnostics,6321095.0,GBR,1,2,0,15232,15232,0
Internet Radio Market,2500000.0,USA,1,1,0,16318,16318,0
Real Estate,67000000.0,USA,4,5,233,15685,15918,0
Software,2100000.0,USA,1,1,0,12849,12849,0
Biotechnology,32655000.0,USA,8,17,2058,12843,14901,0
Hardware + Software,329695.0,GBR,1,1,0,15572,15572,0
Mobile|Networking|Telecommunications,15000000.0,IRL,1,3,0,16337,16337,0
Security,8198838.0,USA,4,2,2299,14061,16360,1
Hardware + Software,30500000.0,USA,2,2,921,15183,16104,0
Information Technology,25000.0,USA,1,1,0,13462,13462,0
Consumer Goods|Content Delivery|Logistics,3715000.0,NGA,2,3,397,16085,16482,0
Public Relations,5000000.0,USA,1,8,0,13514,13514,0
Health and Wellness|Health Care|Health Care Information Technology|mHealth|Predictive Analytics,145562.0,IRL,2,3,280,15765,16045,0
Advertising,24980307.0,USA,6,14,2198,14092,16290,0
Biotechnology,30000000.0,USA,1,2,0,16748,16748,0
Education|Mobile Commerce|Technical Continuing Education,4700000.0,USA,2,4,716,15993,16709,0
Education|Online Education|Services,4000000.0,USA,1,1,0,16576,16576,0
Biotechnology|Health Care,93654902.0,USA,5,1,1487,14571,16058,1
Security,2090000.0,USA,1,1,0,14253,14253,0
Health Care,600000.0,USA,1,1,0,15925,15925,0
Semiconductors,4880000.0,CAN,1,2,0,13663,13663,0
Health Care,41250.0,HKG,1,1,0,16252,16252,0
Biotechnology,151250000.0,USA,6,3,1458,14457,15915,0
Enterprise Software,5280000.0,USA,1,3,0,12985,12985,1
Advertising|Classifieds,30000.0,BRA,1,1,0,14245,14245,0
Biotechnology|Health Care,116605707.0,USA,4,20,3155,12631,15786,1
Clean Technology,54300000.0,USA,3,13,1462,14525,15987,0
Finance,5000000.0,USA,1,1,0,14292,14292,0
E-Commerce|Gift Card|Home & Garden|Kids|Lifestyle|Retail|Travel,13274403.0,GBR,3,6,1522,14730,16252,0
Brand Marketing|Finance|P2P Money Transfer,12500000.0,USA,1,1,0,15419,15419,0
Finance Technology,50000.0,USA,1,1,0,16282,16282,0
Software,150000.0,USA,1,1,0,14739,14739,0
Software,13600000.0,USA,2,3,1097,12621,13718,0
Career Management|Education|Human Resources,100000.0,NLD,1,1,0,16035,16035,0
Employer Benefits Programs|Incentives|Services|Software,52422326.0,USA,5,15,1399,13846,15245,1
Enterprise Software,2500000.0,GBR,1,2,0,13887,13887,0
Biotechnology|Health Care,91100000.0,USA,2,15,3124,11715,14839,1
Semiconductors,135776263.0,USA,5,12,2268,13536,15804,0
Biotechnology,9599860.0,USA,3,1,2427,13757,16184,1
Social Media|Storage|Video Streaming|Web Hosting,28000000.0,USA,3,8,1034,13483,14517,1
Software,9500000.0,USA,1,1,0,11474,11474,1
Mobile,100000000.0,IND,1,3,0,14887,14887,1
Biotechnology,82000000.0,USA,3,15,1050,15637,16687,1
Consulting,8000000.0,USA,1,2,0,16001,16001,0
Telecommunications|Web Hosting,38247779.0,USA,2,2,2775,11603,14378,1
Biotechnology,40000000.0,USA,1,4,0,12542,12542,0
E-Commerce,18800000.0,THA,3,13,508,16058,16566,0
Android|Consumer Internet|Email|Enterprise Software|iOS|Mobile|Mobile Security|SaaS,7300000.0,USA,1,5,0,15860,15860,1
Hardware + Software,1998000.0,DNK,3,3,1160,13145,14305,0
Software,592000.0,GBR,1,1,0,13165,13165,0
Software,75000000.0,USA,3,15,1125,12193,13318,1
Agriculture|Analytics|Coffee,20000.0,USA,1,1,0,15431,15431,0
Biotechnology|Health Care,76800000.0,USA,3,8,1289,12192,13481,1
Advertising,43000000.0,CHN,2,2,455,13149,13604,1
Apps|Finance|FinTech|Mobile|Technology,31960000.0,USA,4,12,1048,15492,16540,0
Clean Technology,976865.0,GBR,1,1,0,15773,15773,0
Clean Technology,15000000.0,USA,4,7,1336,14916,16252,0
Mobile|Networking,808211.0,GBR,1,3,0,16006,16006,0
Curated Web,40000.0,USA,1,1,0,15712,15712,1
Content|Enterprise Software|Social Media|Software|Web CMS,173500000.0,USA,8,26,2858,13848,16706,0
Advertising Platforms|Software,12100000.0,CAN,3,4,898,15202,16100,0
Fitness|Health and Wellness,130000.0,USA,1,1,0,15503,15503,0
Finance,20000000.0,USA,1,1,0,14638,14638,0
EdTech|Education,9750000.0,USA,1,4,0,16644,16644,0
Flash Storage|Homeland Security|Storage|Web Hosting,11000000.0,SGP,1,2,0,12418,12418,0
Sports,215000.0,USA,1,1,0,13330,13330,0
E-Commerce,26239014.372048497,GBR,2,2,575,16131,16706,0
Internet Service Providers|Networking,500000000.0,IND,1,1,0,16617,16617,0
Biotechnology|Health and Wellness|Medical|Pharmaceuticals,26980000.0,USA,6,1,766,14005,14771,0
Software,8400000.0,USA,1,1,0,16637,16637,0
CRM|Marketing Automation|Software,72500000.0,USA,5,16,1327,14848,16175,0
Data Integration|Enterprises|Real Time,25000000.0,USA,1,5,0,11542,11542,1
Batteries|Clean Technology|Search,9800000.0,USA,3,5,890,14082,14972,1
Internet|Software|Web Hosting,113616859.0,USA,8,44,4401,11479,15880,0
Software,43600000.0,USA,3,12,4562,12006,16568,0
Information Security|Software,100000.0,ISR,1,1,0,16566,16566,0
Enterprise Software|Information Services|Information Technology,207500000.0,USA,6,19,1640,14512,16152,0
Telecommunications,25000000.0,FRA,1,7,0,16602,16602,0
Software,3759300.0,FRA,1,1,0,13347,13347,0
Biotechnology,15600000.0,USA,2,3,1135,12901,14036,1
Audio|Information Technology|Media|Messaging|Video,790398.0,DNK,1,1,0,15601,15601,0
Biotechnology,600000.0,USA,2,2,1434,14323,15757,0
Contact Management|Web Design,20000000.0,USA,2,1,545,11322,11867,0
Collectibles|Entertainment|Games|Toys,100000.0,USA,2,3,61,15218,15279,0
Application Platforms|Professional Services|Project Management,242563.0,SVK,1,1,0,16436,16436,0
Cloud Computing|Consulting|Search|Software,10150000.0,USA,2,1,204,15266,15470,0
Advertising,1000000.0,DEU,1,1,0,13185,13185,0
Advertising|Business Development,400000.0,ISR,1,1,0,8955,8955,0
Mobile,58200000.0,USA,5,11,2617,11078,13695,1
Application Performance Monitoring|Business Services|Reviews and Recommendations|Software,500000.0,DNK,1,1,0,16079,16079,0
Hardware|Hardware + Software|Semiconductors,80000000.0,CHN,1,6,0,13042,13042,1
Enterprise Software,1604278.0,CHN,1,1,0,15675,15675,0
Facebook Applications|Finance|Social Fundraising,1700000.0,USA,1,4,0,16477,16477,0
Mobile,5000000.0,USA,2,9,564,15400,15964,0
Email|Marketing Automation|Software,900000.0,BEL,1,2,0,11292,11292,0
Software,25000000.0,USA,1,1,0,14629,14629,0
Software,2310008.0,GBR,2,3,2215,13578,15793,0
Biotechnology,22585000.0,DEU,2,10,453,14568,15021,1
Fitness|Medical|Training,25000.0,USA,4,4,590,15380,15970,0
Health Care,950000.0,USA,3,2,1270,15345,16615,0
Software,13360000.0,FRA,2,4,1036,13094,14130,0
Software,1120000.0,NOR,1,1,0,13881,13881,0
Enterprise Software,22500000.0,USA,5,6,2242,12631,14873,0
Advertising,35000000.0,USA,1,1,0,15924,15924,0
Advertising,11500000.0,CHN,2,2,1216,12784,14000,0
Software,10823112.0,USA,3,8,578,15737,16315,0
Electronics|Manufacturing|Mechanical Solutions,2000000.0,USA,1,1,0,13714,13714,0
Software,28000.0,USA,1,1,0,15522,15522,0
Semiconductors,6000000.0,USA,1,1,0,15140,15140,0
Enterprise Software,16400000.0,USA,4,3,1029,14551,15580,0
Cloud Computing,190000.0,RUS,2,2,0,15874,15874,0
Cloud Computing,1054991.0,FRA,1,3,0,16311,16311,0
Curated Web|Entertainment|Facebook Applications|Gift Card|Private Social Networking|Social Commerce|Social Network Media,20000.0,UKR,1,1,0,15355,15355,0
Information Technology|SaaS|Visualization,3000000.0,USA,1,2,0,12739,12739,0
Financial Services,4099999.0,USA,1,3,0,16274,16274,0
Biotechnology,925000.0,USA,3,1,1122,14719,15841,0
Software,214208700.0,USA,10,37,3754,10835,14589,1
Finance,13250001.0,USA,2,3,438,15236,15674,0
Real Estate,2750000.0,USA,1,1,0,13899,13899,0
Software|Web Development,2000000.0,USA,1,4,0,11485,11485,0
Mobile Security|Security|Software,680000.0,USA,2,1,241,14677,14918,0
Health Care,10000000.0,ISR,2,5,801,13830,14631,1
Biotechnology|Health Diagnostics,805000.0,GBR,1,2,0,15048,15048,1
Advertising|B2B|Consumer Internet|Internet|Marketplaces,185000.0,USA,2,3,790,15553,16343,0
Education,2200000.0,USA,2,2,936,15379,16315,0
Mobile,4275852.0,SWE,2,3,448,15142,15590,0
Biotechnology|Clinical Trials|Pharmaceuticals,30204758.8708734,BEL,2,6,156,13552,13708,1
Biotechnology,36700005.0,USA,4,1,1252,14594,15846,1
Business Services|Technology,28000000.0,USA,3,10,570,11915,12485,1
Advertising|Direct Marketing|Social CRM|Social Media,2574004.0,SGP,2,2,1188,14846,16034,1
Analytics|Information Technology|Software|Supply Chain Management,6061005.0,GBR,1,1,0,16029,16029,0
Health Care,550000.0,USA,2,2,933,15273,16206,0
Hardware + Software,150000.0,USA,1,1,0,15405,15405,0
Advertising|Big Data Analytics|Broadcasting|Cloud Computing|Digital Media|Enterprise Software|SaaS|Video Streaming,3750000.0,ISR,3,3,822,14153,14975,0
Biotechnology,2670394.0,USA,2,2,187,16082,16269,0
Manufacturing|Retail,45400000.0,BRA,1,1,0,14589,14589,0
Health Care,104000000.0,USA,4,21,2787,13529,16316,0
Health Care,1067275.0,GBR,2,3,335,14812,15147,0
Health Care|Pharmaceuticals|Technology,15000000.0,USA,1,6,0,12698,12698,1
Ad Targeting|Advertising,3000000.0,USA,1,1,0,15904,15904,0
Accounting|Cloud Computing|CRM|Developer Tools|Development Platforms|Enterprise Resource Planning|Enterprise Software|SaaS|Software,23300000.0,USA,4,8,1813,14551,16364,0
E-Commerce,93000000.0,USA,3,9,839,14963,15802,0
Biotechnology|Health Diagnostics,2200000.0,USA,2,1,2463,13377,15840,0
Manufacturing,18100000.0,USA,2,1,1196,14035,15231,0
Services,25000.0,USA,1,1,0,16395,16395,0
Analytics|Big Data|Databases|Software|Storage,10563501.0,GBR,3,10,1176,14426,15602,0
Health Care,10000000.0,USA,3,3,1107,15187,16294,0
Medical|Pharmaceuticals|Service Providers,27000000.0,USA,1,2,0,11409,11409,0
Biotechnology,63176464.0,USA,5,5,1149,15194,16343,0
Biotechnology,6400000.0,USA,2,4,510,14985,15495,0
Contact Management|iPhone|Mobile|Telephony,2000000.0,USA,2,13,368,15631,15999,0
Advertising|Mobile,17600000.0,USA,3,6,1117,12784,13901,1
Analytics|Customer Service|Lead Management|Mobile,7706593.0,GBR,6,14,1604,13213,14817,0
Social Media,7500000.0,USA,3,7,1311,14537,15848,0
Advertising,1550000.0,USA,2,1,261,14116,14377,1
Health Care|Medical|Technology,8900000.0,USA,1,3,0,12093,12093,0
Advertising|Email Marketing|Software,175000.0,USA,2,1,153,16024,16177,0
Advertising|Television,99234.0,GBR,1,1,0,16071,16071,0
Games|Online Gaming,9000000.0,DEU,1,2,0,16406,16406,1
Advertising,1185000.0,USA,3,4,463,16099,16562,0
Design|Engineering Firms|Technology,8000000.0,MEX,1,3,0,16412,16412,0
Marketing Automation|Monetization|Software,1600000.0,USA,1,3,0,16640,16640,0
Cloud Computing|Enterprises|Security,49500000.0,USA,3,9,864,15675,16539,1
Biotechnology,3007428.34801961,AUS,1,1,0,14967,14967,0
Material Science|Mechanical Solutions|Nanotechnology,1038955.0,IRL,2,2,428,15949,16377,0
Nanotechnology,8206660.0,USA,6,3,1650,14881,16531,0
Health Care,82000000.0,USA,4,5,1614,12904,14518,1
Advertising|Auctions|Television|Video,48500000.0,USA,5,10,1516,13545,15061,1
Enterprise Software,46168126.0,GBR,1,1,0,15251,15251,0
Advertising,13200000.0,USA,4,14,637,14832,15469,0
Advertising,10000000.0,USA,1,2,0,12946,12946,1
Internet|Mobile|Semiconductors,5954000.0,USA,3,2,1542,14544,16086,0
Biotechnology,107500000.0,GBR,2,13,183,16155,16338,1
Software,777729.0,GBR,1,1,0,15516,15516,0
Bio-Pharm|Biotechnology|Health Care,401499480.0,USA,5,5,601,15961,16562,0
Cloud Management|Enterprise Software,22999999.0,USA,3,4,1213,14866,16079,0
Analytics|Business Analytics|Cloud Data Services|Software,176275000.0,USA,7,26,4320,12296,16616,0
Clean Technology,3750000.0,USA,1,1,0,14060,14060,0
Business Intelligence|Cloud Computing|Financial Services,22500000.0,USA,3,9,858,13042,13900,0
Entertainment|Games|Reviews and Recommendations|Semantic Web,24020000.0,USA,4,10,1786,13564,15350,1
Mobile|Security|Telecommunications,19670000.0,IRL,2,5,415,13258,13673,0
Big Data|Big Data Analytics|Enterprise Software|Machine Learning|Oil and Gas|Oil & Gas|Optimization|SaaS|Software,800000.0,USA,2,2,395,16222,16617,0
Enterprise Software,24845955.0,USA,6,9,1157,14552,15709,1
Collaboration|Enterprises|Software,30000000.0,USA,6,17,1954,13852,15806,0
Cloud Computing|Software,2400000.0,USA,1,1,0,16105,16105,0
Advertising,67115160.0,USA,5,15,3493,13199,16692,0
Biotechnology|Health Diagnostics,7250000.0,USA,4,5,533,15812,16345,0
Application Platforms|Cloud Computing|Information Technology|Visualization,2500000.0,DEU,1,3,0,16645,16645,0
Analytics|Big Data,13000000.0,USA,1,3,0,16289,16289,0
Finance|FinTech,20000000.0,USA,1,1,0,13698,13698,0
Advertising,150000.0,USA,1,1,0,16255,16255,0
Assisitive Technology|Universities,1300000.0,USA,1,3,0,16346,16346,0
Advertising|Enterprise Software|Marketing Automation|Mobile,9000000.0,GBR,3,11,465,15675,16140,0
Advertising|Auctions|Publishing,40400000.0,USA,4,5,2799,12662,15461,1
Biotechnology,120000000.0,CHE,2,4,686,15994,16680,0
Advertising|Media|Technology,6500000.0,USA,2,21,365,15645,16010,0
Advertising,2000000.0,RUS,1,1,0,16050,16050,0
Advertising|Displays|Location Based Services|Mobile|Mobile Software Tools|News|Sales and Marketing,2940000.0,CAN,1,1,0,14041,14041,1
Advertising,119191000.0,USA,7,12,2415,12823,15238,1
Advertising,10000000.0,CHN,3,11,992,14042,15034,1
Ad Targeting|Advertising|Entertainment,114000000.0,USA,3,4,1559,13544,15103,1
Fitness|Health and Wellness|Health Care|Personal Health|Software,1800000.0,USA,1,1,0,16164,16164,0
Finance|SaaS,65839694.0,USA,3,23,1062,15140,16202,0
Biotechnology,2842048.0,CHE,1,1,0,16503,16503,1
Mobile|Mobility|Transportation,4160600.0,ESP,2,3,104,15602,15706,0
Health Care,6800000.0,USA,3,5,352,16218,16570,0
Automotive,14350000.0,USA,4,6,2583,13369,15952,0
Enterprise Search|Search,650000.0,FIN,1,1,0,16016,16016,0
Advertising|Analytics|Big Data|File Sharing|Mobile Social|Social Media,73000000.0,USA,7,25,3045,13269,16314,0
Advertising|Apps|Sales and Marketing|Technology,500000.0,LTU,1,1,0,15862,15862,0
Enterprise Software,2729000.0,USA,2,16,70,15840,15910,0
E-Commerce|Gift Card|Online Shopping,1800000.0,DNK,1,1,0,16037,16037,0
Consulting,5000000.0,USA,1,1,0,13514,13514,1
Coupons|E-Commerce,1500000.0,USA,2,11,174,15034,15208,0
Advertising|Sales and Marketing|Software,3100000.0,USA,1,5,0,13180,13180,1
Advertising|Analytics|Mobile|Real Time,2000000.0,USA,1,1,0,16294,16294,0
Advertising|Media|Mobile|Optimization,23000000.0,USA,3,7,1009,15412,16421,0
Biotechnology,787000.0,SWE,1,5,0,14775,14775,0
Software,13463445.0,FRA,3,5,1579,15015,16594,0
Mobile,29758289.0,CAN,2,2,132,14671,14803,1
Enterprise Software,1015000.0,USA,2,2,31,15614,15645,1
Advertising|Optimization|SaaS|Software,1800000.0,USA,2,8,181,16064,16245,0
Software,6000000.0,USA,1,1,0,14907,14907,0
Semiconductors,56381909.0,USA,7,7,2331,14358,16689,1
Advertising|Android|iOS,2000000.0,USA,1,1,0,15135,15135,0
Ad Targeting|Advertising|Application Platforms,5100000.0,USA,2,6,247,13879,14126,0
Advertising,5500000.0,USA,2,3,659,13320,13979,0
Advertising|Media|Outdoors,20118.0,GBR,1,1,0,15396,15396,0
Advertising,944823.0,CAN,3,1,1497,13879,15376,0
Advertising|Internet|Media|Software,5500000.0,DNK,2,2,1586,14615,16201,0
Advertising|Classifieds|Cloud Computing|Real Time,328000.0,USA,4,3,567,15602,16169,0
Advertising,5300000.0,USA,2,2,313,13965,14278,0
Advertising,470000.0,USA,2,6,310,14730,15040,1
Advertising|All Markets|Audio|Creative|Design|Image Recognition|Video,81874.0,CAN,1,1,0,14245,14245,0
Analytics|Mobile|Technology,1400000.0,USA,1,9,0,16757,16757,0
Health Care|Medical Devices,2350000.0,USA,2,1,1086,15174,16260,0
Biotechnology,3500000.0,USA,2,1,3646,12390,16036,0
Automated Kiosk|Finance|Financial Services,30000.0,USA,2,3,59,16436,16495,0
Classifieds|Curated Web|Video,10000.0,IND,1,1,0,13695,13695,0
Biotechnology,23000000.0,USA,1,9,0,13020,13020,1
Facebook Applications|Games,2539200.0,FRA,1,1,0,15657,15657,0
Advertising|Mobile,1500000.0,ISR,1,1,0,16010,16010,0
Advertising,27000000.0,USA,2,6,260,13361,13621,1
Ad Targeting|Advertising|Advertising Platforms,2200000.0,FRA,2,11,654,15698,16352,0
Fashion,40000.0,CHL,1,1,0,16222,16222,0
Advertising|Coupons|Local Advertising|Local Based Services|Network Security,100000.0,USA,2,8,67,15156,15223,1
Biotechnology,45282384.0,USA,9,16,1723,13710,15433,0
Advertising|Internet|Publishing,34623.0,DEU,2,2,62,16191,16253,0
Mobile,1600000.0,JPN,1,3,0,15890,15890,0
Advertising|Enterprise Software|SaaS,9372811.67632733,GBR,2,3,734,15463,16197,0
Travel,355000.0,USA,3,8,455,14245,14700,0
Advertising|Advertising Platforms|Mobile Advertising,1000000.0,USA,1,1,0,16467,16467,0
Services|Technology|VoIP,25000000.0,USA,1,2,0,11484,11484,0
Big Data|New Technologies|Predictive Analytics|Semiconductors|Social Innovation,5600000.0,USA,1,1,0,15218,15218,0
Business Development|Technology,149549.0,FRA,2,2,184,16191,16375,0
Analytics,253000.0,FRA,1,1,0,13353,13353,0
Advertising|Displays|Sales and Marketing,2540206.0,GBR,3,8,519,15761,16280,0
Enterprise Software|Facebook Applications|Medical|Software|Technology|Weddings,550000.0,USA,2,2,608,14610,15218,0
Advertising|Internet|Marketplaces|Publishing,8500000.0,GBR,2,4,242,13697,13939,1
Analytics|Apps|Mobile|Tracking,28917736.262905102,USA,4,8,1298,15431,16729,0
Advertising|Apps|Content Discovery|Facebook Applications|Mobile|Mobile Games|Sales and Marketing|Social Media|Twitter Applications|Video,248000000.0,USA,2,4,1778,13208,14986,0
Software,1540000.0,USA,3,7,403,14914,15317,1
Entertainment|Tourism,8180000.0,IND,1,1,0,16371,16371,0
Advertising|Social Media Marketing,307954.0,ESP,2,1,365,14610,14975,0
Biotechnology,8300000.0,USA,2,3,2591,13165,15756,0
Biotechnology,46500000.0,USA,3,2,418,16001,16419,1
Advertising|Analytics|Direct Marketing|Internet Marketing|Social Commerce|Social Media|Video,1368157.0,ESP,1,1,0,15009,15009,0
Advertising|Auctions|Creative,8802628.0,USA,4,3,1561,15133,16694,0
Advertising|E-Commerce,600000.0,DNK,1,3,0,15431,15431,0
Advertising|Auctions|Software,30000000.0,USA,3,8,629,14193,14822,1
Advertising,515000.0,CHL,3,3,620,15694,16314,0
Advertising|E-Commerce|Publishing|Social Media|Social Network Media,600000.0,TUR,1,2,0,15095,15095,0
Colleges|Education|Information Services,413000.0,USA,2,4,361,16283,16644,0
Security,19000000.0,USA,2,6,790,13096,13886,0
Colleges|Curated Web|Education|Marketplaces|Social Media,2150000.0,USA,3,15,407,16307,16714,0
Health Care,5886000.0,USA,2,3,886,15724,16610,0
Advice|Education|High School Students|Online Education,1340000.0,USA,2,7,449,15859,16308,0
Databases|Information Technology|Services|Software,19311.0,ISL,1,1,0,14858,14858,0
Advertising|Mobile,46800000.0,USA,4,11,881,13392,14273,1
Advertising|Analytics|Apps|Hardware|Internet of Things|Media|Software|Technology,4500000.0,USA,1,2,0,16437,16437,0
Advertising,5000000.0,USA,1,2,0,15613,15613,1
Biotechnology,7588201.0,USA,2,6,819,13116,13935,0
Biotechnology|Health Care|Medical|Therapeutics,55500000.0,USA,3,12,1679,12053,13732,1
Industrial|Medical|Security|Sensors,25000.0,USA,1,1,0,16479,16479,0
Biotechnology,37079200.0,FRA,2,6,737,13899,14636,0
Advertising Exchanges|Advertising Platforms|Brand Marketing|Marketing Automation|Marketplaces|Mobile Advertising|Mobile Software Tools,20000.0,USA,1,2,0,16222,16222,0
Advertising|Analytics|Displays|Software,29575000.0,USA,5,12,2151,13551,15702,1
Advertising,1300000.0,USA,1,2,0,15842,15842,0
Messaging,18500000.0,USA,2,2,2796,10896,13692,1
Hardware + Software,2195355.0,TWN,3,1,788,15008,15796,0
Advertising|Digital Media,936776.0,KOR,1,1,0,16114,16114,0
News|Social Commerce|Social Media,56464869.0,USA,5,9,1213,14796,16009,1
Health and Wellness|Medical|Medical Devices,223828.0,SVN,1,2,0,16495,16495,0
Advertising|Apps|Brand Marketing|Loyalty Programs,2300000.0,USA,1,4,0,16624,16624,0
Leisure|Lifestyle|Travel & Tourism|Vacation Rentals,69247.0,GBR,1,1,0,16191,16191,0
Business Services|Consulting|Outsourcing,2000000.0,USA,1,2,0,13147,13147,1
Advertising|Services|Software,1000000.0,TUR,1,1,0,16637,16637,0
Advertising|Incentives|Loyalty Programs|Video|Video on Demand,3274546.0,GBR,2,1,426,15431,15857,0
Advertising Platforms|Apps|Monetization,632000.0,IND,2,15,110,16372,16482,0
Advertising,3216500.0,DNK,1,1,0,16087,16087,1
Advertising|Displays|Graphics,17807000.0,USA,4,8,1815,13695,15510,1
Mobile|Security,340000.0,USA,4,4,510,15483,15993,0
Advertising|Internet TV|Television,10000000.0,USA,3,12,1129,15629,16758,0
Ad Targeting|Advertising|Email|Optimization,1000000.0,USA,1,6,0,14379,14379,0
Advertising,89000000.0,USA,4,20,2970,13208,16178,0
Brand Marketing|Wireless,10000.0,VEN,1,1,0,16071,16071,0
Advertising|Services|Software,20000000.0,USA,1,2,0,15218,15218,1
Advertising,50000000.0,CHN,2,7,1196,15006,16202,0
Advertising,6150000.0,DEU,2,5,866,13895,14761,0
Advertising,6950000.0,CHE,2,2,467,13573,14040,0
Advertising,50000.0,USA,1,1,0,14482,14482,0
Advertising,100000.0,RUS,2,1,488,14365,14853,0
Advertising,5000000.0,CHN,1,3,0,13846,13846,0
Advertising|Big Data|SaaS|Sales and Marketing,850000.0,SGP,3,10,797,15826,16623,0
Advertising|Media|Technology,31634312.0,AUS,7,4,2696,13558,16254,1
Advertising|Digital Media|Internet Marketing|Mobile Advertising|Online Video Advertising,10500000.0,USA,3,12,539,16163,16702,0
Advertising Exchanges|Advertising Networks|Advertising Platforms|Mobile Advertising,500000.0,USA,1,6,0,15522,15522,0
Advertising,34075000.0,USA,3,10,3203,11537,14740,0
Ad Targeting|Analytics|Location Based Services|Mobile,5700000.0,DEU,2,4,545,15826,16371,0
Advertising|Enterprises|Internet|Machine Learning|Sales and Marketing|Search|SEO|Social Media|Software,10250000.0,USA,5,26,822,15765,16587,0
Software,350000.0,IND,1,3,0,16597,16597,0
Advertising,550000.0,USA,1,1,0,16040,16040,0
Advertising|Outdoor Advertising,3118000.0,USA,4,12,1313,14826,16139,0
Advertising,4000000.0,USA,1,3,0,15959,15959,0
Marketing Automation,6000000.0,USA,1,1,0,16651,16651,0
Advertising|Mobile,1750000.0,USA,2,8,434,16030,16464,0
Clean Energy|Clean Technology|Lighting,25500000.0,USA,3,8,1288,14168,15456,1
Biotechnology,143380947.0,USA,8,5,1875,14565,16440,1
Advertising|Incentives|Internet|Performance Marketing|Sales and Marketing|Search,100000.0,USA,1,1,0,12509,12509,0
Medical Devices,1299826.0,DNK,2,2,1627,14214,15841,0
Health Care|Information Technology|Medical|Pharmaceuticals,40000000.0,USA,1,3,0,16462,16462,0
Health Care,26000000.0,USA,2,4,827,15125,15952,0
Biotechnology|Health Diagnostics,52750600.0,FRA,1,2,0,16118,16118,1
Semiconductors,15000000.0,USA,1,5,0,12437,12437,1
Biotechnology|Health Diagnostics,32000000.0,USA,3,6,1364,15048,16412,0
Clean Technology,1210000.0,USA,2,4,656,15057,15713,0
Biotechnology,33500000.0,USA,2,7,463,13108,13571,1
Biotechnology,17060275.0,USA,4,6,2322,12797,15119,0
Biotechnology,12300000.0,USA,2,3,1561,14620,16181,0
Biotechnology|Health Care|Life Sciences,14350000.0,USA,5,6,1265,15246,16511,0
Biotechnology|Health Diagnostics,40800000.0,USA,4,8,2114,14490,16604,0
Security,1900000.0,USA,1,1,0,13605,13605,0
E-Commerce,30000.0,USA,1,2,0,15257,15257,0
Medical Devices,4500000.0,USA,2,3,322,16303,16625,0
Manufacturing,1500000.0,PRT,1,1,0,14245,14245,0
Software,10000000.0,USA,1,6,0,12261,12261,1
Semiconductors,5200000.0,USA,1,1,0,15169,15169,0
Clean Technology,31670000.0,USA,2,9,862,13598,14460,0
Enterprise Software|Mobile,1021575.0,IRL,1,1,0,12784,12784,0
Health Care,17825489.0,USA,4,4,2030,14615,16645,0
Health Care,16211800.0,ESP,1,1,0,13846,13846,1
Semiconductors,36519878.0,USA,11,9,3177,13104,16281,0
Advertising|Business Intelligence|Sales and Marketing|Software|Technology,500000.0,USA,1,1,0,13559,13559,0
Technology,60764825.0,JPN,1,1,0,15835,15835,1
Clean Technology,5000000.0,ISR,1,2,0,16140,16140,0
Semiconductors,74110000.0,SGP,7,41,1916,12753,14669,0
Renewable Energies,18000000.0,USA,1,2,0,16629,16629,0
Biotechnology,2000000.0,ISR,1,2,0,14731,14731,0
Analytics|Hardware + Software,562336.0,USA,1,1,0,14790,14790,1
Clean Technology,13000000.0,USA,1,3,0,13956,13956,0
Internet|Knowledge Management|Medical,12000000.0,USA,1,2,0,16525,16525,0
Computers|Software|Technology,6000000.0,USA,1,1,0,12431,12431,1
Software,424999.0,USA,2,1,131,15484,15615,0
Clean Technology|Manufacturing,335000.0,USA,2,1,1518,13958,15476,0
Biotechnology,39700000.0,USA,5,7,2737,13774,16511,1
Biotechnology,500000.0,USA,1,1,0,15119,15119,0
Human Resource Automation,26200000.0,USA,1,2,0,12479,12479,0
Software,20000000.0,USA,1,1,0,13472,13472,0
Semiconductors,24000000.0,ISR,3,8,777,12808,13585,1
Clean Technology|Solar,78000000.0,USA,3,8,1630,12053,13683,1
Mobile,4560000.0,USA,1,3,0,13689,13689,0
Consulting,2930000.0,GBR,2,4,1318,12988,14306,0
Software,909150.0,GBR,1,2,0,15936,15936,0
Biotechnology,22500000.0,USA,1,1,0,14981,14981,0
Adventure Travel|Bridging Online and Offline|Online Travel|SaaS,25000.0,USA,2,2,261,16234,16495,0
E-Commerce|Marketplaces|SaaS|Travel,3500000.0,USA,1,3,0,13523,13523,1
Travel,20000.0,FRA,1,1,0,16357,16357,0
Advertising|Cars,2000000.0,USA,1,6,0,15643,15643,0
Big Data Analytics|Health and Wellness|Health Care Information Technology|Pharmaceuticals,2000000.0,USA,1,3,0,16176,16176,0
Software,5530000.0,FRA,1,3,0,14209,14209,0
E-Commerce|Internet Marketing|Mobile|Social Commerce|Social Media Marketing,395000.0,USA,3,4,425,15492,15917,0
Finance,5000000.0,USA,2,2,168,15803,15971,0
Beauty|Cosmetics|Fashion|Technology,40000.0,URY,1,1,0,15538,15538,0
Advertising,103063800.0,CHN,4,2,2496,13483,15979,0
Enterprise Software|Finance Technology|Financial Services|Insurance Companies|Social Media,550000.0,USA,1,3,0,16588,16588,0
Advertising,8000000.0,USA,1,1,0,12753,12753,1
Curated Web|Mobile,1000000.0,RUS,1,1,0,15553,15553,0
B2B|Consulting|Legal|Online Scheduling|Video Conferencing,69247.0,DEU,2,1,426,16191,16617,0
Advertising|Media|News|Television,269133.0,FRA,2,1,183,15492,15675,0
Real Estate,1200000.0,USA,1,1,0,16472,16472,0
Mobile,1000000.0,USA,1,1,0,14412,14412,1
Advertising,24997.0,GBR,1,1,0,15095,15095,0
Advertising|Android|iPhone|Media|Mobile|Web Development|Windows Phone 7,351681.0,RUS,2,2,0,15930,15930,0
Consulting|Internet|Internet Marketing,2300000.0,CAN,1,1,0,10953,10953,0
Advertising|Mobile Commerce|Social Media Marketing,1000000.0,IND,1,1,0,16615,16615,0
Advertising|Analytics|SaaS,22800000.0,USA,3,4,1523,13545,15068,1
Advertising|Analytics|Finance|Sales and Marketing,6700000.0,USA,3,10,676,15953,16629,0
Payments,266000000.0,NLD,3,6,1500,15208,16708,0
Biotechnology,7540560.0,USA,3,1,698,14824,15522,0
Advertising|Advertising Exchanges|Advertising Networks|Advertising Platforms|Media|Video,1908820.0,GBR,2,2,671,15065,15736,0
Advertising,1400000.0,USA,2,3,485,13514,13999,0
Advertising|Marketplaces|Social Media,250000.0,USA,1,1,0,14975,14975,0
Advertising|Consumers|Media,6400000.0,SGP,2,4,358,15784,16142,0
Advertising|Advertising Platforms|Developer APIs|SaaS,650000.0,USA,1,6,0,15167,15167,0
Advertising,10250000.0,USA,1,2,0,13726,13726,0
Career Management|Classifieds|Employment|Search,5997205.0,GBR,5,11,1443,15168,16611,0
Clean Technology,6500000.0,GBR,1,1,0,14119,14119,1
Biotechnology,55367098.0,USA,3,9,1440,15119,16559,0
Biotechnology|Pharmaceuticals,12173913.0434783,CAN,1,6,0,13472,13472,0
Clean Technology,21929020.0,CHN,3,4,762,14730,15492,0
Colleges|Software,3428750.0,USA,4,1,1561,15201,16762,0
Information Technology|Semiconductors,8000000.0,USA,1,4,0,13208,13208,1
Embedded Hardware and Software,26000000.0,USA,2,12,787,11757,12544,0
Biotechnology|Health Care|Therapeutics,68000000.0,USA,3,10,438,16079,16517,0
Semiconductors,7970000.0,USA,1,4,0,13330,13330,0
Analytics|Big Data|Business Intelligence|Predictive Analytics,503757.0,BRA,4,4,355,15560,15915,0
Web Hosting,40000000.0,GBR,3,15,1944,12846,14790,1
Digital Media|Television|Video Streaming,97000000.0,USA,4,19,998,15079,16077,0
Games|Networking,288000.0,USA,2,2,1558,13787,15345,0
Biotechnology,19500000.0,USA,3,1,223,15533,15756,0
Biotechnology,253614965.0,USA,5,6,1469,14853,16322,1
Aerospace|Drones|Robotics,159000.0,RUS,1,1,0,15692,15692,0
Aerospace|Curated Web|Drones,542944.0,ITA,1,2,0,16042,16042,0
Clean Technology|Hospitality,500000.0,USA,2,1,65,14648,14713,0
Cloud Computing|Enterprise Software|Storage,15500000.0,USA,4,16,1808,14822,16630,0
Direct Sales|Home & Garden|Wholesale,13000341.0,USA,2,1,1946,14680,16626,0
Mobile|Technology,104952382.0,USA,6,20,2565,13330,15895,1
Web Hosting,45400000.0,USA,3,6,1944,13243,15187,0
Mobile|RFID|Wireless,49000000.0,USA,4,19,1343,13574,14917,1
Analytics|Auctions|Big Data|Databases|Real Time,22000000.0,USA,3,7,1182,15063,16245,0
Biotechnology,120500000.0,USA,5,16,1454,13600,15054,0
Health Care|Medical|Therapeutics,1200000.0,USA,5,9,860,13399,14259,0
Aerospace,600000.0,USA,2,2,0,16602,16602,0
Biotechnology,63000000.0,USA,4,16,839,15344,16183,0
DOD/Military|Photography,60000000.0,CAN,2,2,2291,14440,16731,0
Cosmetics,6500000.0,USA,1,2,0,12829,12829,1
Business Services|Enterprise Application|Enterprise Software|Information Technology|Innovation Management|Professional Services,6000000.0,USA,1,1,0,16303,16303,0
Education|Nonprofits|Small and Medium Businesses|Startups,3000000.0,USA,1,2,0,16361,16361,0
Curated Web,57939.0,JPN,1,1,0,15317,15317,0
Mobile,6000000.0,USA,1,2,0,16013,16013,0
Health Care,35668990.0,USA,8,6,3602,13117,16719,0
Advertising,1415260.0,BRA,1,2,0,15921,15921,0
Analytics,20224999.0,USA,4,6,918,14641,15559,0
Biotechnology,89200000.0,USA,7,16,4331,12293,16624,0
Corporate Training|Education|Training,13940520.0,BRA,2,3,1797,14792,16589,0
Biotechnology|Health Diagnostics,28499283.0,SWE,1,1,0,13602,13602,0
Biotechnology,108377224.0,DEU,5,10,2708,13607,16315,1
Biotechnology,3000000.0,USA,1,4,0,13215,13215,0
Biotechnology,1359394.0,USA,1,2,0,14895,14895,0
Advertising|Consumer Behavior|Content Discovery|Social Media Marketing,5550000.0,CAN,3,5,733,16009,16742,0
Advertising|Design|Product Development Services,1500000.0,USA,1,1,0,16013,16013,0
Digital Media|Internet|Internet Marketing,574438.0,AUS,1,1,0,16618,16618,0
E-Commerce|Finance|Lifestyle|Tourism|Travel,1300000.0,CHN,3,4,786,15224,16010,0
Ad Targeting|Advertising|Digital Media|Mobile Advertising,85000000.0,USA,2,3,823,10865,11688,1
Finance|Financial Services,11000000.0,USA,2,2,802,13195,13997,0
Advertising|Apps,2900000.0,USA,3,1,1033,15553,16586,0
Mobile|Mobile Advertising|Private Social Networking|Social Media,1200000.0,USA,3,17,400,16076,16476,0
Finance,35500000.0,USA,3,3,684,15182,15866,0
Alumni|Career Management|Social Recruiting|Software,5540000.0,USA,3,3,516,12753,13269,0
Enterprise Software|SaaS,2000000.0,USA,1,3,0,16622,16622,0
Biotechnology|Health Care|Pharmaceuticals,81800000.0,USA,5,10,2361,13598,15959,1
Advertising|Creative|Design|Optimization|Predictive Analytics|Sales and Marketing,10500000.0,SGP,2,3,405,12242,12647,1
Biotechnology,34082500.0,AUT,1,1,0,15287,15287,0
Finance Technology|Financial Services|FinTech|Payments,320000000.0,USA,2,8,331,16230,16561,0
Mobile,116990000.0,USA,5,14,1083,14778,15861,0
Advertising|Apps|Media|Mobile|Mobile Advertising|Mobile Analytics|Social + Mobile + Local|Software,20000000.0,SGP,5,5,1798,13453,15251,0
Biotechnology,7000000.0,USA,1,3,0,13931,13931,0
E-Commerce,600000.0,USA,1,3,0,14594,14594,0
Real Estate,215539.0,GBR,1,1,0,15868,15868,0
Biotechnology,112999999.0,USA,3,5,2773,11533,14306,0
Consumer Lending|Finance|FinTech|Peer-to-Peer,2775000.0,ARG,3,2,1410,15156,16566,0
Cloud Data Services|Enterprise Software|SaaS|Video|Web Development,9850000.0,USA,3,10,915,14518,15433,0
Travel,25000.0,USA,1,1,0,16587,16587,0
Oil & Gas,100000000.0,CAN,1,1,0,16560,16560,0
Mobile|Networking|Telecommunications,20000.0,KEN,1,1,0,15431,15431,0
Hospitality,33500000.0,ZAF,2,2,1105,15006,16111,0
Education|Health and Wellness|P2P Money Transfer,3494416.0,FRA,2,4,575,15887,16462,0
E-Commerce,120000000.0,NLD,1,8,0,16692,16692,0
Enterprise Software,10200000.0,USA,3,4,1980,13238,15218,0
Software,100000.0,USA,1,1,0,16184,16184,0
Software,5235343.0,USA,4,5,2995,11670,14665,0
Domains|Marketplaces|Web Tools,5000000.0,USA,1,1,0,10938,10938,1
Enterprise Software,1000000.0,HKG,2,2,698,15512,16210,0
Curated Web|Marketplaces|Weddings,20000.0,USA,1,1,0,15887,15887,0
Clean Technology,144000000.0,PHL,2,2,29,15859,15888,0
Business Development|Enterprise Software|Technology,21500000.0,USA,2,10,340,11666,12006,0
Health and Wellness|Health Care|Medical Devices,23660000.0,USA,1,3,0,13880,13880,0
Enterprises|Internet|Storage,50000000.0,USA,1,5,0,13836,13836,0
SaaS|Security,22700000.0,USA,4,9,2091,14245,16336,0
Distributors|Film|Internet,30000.0,MEX,1,1,0,15262,15262,0
Collaboration|File Sharing|Mobile|Software,2100000.0,USA,1,1,0,15857,15857,0
Biotechnology,52000000.0,USA,2,6,861,15806,16667,0
Commodities|Finance|Financial Services,12200000.0,MNE,1,3,0,11631,11631,0
Games,27500000.0,USA,2,8,364,12695,13059,1
Business Services,225000.0,RUS,1,1,0,15887,15887,0
Advertising,1600000.0,USA,1,1,0,15224,15224,0
Online Scheduling,100000.0,CHL,2,1,365,15949,16314,0
Biotechnology,122000000.0,NLD,3,12,1738,13753,15491,0
Advertising|App Marketing|Chat|Telecommunications|Telephony,3109450.0,CAN,2,4,1267,13241,14508,0
Biotechnology,84100000.0,USA,2,18,1956,11750,13706,0
Software,14000000.0,ISR,3,3,820,13262,14082,0
CRM|Mobile|Real Estate|Virtual Workforces,3054000.0,USA,2,11,272,16455,16727,0
Software,500000.0,JPN,1,1,0,15989,15989,0
Mobile,9000000.0,USA,2,1,827,13964,14791,0
Real Estate|Startups,140000.0,USA,4,1,803,15706,16509,0
Education|Finance|Kids,333989.0,CHL,5,5,738,15180,15918,0
Reviews and Recommendations,45000.0,USA,1,1,0,16662,16662,0
Biotechnology,171140000.0,USA,5,3,2241,14460,16701,1
Information Services,1191698.0,USA,2,1,100,16461,16561,0
B2B|Email Newsletters|Internet|Social Media,1000000.0,USA,1,3,0,16379,16379,0
Advertising,74311925.0,USA,8,15,3012,12784,15796,1
Electronics|Manufacturing,811779.0,JPN,2,1,0,16448,16448,0
Finance|Finance Technology|FinTech|Insurance,5740000.0,IND,1,1,0,15095,15095,0
Analytics|Banking|Big Data|Retail|SaaS|Sales and Marketing|Software,640000.0,GBR,1,1,0,15279,15279,0
Clean Technology,26040000.0,USA,2,1,520,14614,15134,0
Health and Wellness,2000000.0,USA,1,1,0,15575,15575,0
Advertising|Career Planning|Events|Graphics|Internet Marketing|Meeting Software,1000000.0,JPN,2,1,153,14335,14488,0
Telecommunications|Wireless,1693138.0,USA,2,1,800,15553,16353,0
Hardware + Software,7000000.0,CAN,1,5,0,12915,12915,0
Biotechnology,111005000.0,USA,7,6,1927,14545,16472,1
Energy,1856869.0,CHE,1,3,0,15492,15492,0
Information Technology|Software,10100000.0,USA,1,1,0,16485,16485,0
Software,100000.0,GBR,1,1,0,13300,13300,0
Health Care,2000000.0,USA,2,2,317,15188,15505,0
Enterprise Software|Retail Technology|Security,18527468.0,USA,7,11,2304,14201,16505,0
Mobile|Open Source|Tablets,75000.0,HKG,1,1,0,14700,14700,0
Energy|Energy Efficiency|Energy Management,800000.0,USA,3,4,1242,15275,16517,0
Security,30455361.0,USA,6,13,3185,13018,16203,0
Gps|Software,5000000.0,USA,1,2,0,14015,14015,0
Innovation Engineering|Services,5591768.91615542,USA,1,4,0,12916,12916,0
Lasers|Manufacturing|Optical Communications,168000000.0,USA,4,22,1610,11241,12851,1
Software,7000000.0,USA,1,3,0,13123,13123,0
Health and Wellness,5250000.0,USA,1,2,0,13577,13577,0
SaaS|Services,40000000.0,USA,1,6,0,10903,10903,0
Analytics|Big Data|Business Intelligence|SaaS|Sales and Marketing,41000016.0,USA,3,8,1200,14975,16175,0
Software,9028626.0,USA,7,8,1007,15584,16591,0
Cloud Computing|Flash Storage|Networking|Peer-to-Peer|Storage|Synchronization|Trusted Networks|Web Hosting,250000.0,USA,1,1,0,13627,13627,0
Software,735330.0,BEL,1,1,0,15400,15400,1
Clean Technology,60250000.0,USA,4,8,1615,14364,15979,0
Software,12265000.0,USA,3,1,1476,13579,15055,0
Biotechnology|Health Care,119823937.0,USA,4,7,1228,14067,15295,1
Enterprise Software,2000000.0,USA,1,1,0,13097,13097,1
Enterprise Software,22600000.0,USA,2,7,679,12486,13165,0
Enterprise Software,22000000.0,USA,2,3,259,13801,14060,1
Agriculture|Business Services|Consumers|Hospitality|Internet|Mobile,3800000.0,USA,3,21,722,15462,16184,0
Mobile,2500000.0,CHN,2,2,691,14162,14853,0
Automotive|Heavy Industry|Services,12500000.0,USA,1,1,0,16190,16190,0
Hardware + Software,50000000.0,USA,1,8,0,13838,13838,0
Software,11159458.419373,ESP,3,6,1015,13298,14313,0
Education,3500000.0,USA,1,2,0,15614,15614,0
Curated Web|Natural Language Processing|Twitter Applications,90000.0,USA,2,2,270,15859,16129,0
Delivery|E-Commerce|Fashion,10000.0,MEX,1,1,0,16542,16542,0
Mobile|Mobile Software Tools|VoIP,29000000.0,USA,3,6,441,16252,16693,0
Software,1000000.0,CAN,1,2,0,16160,16160,0
Apps,2600000.0,FRA,1,3,0,16379,16379,0
Nanotechnology,1000000.0,USA,1,1,0,13039,13039,0
Biotechnology,24000000.0,USA,2,1,166,15191,15357,0
Biotechnology,57100000.0,USA,4,13,2964,12090,15054,1
Agriculture|Big Data|Information Services|Product Development Services,4349999.0,USA,3,4,454,16183,16637,0
Agriculture|Analytics|Drones|Geospatial|Productivity Software|Technology,250000.0,USA,1,1,0,16573,16573,0
Agriculture|Specialty Chemicals|Technology,40000.0,CHL,1,1,0,16222,16222,0
Agriculture|Hospitality|Technology,33333.0,USA,2,2,212,15572,15784,0
Agriculture|Curated Web|Education|Fitness|Health and Wellness|Organic|Subscription Businesses|Sustainability,500000.0,USA,1,2,0,16325,16325,0
Mobile,40000.0,CHL,1,1,0,15775,15775,0
Biotechnology,2320000.0,CAN,2,5,2093,14246,16339,0
Biotechnology,43898233.0,USA,7,30,3191,13474,16665,0
Agriculture|Big Data|Clean Technology|Software|Sustainability,2450000.0,USA,2,3,268,16083,16351,0
Biotechnology,6637000.0,BEL,1,2,0,15716,15716,0
E-Commerce,4000000.0,IND,1,2,0,16660,16660,0
Software,11119621.4028991,AUS,3,6,1421,14872,16293,0
Mobile,3000000.0,USA,1,1,0,14039,14039,1
E-Commerce,22999079.0,USA,5,6,895,15182,16077,0
Content Creators|SaaS|Sales and Marketing|Social Bookmarking|Social Media|Software,12750000.0,USA,6,33,955,15614,16569,0
Robotics,2000000.0,CHN,1,2,0,16652,16652,0
Broadcasting|Software|Video,100484.0,KOR,2,1,761,15126,15887,0
Health Care|Health Care Information Technology,20000.0,USA,1,1,0,16252,16252,0
Biotechnology,29500000.0,USA,3,13,1663,11918,13581,1
Finance|FinTech,1500000.0,USA,1,4,0,15230,15230,0
E-Commerce,40000.0,CHL,1,1,0,14924,14924,0
Intellectual Property|Search|Software,50000.0,USA,1,1,0,15579,15579,0
Mobile,30000000.0,CHN,1,3,0,13269,13269,0
Mobile,17300000.0,USA,2,3,539,13586,14125,1
Medical Devices,44645.0,KOR,1,2,0,15939,15939,0
Health Care|Software,600000.0,USA,2,6,79,15428,15507,0
Manufacturing,1253000.0,DEU,1,1,0,14195,14195,0
Social Media,20000000.0,CHN,2,5,730,14304,15034,0
Analytics|Artificial Intelligence|Business Intelligence|Consulting|Machine Learning,7500000.0,GBR,2,2,1395,13859,15254,1
Clean Technology|Environmental Innovation|Recycling,70000000.0,CHN,4,4,1405,15248,16653,0
Biotechnology,139500000.0,USA,7,31,2889,13483,16372,0
Education,40000.0,CHL,1,1,0,15440,15440,0
Travel,1163934.0,CHN,2,1,31,16040,16071,0
Software,5000000.0,CAN,1,1,0,14672,14672,0
Games,26977411.0,JPN,5,7,1291,15126,16417,0
Crowdfunding|Financial Services|Impact Investing|Marketplaces|Nonprofits,5000.0,USA,1,1,0,15952,15952,0
B2B|Financial Services|Internet|Payments|Software,2678886.0,BRA,2,2,194,16222,16416,0
Advertising,40000.0,CHL,1,1,0,15771,15771,0
Apps|Internet|Media|News|Software|Video|Video Streaming,8986842.0,USA,2,2,401,15262,15663,0
Photography,44800000.0,CHN,3,4,2699,13604,16303,0
Delivery,97560.0,BRA,1,1,0,15706,15706,0
Online Travel|Service Providers|Travel & Tourism,26000000.0,MYS,1,3,0,12234,12234,0
Gps|Location Based Services|Semiconductors,10000000.0,GBR,1,1,0,13249,13249,0
Mobile,25000000.0,USA,1,4,0,13417,13417,1
Assisitive Technology|Internet of Things|Machine Learning|Startups|Wearables,790000.0,USA,1,2,0,16737,16737,0
Mobile,52448530.0,USA,9,11,2031,13662,15693,0
Automotive|Software|Wireless,35419873.0,USA,3,5,2457,13879,16336,0
Bitcoin|Computers|Mobile,450000.0,USA,2,6,182,16444,16626,0
Hotels|Travel,2394820000.0,USA,8,42,2514,14245,16759,0
Aerospace|Automotive,11518329.0,NLD,1,1,0,14841,14841,0
Mobile,2500000.0,CAN,2,2,105,14256,14361,1
Aerospace|Heavy Industry|Material Science,2500000.0,NLD,2,3,90,14245,14335,0
B2B|Collaboration|Enterprise Software|Network Security|Telecommunications|Telephony,800000.0,FRA,1,5,0,16588,16588,0
Messaging,276108581.0,USA,3,1,381,14630,15011,0
Cloud Computing|Mobile|Software|Supply Chain Management|Transportation,27500000.0,USA,2,7,2520,11044,13564,1
Enterprise Software,178535.0,USA,2,1,2819,13846,16665,0
E-Commerce|Sales and Marketing|Software,89173.0,BRA,2,2,304,15918,16222,0
Clean Technology,18745880.0,USA,4,3,2376,14152,16528,0
Algorithms|Artificial Intelligence|Credit|Finance Technology|FinTech|Machine Learning,1400000.0,GBR,2,8,228,16237,16465,0
Manufacturing,4672932.0,SWE,1,2,0,15050,15050,0
Web Hosting,20000000.0,USA,1,4,0,12017,12017,1
Biomass Power Generation|Energy Efficiency|Waste Management,2748099.0,CAN,1,2,0,16231,16231,0
Mobile,16350000.0,USA,4,6,1438,12979,14417,0
Legal|Transportation,4700000.0,USA,1,7,0,16161,16161,0
Biotechnology|Manufacturing,8500000.0,FRA,1,2,0,13794,13794,0
Content Syndication,6220000.0,USA,3,7,3459,12901,16360,0
Messaging|Telecommunications,12000000.0,USA,2,3,1016,12079,13095,1
Location Based Services|Mobile|Mobile Security|Mobility|Wireless,3675000.0,USA,1,1,0,15084,15084,1
3D|Digital Signage|Navigation|Sensors,4249998.0,USA,2,3,425,15842,16267,0
E-Commerce|Point of Sale|Retail|Software,610540.0,GBR,3,3,861,14489,15350,0
Cloud Data Services,28000.0,USA,2,3,123,15614,15737,1
Public Relations|Sales and Marketing,5000000.0,USA,2,7,587,15608,16195,0
Advertising,400000.0,USA,1,1,0,14977,14977,0
Public Transportation,6000000.0,USA,1,1,0,13488,13488,0
Analytics|Big Data|Data Mining|Developer APIs|E-Commerce|Predictive Analytics|Travel,500000.0,USA,1,8,0,15826,15826,0
Mobile|Wireless,2502038.0,GBR,1,2,0,15246,15246,0
Public Transportation,10500000.0,USA,2,6,296,14008,14304,0
Aerospace|Mobile|Transportation|Travel,50000.0,USA,2,1,623,14365,14988,0
Android|B2B|Cloud Computing|E-Commerce|Internet|Mobile|Sales and Marketing|Security,2000000.0,TWN,1,1,0,16315,16315,0
Software,2000000.0,USA,2,2,367,13147,13514,0
Mobile|Web Hosting,141636023.0,USA,11,1,2227,14489,16716,1
Big Data|Big Data Analytics|Data Centers,2511000.0,USA,1,3,0,15706,15706,0
Health Care,65000000.0,USA,4,6,1463,14845,16308,0
Business Productivity|Data Visualization|Mobile|Productivity Software|Software,10600000.0,USA,3,23,833,15782,16615,0
Hardware|Hardware + Software|Wireless,2660000.0,DNK,2,1,379,16092,16471,0
Apps|E-Commerce|Employment|Human Resources|Internet|Marketplaces|Mobile|Task Management|Web Development,8494150.0,AUS,3,7,1129,15431,16560,0
Security|Wireless,59450091.0,USA,7,21,3977,12737,16714,0
Messaging|Photography|Social Media|Video|Video Chat|Video on Demand,33458625.0,USA,4,7,637,14865,15502,0
E-Commerce,2500000.0,BRA,1,1,0,15847,15847,0
Software,1200000.0,USA,1,2,0,16072,16072,0
Mobile,46999996.0,USA,6,8,1743,13437,15180,0
Aerospace|Drones|Enterprise Software|Robotics,40420000.0,USA,6,17,1080,15461,16541,0
Mobile|Mobile Devices,225000000.0,USA,2,2,81,15760,15841,1
Biotechnology,5100000.0,USA,2,3,1192,15131,16323,0
Software,38809918.0,USA,3,9,1617,12740,14357,1
Biotechnology,60586207.0,USA,12,27,3080,13511,16591,0
EdTech|Education|Games|Gamification|MMO Games|Social Media,1500000.0,USA,2,4,57,15132,15189,0
Health Care Information Technology|Health Diagnostics|Medical,50000.0,USA,1,2,0,15838,15838,0
Advertising|Android|Apps|iPhone|Location Based Services|Mobile|Navigation|Retail,9740000.0,USA,5,7,1017,14935,15952,0
Advertising|Analytics|Coupons|Groceries|Sales and Marketing,5200000.0,USA,3,17,660,15265,15925,0
Apps|iPhone|Mobile|Mobile Commerce|Retail|Startups,11500000.0,USA,2,2,202,14936,15138,1
Analytics,1347305.0,CAN,1,3,0,16148,16148,0
Games,816000.0,DEU,1,1,0,13629,13629,1
Interface Design,2711993.0,NLD,1,2,0,16239,16239,0
Artificial Intelligence|Chat|Customer Service|Customer Support Tools,350000.0,ARG,1,5,0,16054,16054,0
Cloud Computing|Consulting|Gamification|Mobility|Monetization|Social Media,100000.0,USA,1,1,0,14610,14610,0
Clean Technology,1250000.0,FRA,1,1,0,13999,13999,0
EdTech|Education,100000.0,IND,1,1,0,16088,16088,0
Cloud Computing|Enterprise Software|Mobile|Open Source|Software,5550000.0,USA,2,3,1232,15146,16378,0
Software,25000.0,USA,1,1,0,14034,14034,0
Events|Music|Social Media|Social Network Media|Travel,200000.0,USA,1,1,0,16239,16239,0
Advertising,43000000.0,USA,2,15,110,14867,14977,0
EdTech|Education,5500000.0,USA,3,1,611,14466,15077,0
Biotechnology,905063.0,USA,1,2,0,16660,16660,0
Broadcasting|Entertainment|News,2000000.0,FRA,1,1,0,13965,13965,0
Games,5045650.01145544,ESP,3,6,1059,15156,16215,1
Biotechnology,26100000.0,USA,5,6,690,13017,13707,1
Games,14000000.0,JPN,1,2,0,16211,16211,0
Education,322734.0,PER,3,6,1017,15584,16601,0
Biotechnology|Health Care,83100000.0,USA,4,28,1358,14502,15860,1
Analytics|Healthcare Services,4000000.0,USA,3,4,408,15882,16290,0
Software,18705000.0,RUS,2,4,1798,13088,14886,0
Software,2432351.0,FRA,2,2,424,15912,16336,0
Biotechnology,21553364.0,USA,7,7,2170,13829,15999,0
Health Care,120000.0,USA,1,3,0,16405,16405,0
Software,11300000.0,USA,2,6,285,12803,13088,1
Games|Personal Branding|Recruiting,36150000.0,USA,6,11,3647,12204,15851,0
Banking|Finance|Mobile|Payments|Peer-to-Peer,850000.0,USA,2,2,354,15484,15838,1
Employment|Nonprofits|Personal Branding|Recruiting|Software,470000.0,USA,2,1,432,15851,16283,0
Media|Mobile|SMS|Telecommunications,18410.0,LTU,1,1,0,15553,15553,0
Software,2000000.0,USA,1,2,0,12858,12858,0
Business Intelligence|CRM|SaaS|Sales and Marketing|Software,27478.0,IRL,1,1,0,16124,16124,0
Games,1900000.0,CAN,1,4,0,13997,13997,0
Hardware|Printing|Technology,11600000.0,USA,1,1,0,15562,15562,0
Curated Web,11000000.0,USA,1,4,0,12395,12395,0
Biotechnology|Health Diagnostics,40624513.0,USA,10,6,1968,14579,16547,0
Software,53730000.0,USA,5,9,1783,12908,14691,1
Consumer Internet|Digital Media|Enterprise Software|Mobile,21200000.0,IND,3,3,1355,15218,16573,0
Business Intelligence|Finance|Investment Management,118000.0,USA,1,1,0,16622,16622,0
Semiconductors,10000000.0,USA,1,1,0,13336,13336,1
Semiconductors,46953358.0,USA,6,12,3510,12965,16475,1
E-Commerce|Fashion|Lifestyle|Shopping,500000.0,USA,1,3,0,15285,15285,0
Web Hosting,30200000.0,USA,2,12,1193,12915,14108,1
Curated Web|Events|Weddings,30000.0,TUR,1,1,0,15437,15437,0
Semiconductors,35250000.0,USA,4,8,1558,11977,13535,0
Clean Technology|Water,2444718.0,NLD,4,2,1013,13392,14405,0
Clean Technology|Water Purification,100000.0,DEU,2,3,18,16247,16265,0
E-Commerce|Sales and Marketing,142765.0,ESP,1,2,0,15737,15737,0
Agriculture|Distributors,35000000.0,USA,1,1,0,16321,16321,0
Console Gaming|Entertainment|Game|Games|Online Gaming,24000.0,EGY,2,2,365,15706,16071,0
Enterprise Software,14253000.0,USA,2,4,3978,11715,15693,0
Information Services|Internet|Technology,3100000.0,USA,1,2,0,12062,12062,0
Biotechnology,2227000.0,USA,4,1,1242,14963,16205,0
Software,573000.0,GBR,1,1,0,13214,13214,0
Health and Wellness,10000000.0,USA,1,1,0,15317,15317,0
Software,408000.0,SWE,1,1,0,13398,13398,0
Pharmaceuticals,20000000.0,USA,2,7,768,12084,12852,1
Software,7202144.0,GBR,2,3,731,10957,11688,1
Finance,105900000.0,CAN,1,6,0,15902,15902,0
Internet of Things|Security,163000000.0,USA,2,1,1253,14292,15545,1
Big Data|Databases|Information Technology|Technology,9000000.0,USA,1,5,0,16498,16498,0
Health Care|Health Care Information Technology|Information Technology,30000.0,CAN,1,1,0,16495,16495,0
Services,3300000.0,BRA,2,3,265,16445,16710,0
Games,3000000.0,USA,2,2,920,13726,14646,0
Entertainment|Kids|Television|Video,442820.114660888,GBR,1,1,0,13131,13131,0
Risk Management|Security,15000000.0,PAN,1,1,0,16071,16071,0
Financial Services|Health Care|Insurance|Utilities,3000000.0,USA,1,1,0,16553,16553,0
Clean Technology|Lighting|Semiconductors,10025000.0,USA,5,3,1490,13930,15420,1
Education,775000.0,USA,1,4,0,16220,16220,0
Health Care,2239966.0,GBR,3,4,870,15298,16168,0
Biotechnology,40000000.0,SWE,1,2,0,13910,13910,0
Clean Technology,40000.0,USA,1,1,0,15301,15301,0
Education|Enterprises|SaaS|Services,2100000.0,USA,3,12,454,16001,16455,0
Internet|Subscription Businesses|Television|Video on Demand,326702.0,GBR,2,1,151,16305,16456,0
Local Search|Non Profit|Services,17000.0,USA,1,1,0,15796,15796,0
Health Care,621220.0,GBR,1,2,0,15502,15502,0
Health Care,81837.0,GBR,1,1,0,15194,15194,0
Artificial Intelligence|Big Data|Big Data Analytics|Computer Vision|Developer APIs|Enterprise Software|Machine Learning|Natural Language Processing|Text Analytics,2000000.0,USA,1,1,0,15751,15751,1
Biotechnology|Innovation Management|Medical,3286360.0,FRA,1,1,0,13573,13573,0
Electronics|Semiconductors|Technology,40663845.0,FRA,5,16,3634,12996,16630,0
Manufacturing,3000000.0,TWN,2,3,519,12173,12692,0
Health Care,1500000.0,AUS,1,1,0,16524,16524,0
Biotechnology,20000000.0,USA,2,6,461,15447,15908,0
Biotechnology,6800004.0,USA,3,2,658,15427,16085,0
Biotechnology,50653283.0,USA,6,11,1850,13502,15352,1
Biotechnology,41997183.0,USA,4,8,839,15468,16307,0
Hardware + Software,20340000.0,FRA,2,6,1619,13514,15133,0
Fitness|Health and Wellness|Health Care,378995.0,BEL,1,2,0,16451,16451,0
Biotechnology|Health Care|Therapeutics,105000000.0,USA,4,16,2484,12965,15449,1
Finance|Health Care,14000000.0,USA,1,3,0,15861,15861,0
Banking|Financial Services|Small and Medium Businesses,60610057.0,GBR,1,2,0,16091,16091,0
Software,11043722.0,USA,3,9,1684,13808,15492,0
Software,5820000.0,DEU,2,2,85,13263,13348,0
Biotechnology,32000000.0,USA,2,8,685,16009,16694,0
Health Care|Hospitality,34500000.0,USA,2,3,362,16239,16601,0
Telecommunications,1500000.0,USA,1,3,0,16467,16467,0
Craft Beer,270862.0,ESP,1,1,0,16233,16233,0
Credit|Finance,50000.0,USA,1,1,0,15579,15579,0
Clean Technology,710000.0,USA,2,2,588,14811,15399,0
Enterprise Software,9500000.0,USA,2,1,383,15464,15847,0
Advertising,2000000.0,FRA,1,3,0,16012,16012,0
Biotechnology,5000000.0,USA,1,1,0,14907,14907,0
Hardware|Semiconductors,123000000.0,USA,7,28,2415,13081,15496,0
Cloud Security|Network Security|Security,51311845.0,USA,8,27,2892,13045,15937,0
Healthcare Services|Mass Customization|Services|Technology,4160012.0,USA,1,1,0,16597,16597,0
Security,27000000.0,USA,2,3,930,14286,15216,0
Charter Schools|Email|Messaging|Mobile Emergency&Health|News,1200000.0,USA,7,8,385,14070,14455,0
Biotechnology,13900000.0,CAN,2,7,787,14859,15646,0
E-Commerce|Fashion|Lifestyle,2316062.0,GBR,1,1,0,14965,14965,0
Biotechnology|Health Care,113730309.0,USA,5,7,4195,11953,16148,1
Manufacturing|Motors|Recreation,10900000.0,USA,1,1,0,12823,12823,0
Architecture|Business Services|Career Planning|Enterprises|Information Technology|Software,5200000.0,USA,1,4,0,11740,11740,1
Analytics,15000000.0,USA,2,3,3005,12031,15036,0
Home Automation|Services,12500000.0,USA,3,8,774,15765,16539,0
Document Management|Enterprises|Enterprise Software,68500000.0,GBR,4,9,3338,12965,16303,0
Animal Feed|Clean Technology|Nutraceutical|Water,10065000.0,USA,5,8,2199,14326,16525,0
Biotechnology,2000000.0,USA,1,1,0,15797,15797,0
Biotechnology,5477340.0,DEU,1,2,0,15476,15476,0
Big Data|Cloud Computing|E-Commerce|Enterprise Software|SaaS|Search|Software,22220043.0,USA,3,16,596,15979,16575,0
Algorithms|Computer Vision|Mobile|Photography|Software,2805667.0,CAN,2,3,351,15949,16300,0
Biotechnology,2012351.3654922,BEL,1,4,0,13684,13684,1
Software,376000.0,LVA,1,1,0,13594,13594,0
Software,2400000.0,USA,1,5,0,16300,16300,0
Distribution|Logistics|Supply Chain Management,40000.0,CHL,1,1,0,15911,15911,0
Manufacturing,3204600.0,CHN,2,3,487,15492,15979,0
Marketplaces,900000.0,MEX,2,3,259,16314,16573,0
Cloud Infrastructure|SaaS|Telecommunications|VoIP,15458196.0,USA,5,9,3280,13363,16643,0
E-Commerce,4812000000.0,CHN,7,20,5296,10865,16161,1
Advertising|Collaboration|Sales and Marketing,4000000.0,USA,1,1,0,15459,15459,0
Hospitality|Mobile|Technology,3500000.0,USA,2,5,618,15857,16475,0
E-Commerce,27890167.0,USA,3,2,785,14585,15370,0
Semiconductors,335377366.0,USA,10,25,4082,12270,16352,0
Security,118400035.0,USA,8,26,1890,14776,16666,0
Internet|Local Businesses|SaaS|Sales and Marketing|Small and Medium Businesses|Software,11540578.0,USA,2,7,538,16161,16699,0
Health and Wellness,999500.0,USA,3,2,216,16100,16316,0
Software,6000000.0,USA,1,2,0,12860,12860,1
Health Care,125000000.0,USA,1,1,0,16188,16188,0
Mobile,29620000.0,USA,3,10,1821,11500,13321,0
Curated Web,25000.0,USA,1,1,0,15553,15553,1
Biotechnology|Health Care|Medical|Pharmaceuticals,206050000.0,USA,7,14,3576,12608,16184,1
Internet Service Providers|Messaging,1182833.0,FRA,2,1,2902,11595,14497,0
Biotechnology,73000000.0,USA,3,10,1880,14287,16167,1
Entertainment|Telecommunications|Wireless,831294.0,ESP,2,2,426,15826,16252,0
Health and Wellness,13500000.0,USA,2,7,313,15188,15501,0
E-Commerce Platforms|Fashion|Manufacturing|Product Design|Shoes,1020000.0,NLD,2,2,85,15797,15882,0
Biotechnology,100000000.0,USA,1,1,0,15888,15888,0
Biotechnology,10562781.0,FRA,2,1,828,15495,16323,0
Financial Services|FinTech|Software,43000000.0,USA,4,2,1150,15223,16373,0
Internet,5394111.0,FRA,1,2,0,16504,16504,0
Biotechnology,100000.0,USA,1,1,0,14903,14903,0
Consumer Goods|Consumers|Environmental Innovation|Hardware + Software|Identity|Outdoors,250000.0,USA,1,1,0,15857,15857,0
Hardware + Software,750000.0,USA,1,1,0,12870,12870,0
Media|Social Media,2000000.0,USA,1,11,0,16420,16420,0
Media,5000000.0,USA,1,4,0,16288,16288,0
Health Care,4545754.0,GBR,1,1,0,16126,16126,0
B2B|Human Resources|Recruiting|Virtual Workforces,1500000.0,USA,1,2,0,16437,16437,0
Biotechnology,62449545.0,USA,3,12,210,16309,16519,0
Health and Insurance|Human Resources|Insurance,3458000.0,USA,2,9,275,16455,16730,0
Content Delivery|Enterprise Software|Mobile|SaaS|Sales and Marketing|Sales Automation,1700000.0,USA,2,4,296,16405,16701,0
Curated Web|Media|Publishing|Small and Medium Businesses,22400000.0,USA,2,4,580,12600,13180,0
Curated Web|Education|Search|Training,1500000.0,USA,1,8,0,16196,16196,1
Security,9300000.0,USA,1,2,0,13998,13998,0
Industrial Automation|Industrial Energy Efficiency|Internet of Things|Smart Building|Smart Grid,539007.0,ITA,4,1,1550,15138,16688,0
Biotechnology,19567500.0,FRA,1,3,0,15813,15813,0
Data Mining|Software|Surveys,57262275.0,USA,5,7,2591,13514,16105,1
Health and Wellness,157000.0,USA,1,1,0,16113,16113,0
Software,1940000.0,FRA,1,1,0,14805,14805,0
Biotechnology|Health Diagnostics,5400000.0,USA,1,2,0,15162,15162,1
Application Platforms|Internet|Services,110000000.0,USA,2,6,123,11599,11722,0
Biotechnology,22000000.0,USA,2,2,21,16448,16469,0
Biotechnology,7000000.0,USA,1,2,0,16337,16337,0
Hospitality,7100000.0,USA,1,1,0,14615,14615,0
Hospitality,5000000.0,USA,1,2,0,12796,12796,0
Biotechnology,40000000.0,USA,2,8,1114,15294,16408,0
Hospitality,97000000.0,USA,2,7,476,16030,16506,0
Business Development|Development Platforms|Entrepreneur,16000000.0,USA,1,2,0,16486,16486,0
Discounts|Environmental Innovation|Recycling|Renewable Energies,355003.0,CHL,3,1,397,15918,16315,0
Software,10000000.0,USA,1,1,0,10935,10935,0
Health Care,14300000.0,USA,2,6,623,14503,15126,0
Industrial|Mechanical Solutions,7300000.0,USA,1,6,0,12016,12016,0
Distribution|Financial Services|Insurance,65000000.0,USA,1,4,0,11479,11479,0
Consulting,175000.0,IND,1,1,0,14880,14880,0
Internet|Mobile|Sports|Video Streaming,7000000.0,HKG,1,2,0,14610,14610,0
Specialty Chemicals,4000000.0,USA,1,1,0,13690,13690,0
Clean Technology,53000000.0,USA,1,1,0,14039,14039,0
Clean Technology|Internet|Local Businesses,1700000.0,USA,1,3,0,15796,15796,0
Software,643000.0,GBR,1,2,0,14524,14524,0
Health and Wellness|Health Care,350000.0,IND,1,6,0,15858,15858,0
Biotechnology,11587263.0,USA,3,1,738,14463,15201,0
Biotechnology,46988259.0,USA,5,5,1370,14062,15432,0
Advertising|Business Services,125000.0,RUS,2,2,425,15340,15765,0
Biotechnology,11626182.0,CAN,2,1,806,14671,15477,1
Public Relations,109000000.0,USA,5,7,2373,11478,13851,0
Biotechnology,15400000.0,CAN,1,4,0,14452,14452,0
Education,1800000.0,USA,2,7,489,16106,16595,0
Advertising,30000000.0,USA,1,2,0,15771,15771,1
Biotechnology,36902500.0,USA,4,9,2677,13123,15800,0
Bridging Online and Offline|Mobile|Restaurants,1500000.0,USA,1,2,0,16700,16700,0
Internet,5100000.0,USA,1,1,0,16398,16398,0
Apps|Search|Travel,432000.0,KOR,1,3,0,16637,16637,0
Health Care,6599285.0,CHN,4,4,1583,13392,14975,0
Hotels|Online Travel|Travel,1100000.0,USA,1,3,0,16213,16213,0
Sports,2879987.0,USA,5,6,943,14853,15796,0
Pharmaceuticals,860000.0,USA,1,3,0,13710,13710,0
Finance|Startups,4015000.0,USA,3,8,808,14761,15569,0
Internet|Wireless,3700000.0,DNK,1,1,0,16375,16375,0
Curated Web,2000000.0,USA,2,3,833,13829,14662,1
Health Care,6400000.0,USA,1,3,0,13024,13024,0
Journalism|Media|News,4276568.0,USA,2,2,1275,13360,14635,0
Communications Hardware|Mobile|Telecommunications|VoIP,8500000.0,USA,3,4,315,12996,13311,1
E-Commerce,3300000.0,USA,4,1,1199,15510,16709,0
Advertising,140500000.0,CHN,4,2,4443,10957,15400,0
Aerospace|Automotive|Engineering Firms|Medical|Medical Devices,20000000.0,IND,1,1,0,16658,16658,0
Agriculture|Biotechnology|Pharmaceuticals,30550000.0,USA,3,14,1565,13846,15411,1
Internet,400000.0,IND,1,1,0,16734,16734,0
Beauty|Content|E-Commerce|Online Shopping,1225000.0,ARG,4,6,547,15524,16071,0
Business Services|Events|Mobile,1525000.0,USA,1,2,0,16000,16000,0
Hospitality,10038299.0,GBR,3,3,4418,9496,13914,0
Biotechnology|Health and Wellness,55000000.0,USA,2,4,455,14182,14637,1
Health Care,734600000.0,USA,3,7,3843,12240,16083,1
Mobile,445000.0,USA,1,1,0,15091,15091,0
Health and Wellness,4500000.0,USA,2,18,296,16091,16387,0
Location Based Services|Mobile|Web Development,1500000.0,DEU,1,1,0,14441,14441,1
Blogging Platforms|Browser Extensions|Software,200000.0,USA,1,4,0,15944,15944,0
Education,50000.0,SWE,1,2,0,15868,15868,0
Artificial Intelligence|FinTech|Machine Learning|Trading,1244661.10413519,USA,3,8,607,16120,16727,0
Pharmaceuticals,9000000.0,CHE,1,2,0,13747,13747,0
Semiconductors|Technology,1750000.0,USA,1,1,0,12600,12600,1
Beauty|Cosmetics|Women,500000.0,USA,2,2,697,15857,16554,0
Technology,1430018.0,USA,1,1,0,16738,16738,0
Clean Technology|Energy,31000000.0,USA,4,10,1043,14732,15775,0
Analytics|Automotive|E-Commerce|EdTech|Education|Internet|Payments,40000.0,IND,1,1,0,15538,15538,0
Biotechnology,17415364.0,USA,2,1,153,15931,16084,0
Finance|Internet|Simulation|Stock Exchanges,4269000.0,USA,6,3,2783,13910,16693,0
Fantasy Sports|Games|Social Games|Video Games,5000000.0,USA,2,14,107,16467,16574,1
Social Commerce,107060133.0,USA,2,5,308,16451,16759,0
Video,12000000.0,GBR,1,4,0,12193,12193,1
Bitcoin|Financial Exchanges|FinTech|Software,1350000.0,USA,1,3,0,16358,16358,0
Health Care,58950000.0,USA,2,1,493,15653,16146,1
Web Hosting,135000000.0,USA,1,1,0,15867,15867,0
Web Hosting,34600000.0,USA,3,6,1586,13027,14613,0
Ad Targeting|Advertising|Brand Marketing|Social Television,300000.0,USA,1,1,0,16222,16222,0
Customer Service,4800000.0,USA,1,3,0,12437,12437,0
Analytics|Big Data Analytics,23500000.0,USA,2,8,926,15105,16031,0
Hardware + Software|Mobile|Sports,2100000.0,USA,2,4,55,16077,16132,0
Software,163000.0,RUS,1,1,0,15365,15365,0
Software,3808000.0,FRA,2,2,853,13846,14699,0
Mobile,1260000.0,USA,1,2,0,15447,15447,0
Manufacturing|Mobile|Solar,72000000.0,USA,1,8,0,15042,15042,1
Hardware + Software,15000000.0,BRA,1,1,0,15833,15833,0
Clean Technology,102000000.0,USA,1,1,0,15147,15147,0
Biotechnology,3050505.0,GBR,1,3,0,15014,15014,0
Renewable Energies,7000000.0,USA,1,1,0,16409,16409,0
Web Hosting,10000000.0,HKG,1,2,0,13405,13405,0
Software,30000000.0,USA,1,1,0,12697,12697,0
Semiconductors,124000000.0,ISR,6,21,3096,13131,16227,0
Biotechnology,23466666.0,USA,2,4,77,14565,14642,0
Clean Technology|Energy|Natural Resources,26250000.0,USA,1,4,0,14092,14092,0
Semiconductors,2400000.0,FRA,1,1,0,13080,13080,0
Art|Distribution|Entertainment|Games|Independent Music Labels|Music|Retail|Video Streaming,475000.0,USA,4,1,142,15594,15736,0
Software,441000.0,GBR,1,1,0,14761,14761,0
Clean Technology,100000.0,USA,1,1,0,15706,15706,0
Consumer Goods|Groceries|Retail,3050000.0,USA,2,3,822,14700,15522,0
Enterprise Software,2640000.0,FRA,1,1,0,13584,13584,0
Health Care|Medical Devices,50310333.0,USA,7,10,3034,13612,16646,0
Advertising|Android|Apps|Discounts|Gps|Indoor Positioning|Information Technology|iPhone|Local Advertising|Local Search|Location Based Services|Mobile|Mobile Advertising|Navigation|Personalization|Private Social Networking|Reviews and Recommendations|Services|Social Media|Social Network Media|Technology|Windows Phone 7|Wireless,11000000.0,RUS,2,4,889,14245,15134,0
Biotechnology,7000000.0,USA,1,1,0,15239,15239,0
Software,28000000.0,USA,4,8,1380,12080,13460,1
Analytics|Data Integration|Predictive Analytics,163000000.0,USA,4,9,1667,15069,16736,0
Hardware + Software,3000000.0,IND,1,1,0,14930,14930,0
Enterprise Software,23000000.0,USA,1,1,0,13523,13523,1
Biotechnology,32500000.0,USA,2,8,675,14704,15379,0
Biotechnology,15000000.0,USA,1,1,0,15827,15827,0
Biotechnology,3855000.0,ESP,1,1,0,15648,15648,0
Semiconductors,4310000.0,KOR,1,1,0,14574,14574,0
Software,1157500.0,USA,1,1,0,15300,15300,0
Mobile,17200000.0,USA,2,2,162,16006,16168,0
Software,21000000.0,KOR,1,1,0,13354,13354,0
Education|Mobile|Wireless,85100000.0,USA,6,21,3477,12784,16261,0
Hardware + Software,1600000.0,FRA,1,1,0,13483,13483,0
Big Data,42000000.0,USA,2,9,531,15869,16400,0
Aerospace|Drones|Internet of Things,380000.0,GBR,2,1,80,16587,16667,0
Advertising,42200000.0,USA,4,7,1597,14944,16541,0
Games,1016000.0,PHL,2,2,280,16135,16415,0
EdTech|Education,26600000.0,USA,2,5,420,14510,14930,1
Consumer Goods|Wine And Spirits,40000.0,USA,1,1,0,15639,15639,0
Semiconductors,26000000.0,CHN,4,15,1187,14287,15474,0
Mobile,19800000.0,IRL,2,3,714,15047,15761,0
Communications Infrastructure|CRM|Customer Support Tools|Marketing Automation|SaaS|Software,2000000.0,USA,1,2,0,16510,16510,0
Security,16000000.0,USA,2,6,700,13970,14670,1
Hardware + Software,1500000.0,USA,1,1,0,13521,13521,0
Software,31000000.0,USA,2,4,787,10957,11744,0
Apps|Customer Service|Mobile Payments,1000000.0,USA,1,1,0,16406,16406,0
Consulting|Semiconductors,4000000.0,FRA,1,3,0,13410,13410,1
Search|Search Marketing|SEO|Software,9499393.0,USA,4,14,1063,14379,15442,1
Education|Technology,133000000.0,USA,3,32,641,15918,16559,0
Health Care,39999999.0,USA,4,3,1051,14754,15805,0
Technology,86000000.0,USA,2,8,966,11598,12564,1
Medical|Online Education,829234.0,USA,3,2,228,16467,16695,0
Language Learning|Online Video Advertising|Video Streaming,1050000.0,DEU,1,1,0,16182,16182,0
All Students|Education|High Schools,20000.0,USA,1,2,0,15857,15857,0
Application Platforms|Design|Web Hosting,40000.0,USA,1,1,0,16440,16440,0
E-Commerce|Mobile|Social Media|Software,1300000.0,USA,1,7,0,16353,16353,0
Biotechnology,76241743.0,USA,8,17,2049,14518,16567,0
E-Commerce|Social Commerce,15590000.0,USA,3,3,490,14564,15054,1
Medical Devices,10000000.0,USA,1,5,0,12629,12629,0
Finance,7700000.0,USA,1,2,0,13915,13915,1
Networking|Services|Telecommunications,12000000.0,USA,1,4,0,11631,11631,1
Biotechnology,138012000.0,USA,6,9,2442,13397,15839,0
Education|Teachers,650000.0,USA,1,4,0,15659,15659,1
E-Commerce|Online Shopping,950000.0,TUR,2,1,679,15124,15803,0
Consulting,24858097.540840197,FRA,3,14,1108,13690,14798,0
Consulting,4250000.0,CAN,1,1,0,13545,13545,0
Advertising,117994.0,RUS,2,3,0,15765,15765,0
Biotechnology,19955000.0,USA,3,1,199,16444,16643,0
Industrial|Services|Telecommunications,12500000.0,IRL,1,3,0,12023,12023,0
Biotechnology,59059340.591424406,NLD,3,12,2592,13732,16324,0
Biotechnology,61399.0,GBR,1,1,0,15815,15815,0
Analytics|Optimization|Personalization|Reviews and Recommendations|Software|Testing,12800000.0,USA,2,3,1402,13850,15252,0
Biotechnology|Medical|Physicians,2674800.0,ESP,1,2,0,15746,15746,0
Advertising,5500000.0,IND,2,4,581,15873,16454,0
Biotechnology,25378200.0,BEL,1,4,0,15223,15223,0
Semiconductors,76000000.0,USA,4,12,3161,12293,15454,1
Enterprise Software,1000000.0,USA,1,2,0,15470,15470,0
Biotechnology,20000000.0,USA,1,4,0,15986,15986,0
Biotechnology,70000000.0,IRL,1,1,0,14530,14530,1
Information Technology|Services|Software|Technology,1626000.0,IRL,1,2,0,15736,15736,0
Mobile|Telecommunications,153721622.0,AUS,2,1,1717,14914,16631,1
Consulting,3960000.0,GGY,1,1,0,13483,13483,0
Human Resources|Information Technology|Recruiting,800000.0,RUS,2,4,293,16049,16342,0
Consumer Goods|Crowdsourcing|Delivery|E-Commerce|Groceries|Internet|Retail|Software,8000000.0,USA,1,1,0,9312,9312,1
Security,430548.0,GBR,1,1,0,16210,16210,0
Broadcasting|Security|Semiconductors,15400000.0,USA,1,3,0,13180,13180,1
Internet Marketing|Sales and Marketing|Social Commerce|Social Media Marketing|Software,5184434.0,USA,5,10,1626,14975,16601,0
Software,6700000.0,USA,1,3,0,11992,11992,1
Ad Targeting|App Marketing|Apps|Big Data|Mobile|Technology,40000.0,CHL,1,1,0,16222,16222,0
Leisure|Search|Travel,500000.0,USA,1,7,0,16531,16531,0
Curated Web,41900000.0,USA,3,14,1620,12006,13626,1
Semiconductors,53300000.0,USA,5,15,3675,11694,15369,0
Music,118000.0,GBR,1,1,0,16622,16622,0
Health Care,1762800.0,USA,2,3,554,16120,16674,0
Mobile,10257000.0,USA,5,12,989,13149,14138,0
Active Lifestyle|Fitness|Health and Wellness,500000.0,USA,2,1,120,16375,16495,0
iPhone|Location Based Services|Mobile|Software|Startups,900000.0,GBR,2,4,446,14195,14641,0
Internet of Things|Semiconductors|Wearables,36958609.0,USA,9,17,1793,14791,16584,0
Biotechnology,193727869.0,USA,7,37,2735,12915,15650,1
Enterprise Software|SaaS,2000000.0,USA,2,18,123,16102,16225,0
Education,559521.0,GBR,1,1,0,15224,15224,0
Customer Service|EdTech|Education,167000000.0,CHN,3,10,934,13239,14173,1
Clean Technology|Energy|Fuels,50000000.0,USA,3,9,1095,15095,16190,0
Biotechnology,706924.0,SWE,1,1,0,13472,13472,0
Health Care|Nutrition|Organic,702824.0,FIN,2,1,454,16254,16708,0
Biotechnology,10000000.0,USA,1,7,0,14335,14335,0
Software,1120000.0,GBR,1,1,0,15019,15019,0
Biotechnology,6747501.0,DEU,1,1,0,16274,16274,0
Biotechnology|Health Care,142825000.0,USA,6,4,2603,13650,16253,1
Biotechnology,989240.0,DEU,1,2,0,14629,14629,0
Carbon|Clean Energy|Open Source|Software|Sustainability,10750000.0,GBR,5,6,2131,13879,16010,1
Application Platforms|Consulting|Corporate Training|Information Technology|Online Education|Outsourcing,20000.0,NGA,1,1,0,16616,16616,0
Finance|Real Estate|Senior Citizens,4000000.0,USA,1,1,0,14460,14460,0
Manufacturing,23466222.0,USA,5,3,2802,13845,16647,0
Aerospace,350000.0,USA,1,1,0,16603,16603,0
Fashion|Manufacturing|Retail,25000000.0,USA,1,1,0,16260,16260,0
Clean Technology,4030000.0,USA,1,1,0,14014,14014,0
Pharmaceuticals,10000000.0,USA,1,1,0,16609,16609,0
Clean Technology,4500000.0,USA,1,1,0,16050,16050,0
Health Care|Healthcare Services|Hospitals,70000000.0,USA,1,2,0,12514,12514,0
Telecommunications,6000000.0,USA,1,3,0,12293,12293,1
Health and Wellness,1000000.0,USA,1,1,0,13371,13371,0
Clean Technology,250000.0,USA,1,1,0,14146,14146,0
Cooking|Digital Media|Social Network Media,5519437.0,USA,4,8,448,15317,15765,0
Manufacturing,150000.0,USA,1,1,0,15955,15955,0
Biotechnology|Health Diagnostics,5999999.0,USA,1,1,0,15584,15584,0
Education|Mobile Commerce|Software,3460000.0,USA,2,2,125,16444,16569,0
Biotechnology,2500000.0,USA,1,1,0,14440,14440,0
Biotechnology,133149345.0,USA,4,1,2113,14540,16653,0
Design,40000.0,USA,1,1,0,15749,15749,0
Communities|Curated Web|Portals,4400000.0,USA,2,1,427,13330,13757,0
Pharmaceuticals,35000000.0,USA,1,1,0,16444,16444,0
Education,6800000.0,USA,1,1,0,15414,15414,0
Business Services|Enterprise Software|Location Based Services|Maps,40000.0,USA,1,1,0,15379,15379,0
Software,5000000.0,IND,1,1,0,16619,16619,0
Clean Technology,9000000.0,ISR,1,1,0,14245,14245,1
Analytics,2000000.0,USA,1,6,0,15779,15779,1
Biotechnology,9000000.0,USA,1,1,0,11645,11645,1
Colleges|Innovation Management|Nonprofits|Politics|Social Media|Software,3780000.0,USA,2,23,286,15371,15657,0
Apps|Mobile|Mobile Commerce,18015.0,IND,2,1,7,16540,16547,0
Biotechnology|Health Care,105866943.0,USA,5,9,3519,12551,16070,1
Curated Web|Marketplaces|Music,3900000.0,USA,2,2,799,13726,14525,1
Computers|Service Providers|Translation,129679.0,FRA,1,1,0,15674,15674,0
Exercise|Fitness|Hardware|Hardware + Software|Health and Wellness|Technology|Tracking|Wearables,1750000.0,USA,2,2,411,15721,16132,0
Semiconductors,52120000.0,ISR,6,19,3798,12799,16597,0
E-Commerce,40000.0,ESP,1,1,0,15407,15407,0
Health Care|Healthcare Services,26400000.0,USA,3,5,560,16168,16728,0
Communities|Interest Graph|Mobile|Social Media,8150000.0,USA,2,14,442,16260,16702,0
Biotechnology,25000000.0,USA,1,4,0,13595,13595,1
Estimation and Quoting|Opinions|Social Media|Social Network Media|Startups|Video Streaming,2500000.0,GBR,1,1,0,15746,15746,0
Energy|Oil and Gas|Startups,150000000.0,USA,1,1,0,16624,16624,0
Software,10000000.0,USA,1,2,0,14061,14061,1
Real Estate,4309987.0,USA,2,8,583,16078,16661,0
Nonprofits|Web Development,9000000.0,CHE,1,2,0,15390,15390,0
Clean Technology,9782500.0,DNK,1,2,0,13775,13775,0
Technology,14000000.0,USA,1,5,0,11484,11484,0
Biotechnology,833000.0,USA,1,1,0,16589,16589,0
Diagnostics|Manufacturing|Medical Devices,13037350.0,USA,3,5,1430,13024,14454,0
Biotechnology,25000000.0,GBR,1,2,0,16708,16708,0
Big Data|Brand Marketing|Digital Media|Internet Marketing|Mobile|Social Media Marketing|Technology|Video,72000000.0,USA,6,16,1581,13453,15034,1
Environmental Innovation,888722.0,FRA,1,1,0,16252,16252,0
Clean Technology,154400000.0,USA,2,10,148,14572,14720,0
Small and Medium Businesses,5000000.0,HKG,1,2,0,16393,16393,0
B2B|CRM|E-Commerce|Enterprise Resource Planning|iOS|Mobile|Point of Sale|Retail Technology|SaaS|Software|Supply Chain Management,711518.0,USA,2,1,593,15807,16400,0
Electrical Distribution|Energy|Energy Management,2578524.0,CHE,1,2,0,16407,16407,0
Mobile,374000000.0,USA,4,28,590,13003,13593,0
Manufacturing,30000000.0,HKG,1,2,0,12053,12053,1
Distribution|Smart Grid|Web Hosting,12900000.0,USA,2,9,1195,12755,13950,0
Hardware + Software,5000000.0,USA,1,1,0,14155,14155,0
Biotechnology,43000000.0,USA,2,7,1072,11688,12760,1
Biotechnology,13382106.0,USA,2,1,770,15861,16631,0
Babies|Curated Web|Finance|FinTech|Parenting,18000.0,USA,1,1,0,14497,14497,0
Cars|Parking|Software,32524.0,DEU,1,1,0,15779,15779,0
Biotechnology,7265271.0,USA,3,4,1608,13488,15096,0
Hardware + Software,25500000.0,USA,2,7,326,12458,12784,0
Specialty Foods,4000000.0,USA,1,6,0,16755,16755,0
Analytics|Cloud Computing|Cloud Data Services,44074955.0,BEL,6,18,1566,14755,16321,1
Brand Marketing|E-Commerce,28192646.0,GBR,5,9,1731,15027,16758,0
Brand Marketing|Enterprise Software|Marketing Automation|Technology,15589114.0,USA,4,7,1956,14619,16575,0
Finance,8100000.0,USA,2,20,159,15926,16085,0
Biotechnology,14140433.0,USA,3,4,779,13892,14671,0
Biotechnology|Health and Wellness|Medical|Pharmaceuticals,20000000.0,USA,1,2,0,13149,13149,1
Finance,22094400.0,GBR,1,1,0,15280,15280,0
Health Care,6706000.0,USA,3,4,365,15584,15949,0
Biotechnology,1000000.0,USA,1,4,0,16442,16442,0
Biotechnology,43990999.0,USA,4,4,744,15761,16505,1
Child Care|Cloud Data Services|Hardware + Software|Medical Devices|Mobile Health,205032.0,FRA,3,4,546,15706,16252,0
Analytics|Big Data|Mobile Analytics|SaaS,11000000.0,USA,4,15,1312,15340,16652,0
Electronics,39079461.0,FRA,1,4,0,15364,15364,0
Pharmaceuticals,42000000.0,USA,2,3,85,16665,16750,0
Curated Web,467880.0,DEU,1,1,0,13994,13994,0
Nanotechnology,55000000.0,USA,2,9,1040,15036,16076,0
Energy|Innovation Management|Technology,25000000.0,USA,1,3,0,16631,16631,0
Legal,15980000.0,USA,4,2,1075,14549,15624,0
Advertising|Advertising Platforms|Digital Media|Mobile Advertising,15000000.0,USA,1,1,0,16728,16728,0
Energy|Technology,950000.0,USA,2,6,563,16167,16730,0
Biotechnology,3242399.0,GBR,3,9,914,13604,14518,0
Electrical Distribution|Mechanical Solutions|Test and Measurement,50000.0,USA,1,1,0,16008,16008,0
Curated Web,1865000.0,USA,2,5,529,15718,16247,0
Software|Transportation,6779357.0,IRL,2,4,455,11372,11827,0
Consulting,5000000.0,USA,1,1,0,13049,13049,0
Games,10000000.0,CHN,1,1,0,14319,14319,0
Hardware + Software,9541187.0,USA,2,2,554,13805,14359,0
Biotechnology,1700000.0,USA,1,2,0,13577,13577,0
Health Care,255000.0,USA,2,3,91,15765,15856,0
Biotechnology,1840000.0,GBR,1,1,0,12904,12904,0
Brand Marketing|Content|Games|Networking,1500000.0,GBR,1,1,0,14530,14530,0
Biotechnology,2800000.0,CHE,1,1,0,14651,14651,0
Software,250000.0,USA,1,1,0,15658,15658,0
Biotechnology|Chemicals|Clean Technology|Renewable Energies,417040423.0,USA,10,16,1964,13433,15397,1
Corporate Training|Software,100000.0,USA,1,1,0,16041,16041,0
Agriculture|Financial Services|Startups,90000000.0,VNM,1,1,0,16342,16342,0
Analytics,1318297.0,USA,1,1,0,15068,15068,0
Services,3000000.0,GBR,1,3,0,16554,16554,0
Software,1481639.0,SWE,1,2,0,15460,15460,1
Energy Management|Enterprise Software|Technology,1970000.0,SGP,2,3,2526,13514,16040,0
Consulting,7500000.0,USA,1,1,0,14403,14403,1
Biotechnology,3240000.0,FRA,1,1,0,14809,14809,0
Biotechnology|Health Care,198500000.0,USA,8,17,3876,11992,15868,1
Semiconductors|Technology,15000000.0,GBR,1,4,0,12327,12327,0
Clean Technology,46256055.0,CAN,1,4,0,15985,15985,0
Waste Management,15000000.0,USA,1,3,0,11975,11975,0
Web Hosting,34600000.0,USA,3,11,1034,13103,14137,0
Biotechnology|Diagnostics|Pharmaceuticals,600000.0,USA,2,2,379,13747,14126,0
Semiconductors,39400000.0,USA,3,14,1509,12964,14473,0
Artificial Intelligence|Knowledge Management,587090.0142701439,HUN,2,2,608,16071,16679,0
Finance|Financial Services|Mobile|Personal Finance,66000000.0,USA,3,30,522,16040,16562,0
Health Care,38550000.0,USA,5,8,1363,14183,15546,0
Biotechnology,3040000.0,DEU,1,2,0,12901,12901,0
Software,1515251.0,GBR,1,1,0,16133,16133,0
Analytics|Big Data|Health Care|Optimization|Staffing Firms,120000.0,USA,2,3,134,16405,16539,0
Analytics|Big Data Analytics|Enterprise Software|Finance Technology|Financial Services|FinTech|Insurance|Predictive Analytics,1346153.0,CAN,1,4,0,16014,16014,0
Messaging,16940000.0,IRL,1,3,0,13181,13181,0
Analytics|Big Data|Internet|Media|SaaS,5550000.0,USA,3,3,767,14855,15622,1
Design,20000.0,USA,1,1,0,16757,16757,0
Biotechnology|Health Diagnostics,1000000.0,DNK,1,2,0,13538,13538,0
Biotechnology,24300000.0,USA,3,8,495,13909,14404,0
Cloud Computing|Enterprise Software,144400000.0,USA,3,14,845,15358,16203,0
Analytics,100000.0,USA,1,1,0,15857,15857,0
Biotechnology,85946511.0,USA,5,12,3271,13360,16631,0
Software,125000000.0,USA,2,2,92,15903,15995,0
Software,3241000.0,FRA,2,2,1604,13312,14916,0
Biotechnology|Health Diagnostics,1277500.0,USA,2,2,256,15778,16034,0
E-Commerce|Internet,333200000.0,USA,2,5,2967,10835,13802,1
Web Hosting,7000000.0,USA,1,1,0,13269,13269,0
Semiconductors|Video,10000000.0,USA,2,3,1354,12188,13542,1
Material Science,25000000.0,USA,1,2,0,16633,16633,0
Semiconductors,7200000.0,USA,1,1,0,13424,13424,0
Biotechnology,10000000.0,USA,1,3,0,14841,14841,0
Mobile Security|Privacy|Security|Wireless,62800000.0,USA,3,11,2332,13149,15481,0
Advertising,6000000.0,USA,2,9,243,13514,13757,0
Big Data Analytics|Data Visualization|FinTech|Fraud Detection,6367595.0,GBR,2,5,276,16423,16699,0
Biotechnology,800000.0,USA,2,1,921,13636,14557,0
Mobile,10500000.0,USA,1,3,0,13305,13305,0
Analytics|Biotechnology|Clean Technology|Water Purification,4313980.0,USA,4,1,1039,15370,16409,0
Design,40000.0,CHL,1,1,0,15440,15440,0
Hardware + Software,1140000.0,GBR,1,1,0,14159,14159,0
Recruiting|Software,13000000.0,USA,2,16,275,16336,16611,0
Finance,9350000.0,USA,2,3,879,14000,14879,1
Aerospace|Manufacturing,250000.0,USA,1,1,0,15273,15273,0
Biotechnology,75000000.0,USA,1,1,0,15838,15838,1
Incubators,97956.0,PER,2,2,306,15796,16102,0
Analytics|Market Research|Technology,1550000.0,CHE,2,1,494,16192,16686,0
Semiconductors,29600000.0,USA,4,13,1313,12251,13564,0
Software,1000000.0,USA,1,1,0,15573,15573,0
Biotechnology,500000.0,USA,1,3,0,14253,14253,0
Android|Cloud Computing|Mobile|Operating Systems|Software,3000000.0,USA,1,6,0,16469,16469,0
Contact Management|E-Commerce|Mobile|Nonprofits|SaaS,1200000.0,USA,1,1,0,15584,15584,0
Biotechnology,35000000.0,CHE,2,3,1346,15061,16407,0
Biotechnology,30000000.0,USA,3,1,534,13865,14399,1
Mobile,8330000.0,FRA,2,3,1240,13104,14344,0
Blogging Platforms|Digital Media|News|Personalization,4300000.0,RUS,2,5,505,15958,16463,0
Blogging Platforms|News|Social Media|Social Network Media,4360000.0,USA,2,2,608,15675,16283,0
Nanotechnology,10000000.0,EST,1,1,0,15791,15791,0
Nanotechnology|Startups|Technology|Water Purification,50000.0,USA,1,1,0,16007,16007,0
Design|Energy|Social Entrepreneurship,5500000.0,USA,2,1,693,16038,16731,0
Curated Web,75176.0,GBR,1,1,0,15767,15767,0
E-Commerce|Fashion|Kids,236490.0,BGR,2,2,90,16405,16495,0
Hospitality,16474464.0,CHN,1,1,0,16071,16071,0
Clean Technology,10564800.0,BRA,1,1,0,15455,15455,0
Specialty Foods,329122.0,MUS,1,1,0,16102,16102,0
Ad Targeting|Advertising Exchanges|Advertising Platforms|SaaS,500000.0,TUR,1,2,0,15909,15909,0
Databases|Finance|Recruiting|Startups,24100000.0,USA,6,35,318,15908,16226,0
Crowdfunding|Finance|Medical|Medical Devices|mHealth|Physicians|Venture Capital,1500000.0,USA,2,1,0,16070,16070,0
Incubators|Pre Seed|Venture Capital,7000000.0,USA,1,1,0,16301,16301,0
Consulting,1930000.0,ESP,1,2,0,13524,13524,0
Apps|Entertainment|Mobile|Music|Video Streaming,2750000.0,LBN,2,2,549,15553,16102,0
Advertising|Curated Web|Local|Reviews and Recommendations|Services,182600000.0,USA,9,8,1967,13300,15267,1
Biotechnology,9807000.0,CAN,3,4,1064,12784,13848,0
Health and Wellness,1157940.0,ITA,1,2,0,16000,16000,0
Medical,875000.0,USA,1,2,0,12524,12524,0
Biotechnology,42000000.0,USA,2,7,1289,13795,15084,1
Health Care,33150000.0,USA,7,22,3073,13483,16556,0
Audio|iOS|iPad|iPhone|News|Technology|Venture Capital,1075000.0,USA,2,2,847,15126,15973,0
B2B|Internet|Media|Startups,35000.0,USA,1,1,0,16080,16080,0
Software,225000.0,USA,1,1,0,13634,13634,1
Governments|SaaS|Small and Medium Businesses,800000.0,RUS,1,1,0,15979,15979,0
Software,6157940.0,CHN,5,4,3468,11323,14791,0
Automotive|E-Commerce|Internet|Mobile|Mobile Commerce|Public Transportation|Transportation,1176830000.0,IND,7,26,1671,15085,16756,0
Collaboration|Games|Video,14500000.0,ISR,2,4,486,13545,14031,0
Pets,1667200.0,FRA,2,3,713,15826,16539,0
Apps|Health and Wellness|Pets|Startups,335068.0,ESP,2,8,123,15856,15979,0
Biotechnology,150000.0,USA,1,1,0,16315,16315,0
Software,250000.0,USA,1,3,0,13535,13535,0
Mobile,25000.0,RUS,1,1,0,15400,15400,0
Games,213000.0,ESP,1,1,0,13149,13149,0
3D|Content|Games|Graphics|Virtual Worlds,150000.0,USA,1,1,0,14791,14791,0
Entertainment|Mobile Games|Online Gaming,5700000.0,HKG,2,1,149,16621,16770,1
Music|Photography|Presentations|Video,30000000.0,USA,3,7,1428,13726,15154,0
Crowdfunding|Curated Web|Entrepreneur|Finance|Graphics,104292.0,JPN,2,2,0,15638,15638,0
Finance|Online Gaming|Web Development,100000.0,ISR,1,1,0,16252,16252,0
Real Estate,72000000.0,CHN,4,5,1254,13787,15041,0
Biotechnology,8500000.0,USA,1,3,0,16609,16609,0
Artificial Intelligence|Cars|Consumer Electronics|Entertainment|Games|Hardware + Software|Robotics,105000000.0,USA,2,7,482,15857,16339,0
Non Profit,500000.0,USA,1,1,0,16248,16248,0
Fashion,265064.0,ESP,1,1,0,15867,15867,0
Finance,9200000.0,IND,2,3,378,16155,16533,0
E-Commerce,6235547.0,TUR,3,11,948,15492,16440,0
Biotechnology,34999999.0,USA,2,3,1211,15208,16419,0
Hardware + Software,5000000.0,CAN,1,1,0,15982,15982,0
Biotechnology,10375000.0,USA,3,3,482,15111,15593,1
Enterprise Software,5600000.0,USA,1,4,0,13418,13418,1
Biotechnology,37500000.0,CHE,1,3,0,16199,16199,0
Social Media,1372725.0,USA,3,3,399,15875,16274,0
Apps|Brand Marketing|Sales and Marketing|Search,386483.0,ESP,2,2,364,15750,16114,0
Biotechnology,2500000.0,USA,1,2,0,12144,12144,0
Mobile,6090909.0,CHN,1,1,0,14975,14975,0
Automotive|Cloud Computing|Enterprise Software,6000000.0,USA,1,2,0,15929,15929,1
Content Creators,9000000.0,USA,1,1,0,16596,16596,0
Email Marketing,700000.0,USA,1,3,0,16405,16405,0
Information Technology|Software,5440000.0,USA,2,10,651,16041,16692,0
Curated Web|Information Technology,384410000.0,USA,9,19,5773,10592,16365,1
Software,307000.0,SWE,1,1,0,13916,13916,0
VoIP,2400000.0,USA,1,3,0,12499,12499,0
Biofuels|Energy|Innovation Engineering,358443.0,GBR,1,1,0,16295,16295,0
Security,6100000.0,ITA,1,1,0,15543,15543,0
Advertising|Apps|Email|Gambling|Infrastructure Builders|Promotional|SaaS|Sales and Marketing|Social Media|Software,65478.0,GBR,1,1,0,15436,15436,0
Software,1280000.0,GRC,1,1,0,13300,13300,1
Android|Apps|iPhone|Mobile|Real Time|Sports,160000.0,CHL,2,3,182,15218,15400,0
Biotechnology,100000.0,USA,2,1,916,15797,16713,0
Medical,11313.0,EST,1,1,0,15933,15933,0
Consumer Electronics,3000000.0,USA,3,1,728,15887,16615,0
Hardware + Software,28500000.0,GBR,3,13,1370,12803,14173,0
Clean Technology,7000000.0,CAN,1,1,0,15943,15943,0
Hardware + Software,17720000.0,NLD,4,7,736,14031,14767,0
Biotechnology|Health Care,50500000.0,USA,2,8,768,14105,14873,1
Software,15000000.0,USA,2,3,410,12775,13185,0
Big Data|Data Integration|Semantic Search,3500000.0,FRA,1,1,0,14975,14975,0
Games,3000000.0,GBR,1,2,0,14383,14383,0
Boating Industry|ICT|Online Travel|Sailing Community|Social Travel|Travel|Travel & Tourism|Vacation Rentals,779302.0,ITA,2,4,184,16427,16611,0
Health Care,3462380.0,SWE,2,1,1444,15216,16660,0
Classifieds|Databases|Local Based Services|Location Based Services|Marketplaces|Mobile|Real Time|Twitter Applications|Wireless,825000.0,USA,5,1,1663,14610,16273,0
Analytics|Big Data|Supply Chain Management,59990440.0,SGP,2,3,527,15930,16457,0
E-Commerce|Media|Software,1067625.0,FRA,1,4,0,15145,15145,0
Biotechnology,52280000.0,USA,4,10,1413,13354,14767,0
Enterprise Software,3000000.0,IND,1,1,0,15750,15750,0
Software,2550000.0,USA,2,4,132,14089,14221,0
Semiconductors,1856685.0,GBR,2,3,837,15164,16001,0
Android|Browser Extensions|Events|iPhone|Mobile|Productivity Software|Utilities,4500000.0,ISR,3,13,887,15288,16175,0
Crowdsourcing|Enterprises|Search,2428205.0,JPN,2,4,324,16246,16570,0
Chat|Messaging,500000.0,ISR,2,1,365,14276,14641,0
Advertising|Advertising Platforms|Big Data|Content Delivery|Content Syndication|Developer APIs|Digital Media|Entertainment|Film|Internet Marketing|Publishing|Search|Television|Video|Web Development,21000000.0,USA,1,4,0,16630,16630,0
Curated Web|Mobile|Social Media,175000.0,USA,3,6,1344,15156,16500,0
B2B|Crowdsourcing|Curated Web|Language Learning,1080000.0,JPN,3,6,1281,14698,15979,0
Mobile|Telecommunications|Wireless,3040733.0,SWE,2,2,0,15595,15595,0
3D|Content|Graphics|Public Relations,2306560.0,BEL,1,1,0,13865,13865,0
Energy Management,500000.0,AUT,1,1,0,16415,16415,0
Software|Telecommunications|Video Conferencing,2600000.0,USA,2,6,489,15565,16054,0
Games,1000000.0,USA,1,6,0,15820,15820,0
Discounts|E-Commerce|Employer Benefits Programs|Human Resources|Incentives|Loyalty Programs|Subscription Businesses,14350000.0,USA,4,20,1008,15461,16469,0
Android|Apps|Cloud Computing|Developer APIs|Enterprise Software|iOS|Mobile|Mobile Software Tools|Mobility|PaaS|SaaS|Web Development,13500000.0,USA,3,7,1187,15156,16343,0
Hardware + Software|Internet|Television|Video Streaming,3200000.0,USA,1,2,0,14319,14319,1
Software,70000000.0,USA,4,8,2594,10957,13551,1
Hardware + Software,3700000.0,CAN,1,3,0,13080,13080,0
Ticketing|Travel,10000000.0,USA,1,1,0,14816,14816,0
Apps|Insurance Companies|Real Time|Services,2000000.0,THA,2,13,467,16296,16763,0
Mobile,10000000.0,CHN,1,1,0,15156,15156,0
Sports,380000.0,USA,1,3,0,15483,15483,0
Education,4392386.0,CHN,1,1,0,14579,14579,0
Advertising Platforms|Content Creators|Digital Media|News,1000000000.0,USA,1,1,0,13118,13118,1
Travel,1500000.0,CHN,1,1,0,16454,16454,0
Software,7576257.0,GBR,1,1,0,16147,16147,0
Biometrics|Biotechnology|Security,89877849.0,USA,4,16,2911,13663,16574,0
Enterprise Security|Network Security|Security,11000000.0,ISR,2,6,385,15706,16091,1
Biotechnology,5800000.0,USA,1,2,0,13494,13494,1
Hardware|Innovation Management|Services|Startups,2000000.0,USA,2,2,807,15706,16513,0
Clean Technology|Cloud Infrastructure,6346880.0,DEU,3,4,610,15826,16436,0
Internet|Telecommunications|Telephony,30000000.0,USA,1,6,0,11477,11477,0
Semiconductors,19900000.0,USA,2,5,1591,13199,14790,0
Mobile|Software|Wireless,2600000.0,USA,1,1,0,13628,13628,0
Entertainment|Games|Internet|Messaging,2524025.0,FIN,1,1,0,13818,13818,0
Content|Digital Media|Entertainment|Mobile|Video Streaming,18500000.0,IND,3,9,1157,14518,15675,0
Biotechnology,21800000.0,USA,3,4,1828,14620,16448,0
DIY|Home Decor|Online Shopping,1000000.0,RUS,1,1,0,15614,15614,0
Curated Web|Online Rental|Real Estate,37000000.0,USA,5,17,1925,14518,16443,0
Entertainment|Event Management|Performance Marketing,600000.0,USA,1,2,0,15645,15645,0
Cloud Computing|Cloud Infrastructure|Cloud Security|Data Center Infrastructure|Enterprise Software|Governance|Software,7200000.0,USA,3,7,868,15468,16336,0
Software,3800000.0,USA,1,2,0,14438,14438,0
Big Data|Fitness|Health and Wellness|SaaS|Sports|Training,20000.0,USA,1,1,0,15949,15949,0
Biotechnology,55509987.0,USA,4,2,1656,14750,16406,0
Biotechnology,3950000.0,AUT,1,2,0,14826,14826,0
E-Commerce|Fashion|Retail,100000.0,USA,1,1,0,15645,15645,0
Hardware + Software,15196305.0,USA,5,4,1469,15181,16650,0
Hardware + Software,46420307.0,USA,4,10,2837,12724,15561,1
Bioinformatics|Biotechnology|Diagnostics,375000.0,USA,1,1,0,16526,16526,0
Biotechnology,5439942.0,USA,2,1,624,15125,15749,0
Mobile,30000000.0,GBR,1,6,0,13185,13185,1
Mobile|Wireless,160279779.0,USA,15,52,4058,10592,14650,1
Clean Technology,16000000.0,USA,1,3,0,13924,13924,0
Education,24661724.0,USA,4,2,3913,11962,15875,0
Biotechnology,2763899.0,USA,3,1,1727,14883,16610,0
Biotechnology,20000000.0,USA,1,5,0,15923,15923,0
Alternative Medicine,6200000.0,CAN,1,1,0,16227,16227,0
Artificial Intelligence|Assisitive Technology|Audio|Mobile|Natural Language Processing,8600000.0,USA,4,14,1181,15485,16666,0
Software,17200000.0,USA,2,5,1483,12090,13573,1
Cloud Computing|Consumer Electronics|Developer APIs|SaaS|Services|Testing,40000.0,USA,1,3,0,16440,16440,0
Data Integration|Developer APIs|Infrastructure|Software|Testing,8550000.0,USA,3,9,1334,15331,16665,0
Enterprise Software,11280162.0,SWE,5,12,1862,13661,15523,0
Apps|Development Platforms|Mobile,5000000.0,CHN,2,2,105,16357,16462,0
Biotechnology|Health Care|Medical Devices,43500000.0,USA,4,8,2344,12053,14397,0
Cloud Data Services|Enterprise Software,173000000.0,USA,7,34,3315,12874,16189,1
Analytics|Big Data|Testing,650000.0,USA,2,1,140,16343,16483,0
Computers|Mobile|Mobile Commerce|Software,8263276.0,USA,2,2,50,16337,16387,0
Biotechnology,13456610.0,GBR,1,5,0,16707,16707,0
Information Technology|Software|Technology,1160000.0,ESP,1,2,0,13818,13818,1
Credit|Finance|Marketplaces,17200000.0,IND,2,4,305,13543,13848,0
Health Care,60100000.0,USA,4,11,1960,13647,15607,0
Medical Devices,5099000.0,USA,1,2,0,15796,15796,0
Hardware + Software,9700000.0,USA,1,6,0,12990,12990,0
Design|E-Commerce|Internet|SEO|Software|Web Development,70000.0,USA,3,2,68,15645,15713,0
Biotechnology,10000000.0,DEU,1,1,0,15398,15398,0
EdTech|Education,3000000.0,USA,1,2,0,15078,15078,0
Biotechnology|Health Care|Medical Devices,267827392.0,USA,8,8,2710,13794,16504,0
Health Care,14155000.0,USA,3,1,1260,15036,16296,0
Local Search|Mobile,15000000.0,BRA,1,1,0,16338,16338,0
Biotechnology,22300000.0,ISR,3,12,1291,13461,14752,1
Health Care,31000000.0,USA,3,7,1090,15309,16399,0
Health Care,20000.0,USA,1,1,0,16270,16270,0
Cloud Computing|Enterprises|Gamification|Information Security|SaaS|Security|Training,800000.0,USA,4,3,473,15963,16436,0
Analytics|Big Data Analytics|Mobile,94000000.0,USA,5,21,1286,15162,16448,0
Aerospace|Chat|Incentives|In-Flight Entertainment|iPhone|Mobile|Travel,250000.0,RUS,2,2,274,15187,15461,0
Android|Customer Service|Enterprise Software|iOS|Mobile|SaaS|Sales and Marketing,1195000.0,USA,3,9,394,15452,15846,0
Advertising,3000000.0,USA,3,2,1289,14643,15932,0
Software,1059500.0,USA,2,1,290,16309,16599,0
Software,331000.0,JPN,1,1,0,14237,14237,0
Apps|Mobile Software Tools,964997.0,USA,3,30,595,16092,16687,0
Apps|Enterprise Software,1750000.0,USA,2,1,480,14997,15477,0
Finance Technology|FinTech|Mobile Payments|Payments,1700000.0,GBR,1,1,0,15481,15481,0
Advertising|Facebook Applications,1200000.0,USA,2,3,162,15196,15358,0
Online Rental|Parking|Price Comparison,270820.0,ESP,1,1,0,16234,16234,0
Advertising|B2B|Local|Sales and Marketing|Social Media|Sponsorship,1815000.0,USA,3,18,1096,14579,15675,0
Flash Storage|Homeland Security|Software,6000000.0,USA,1,1,0,14019,14019,1
App Discovery|Apps|Hardware|Marketplaces|Mobile Devices,1299787.0,USA,3,2,1956,14568,16524,0
Enterprise Software,9600000.0,USA,2,3,949,14585,15534,0
Android|Apps|Developer Tools|iOS|Mobile|Startups,2525563.0,USA,5,1,1310,14706,16016,0
Databases|SaaS,380000.0,USA,3,1,457,16252,16709,0
Developer APIs|Facebook Applications|Marketplaces|Mobile,600000.0,USA,2,9,224,14610,14834,0
Analytics|Android|Apps|CRM|iOS|Marketing Automation|Mobile|Social Media|Software,22500000.0,USA,4,14,1044,15301,16345,0
Analytics|Business Intelligence|Loyalty Programs,6500000.0,USA,1,4,0,15340,15340,0
Advertising Exchanges|Employment|Human Resources|Recruiting,7400000.0,USA,2,4,531,16220,16751,0
Enterprise Software|Mobile|Mobility|Open Source,87900000.0,USA,9,38,2460,14214,16674,0
Information Technology|Internet|SaaS|Software,7500000.0,USA,1,4,0,16413,16413,0
Government Innovation|Mobile|Open Source|PaaS,1100000.0,USA,1,1,0,16653,16653,0
Marketing Automation,10000000.0,CHN,1,1,0,16679,16679,0
Apps|Mobile|Software,22623720.0,USA,5,5,1672,14973,16645,0
Cloud Computing|Cloud Management|Enterprise Software,11600000.0,USA,4,9,1584,14549,16133,0
Productivity Software,1200000.0,USA,1,7,0,16427,16427,0
Apps|Enterprise Software|IaaS|PaaS|SaaS,245750000.0,USA,6,18,1623,15092,16715,0
Advertising,5265646.0,KOR,2,1,281,15692,15973,0
Enterprise Software|Mobile Security|Security,14000000.0,USA,3,8,1472,15278,16750,0
Software,1500000.0,IND,1,1,0,16273,16273,0
Application Performance Monitoring|Apps|Business Analytics|Information Services|Information Technology|Internet|Software,364500000.0,USA,7,32,2890,13879,16769,0
Brand Marketing|Fashion|Local Commerce|Marketplaces|Real Estate|Retail|Shopping,9400000.0,GBR,2,17,369,16031,16400,0
B2B|Construction|Enterprise Software|Mobile|Mobility|PaaS|SaaS|Software|Transportation|Web Development,7267800.0,SWE,1,1,0,13160,13160,0
Hospitality|Local Search|Online Reservations|Restaurants,161947.0,ITA,3,1,386,16036,16422,0
Big Data Analytics|Education|Mobile|Tutoring,1800000.0,HKG,2,3,44,16666,16710,0
Apps|B2B|Mobile|Software,550000.0,USA,2,3,1218,15042,16260,0
Mobile,20000.0,ZAF,1,1,0,15614,15614,0
Application Performance Monitoring|Cloud Management|Enterprise Software|Virtualization,2916745.0,USA,2,1,554,15614,16168,0
Android|App Stores|Enterprises|iOS|iPad|iPhone|Mobile,39400000.0,USA,6,18,2231,14456,16687,0
Analytics|Legal|Real Time,500000.0,GBR,2,1,236,15954,16190,0
Local Businesses|Network Security|Restaurants|SaaS|Sales and Marketing,120000.0,USA,3,4,341,15576,15917,1
iPhone|Mobile,40000.0,USA,1,1,0,15972,15972,0
Analytics|Application Performance Monitoring|Enterprise Software|SaaS,20025000.0,USA,6,8,2069,14407,16476,0
Analytics,4100000.0,USA,1,4,0,12877,12877,1
Real Estate,30000000.0,USA,2,5,443,14031,14474,1
App Stores|Mobile|Mobile Analytics,25000.0,RUS,2,1,86,16467,16553,0
Mobile|Services|Wireless,8300000.0,USA,1,3,0,12251,12251,0
Advertising|Artificial Intelligence|Business Intelligence|Internet Marketing|Social Media Marketing,2200000.0,ISR,3,8,389,15737,16126,0
Cloud Computing|Cloud Infrastructure|Enterprise Software|Infrastructure,7000000.0,USA,1,1,0,16595,16595,0
Apps|Consulting|Graphics|Mobile|Technology,15000.0,UGA,1,1,0,14295,14295,0
Meeting Software|Network Security|Security,3180000.0,SWE,1,1,0,13220,13220,1
iOS|Mobile,15000.0,CAN,1,1,0,15851,15851,0
App Stores|Mobile,13500000.0,FRA,1,1,0,15706,15706,0
Android|Apps|Cloud Computing|Internet|iPhone|Mobile|Mobile Software Tools|Web Development,3500000.0,USA,2,2,604,15551,16155,0
Mobile,1800000.0,CAN,1,3,0,15526,15526,1
Advertising|App Stores|Mobile,44250000.0,USA,8,10,1992,14031,16023,1
Application Platforms|Business Productivity|Cloud Computing|Collaboration|Enterprise Software|Mobile|Mobile Enterprise|Social Business|Software|Web Development|Web Tools,47499994.0,USA,2,2,2051,14081,16132,0
Analytics|Artificial Intelligence,29000000.0,TWN,2,6,503,16239,16742,0
Development Platforms|Mobile|PaaS|SaaS,318627.0,CAN,1,1,0,15483,15483,1
Application Platforms|Internet|Software,15500000.0,USA,2,7,205,12227,12432,1
Mobile|Social Media,600000.0,USA,2,2,242,16314,16556,0
Advertising Platforms|Apps|Games|Mobile|Mobile Advertising,1200000.0,USA,1,3,0,15881,15881,0
Opinions|Social Media|Software,5600000.0,USA,3,1,639,15187,15826,1
Cyber Security|Mobile Security|SaaS,2300000.0,USA,1,1,0,16667,16667,0
Mobile|Mobile Software Tools,2250000.0,GBR,4,2,416,16055,16471,0
Automated Kiosk|Internet Marketing|Mobile,6000000.0,SGP,1,1,0,16402,16402,0
iOS|iPhone|Mobile Commerce,200000.0,RUS,1,1,0,15883,15883,0
Mobile,200000.0,USA,1,1,0,15522,15522,0
Software,12000000.0,USA,1,2,0,12110,12110,1
Cloud Computing|Enterprise Software|SaaS|Software,111700000.0,USA,5,12,2590,13951,16541,0
Analytics|Big Data|Cloud Computing|Genetic Testing|Life Sciences,47697751.0,USA,7,3,3407,13079,16486,0
Apps|Mobile|Mobility|Software,500000.0,USA,1,3,0,16161,16161,1
Application Platforms,6034050.0,SWE,1,2,0,12479,12479,1
Curated Web|Software|Venture Capital,715000.0,USA,3,9,611,13665,14276,1
Mobile|Mobile Security|SaaS,19900.0,SGP,2,5,215,16191,16406,0
Software,10000000.0,IND,1,1,0,13328,13328,1
Enterprise Software|SaaS|Software,401500.0,ISR,3,5,343,15686,16029,0
Analytics|Information Technology|Professional Services|Software|Testing,80800000.0,USA,6,17,2935,13149,16084,0
Consumer Electronics,100000.0,USA,1,1,0,16436,16436,0
Software,947032.0,GBR,1,2,0,15893,15893,0
Education,5600000.0,IND,2,2,544,16043,16587,0
Financial Services,37770000.0,USA,3,9,282,16252,16534,0
Customer Service|Distribution|Manufacturing|Natural Resources|Pharmaceuticals,25000000.0,USA,1,1,0,16532,16532,0
Delivery|Networking|Services,14000000.0,USA,1,3,0,11191,11191,1
Social Television|Video on Demand|Video Streaming,10500000.0,ISR,5,6,1310,15425,16735,0
Enterprise Software,1000000.0,GBR,1,3,0,15594,15594,0
Cloud Computing|CRM|Finance|Finance Technology|FinTech|Software,18000.0,USA,1,1,0,14000,14000,0
Software,17000000.0,USA,2,5,642,12613,13255,1
Software,200000.0,USA,1,2,0,13451,13451,0
Credit|Finance|Financial Services,50000000.0,USA,1,1,0,16538,16538,0
Biotechnology,78050000.0,USA,5,13,3306,12357,15663,1
Advertising,30300000.0,USA,3,12,1357,12796,14153,0
Biotechnology,4000000.0,ISR,1,1,0,14725,14725,0
Hardware + Software,1358979.0,USA,3,2,2198,13228,15426,0
Manufacturing,10750000.0,USA,2,3,1917,12880,14797,0
Manufacturing|Minerals,12500000.0,USA,2,1,459,15922,16381,1
Technology,1000000.0,USA,1,1,0,11982,11982,0
Nanotechnology,370356.0,CAN,2,1,212,15645,15857,0
Software,154000000.0,USA,2,2,2485,13398,15883,1
Biotechnology|Health Diagnostics,72999993.0,USA,3,3,561,15376,15937,0
Concentrated Solar Power|Electronics|Renewable Energies,40000000.0,IND,1,4,0,16594,16594,0
Semiconductors,5933707.0,GBR,1,1,0,15142,15142,0
Advertising|Facebook Applications|Games|Social Games,6000000.0,FIN,2,9,679,15008,15687,1
Advertising|Mobile|Mobile Advertising|Mobile Games|Monetization,20000000.0,DEU,1,1,0,15858,15858,0
Software,2460000.0,DEU,1,1,0,12935,12935,0
Enterprise Software,4000000.0,USA,1,3,0,12877,12877,1
Software,2500000.0,ISR,1,1,0,16259,16259,0
Enterprises|iOS|iPad|iPhone|Software,160000.0,JOR,1,1,0,15965,15965,0
Mobile,7000000.0,USA,1,6,0,16439,16439,0
Ad Targeting|Apps|Mobile Commerce,4020000.0,USA,2,2,265,16017,16282,0
EdTech|Education|Technology,34330.0,GBR,1,1,0,16202,16202,0
Enterprise Software|Online Rental|Real Estate,125000.0,USA,1,1,0,15751,15751,0
Education,98000.0,USA,2,3,37,15923,15960,0
Android|iPhone|Mobile,1000000.0,SGP,1,7,0,14907,14907,1
Enterprises|Enterprise Software|Mobile,3000000.0,USA,2,6,446,15506,15952,0
Application Performance Monitoring|Cloud Computing|Information Technology|Software,55799998.0,USA,5,16,2311,13710,16021,0
Advertising|Internet|Internet Marketing,288171856.0,USA,8,21,2666,13874,16540,0
Cloud Computing|Enterprise Software|RIM|SaaS|Software,11700000.0,USA,3,3,1328,14272,15600,0
Android|Apps|Curated Web|Internet|iOS|iPad|iPhone|Mobile|Mobile Software Tools|Software|Web CMS,50000.0,USA,1,1,0,16495,16495,0
Email Marketing|Online Reservations|Online Scheduling,265509.0,GBR,1,3,0,16314,16314,0
Apps|Mobile,2569000.0,USA,2,1,427,14579,15006,0
Mobile,8700000.0,USA,3,12,1096,14975,16071,0
Apps|Mobile,1800000.0,ISR,2,5,573,15376,15949,1
Advertising|iPad|iPhone|iPod Touch|Mobile,700000.0,USA,1,2,0,15141,15141,1
Cloud Computing|Enterprise Software|PaaS|SaaS,56000000.0,USA,4,11,2080,14557,16637,0
EdTech|Education,1500000.0,USA,2,1,591,16049,16640,0
Mobile,31500000.0,USA,4,11,1506,13172,14678,0
Software,11000000.0,USA,2,2,1245,13708,14953,0
Security,25000000.0,USA,2,11,412,16121,16533,0
Advertising|E-Commerce|Social Commerce,364742.0,SWE,2,1,344,16314,16658,0
Security,750000.0,ISR,1,4,0,13356,13356,0
Enterprise Software,63000000.0,USA,9,19,2764,11718,14482,1
Consumers|Mobile,2400000.0,IDN,1,1,0,15818,15818,0
Mobile|Software,690000.0,RUS,3,3,1140,15553,16693,0
Android|Apps|iPad|iPhone|Mobile|Storage|Web Development|Web Tools,3455250.0,ITA,3,8,1142,15034,16176,0
Mobile|QR Codes|Web CMS,40000.0,USA,2,2,482,15679,16161,0
Apps|Open Source|Software,7000000.0,USA,2,2,655,13592,14247,0
Cloud Computing|Identity Management|Marketplaces|PaaS|SaaS|Software,500000.0,NOR,1,5,0,15949,15949,0
Software,20900000.0,IND,2,6,355,16170,16525,0
Mobile,3000000.0,ISR,2,5,349,16000,16349,0
Finance|Software,118000.0,USA,1,1,0,15340,15340,0
Enterprise Software|Virtualization,70978783.0,USA,2,1,470,15027,15497,0
Advertising|Android|iOS|Mobile|Promotional,8699999.0,FRA,4,10,1833,14643,16476,1
Advertising|Android|Apps|App Stores|iOS|Mobile|Mobile Analytics|Sales and Marketing,27100000.0,ISR,3,11,857,15598,16455,0
Enterprise Software,4566668.0,USA,4,1,846,15730,16576,0
Android|Consumer Electronics|Crowdfunding|Finance|iOS|Mobile,250000.0,BEL,2,2,203,15140,15343,0
Enterprise Software,783603.0,GBR,2,3,514,14816,15330,0
Apps|iPhone|Mobile|SaaS|Startups|Technology,32090.0,GBR,1,1,0,15279,15279,0
Developer Tools,2015000.0,USA,3,2,1265,15459,16724,0
Games,1900000.0,RUS,1,1,0,15645,15645,0
Analytics|Mobile Security|SaaS,28000.0,USA,1,1,0,15896,15896,1
Android|Apps|Finance|iOS|iPhone|Mobile,30000.0,USA,1,1,0,14986,14986,0
DIY|Mobile Commerce|SaaS,329500.0,SWE,1,2,0,16222,16222,0
Advertising,13329915.0,USA,4,5,1212,14159,15371,0
Mobile,1500000.0,USA,2,12,304,15614,15918,0
Apps|App Stores|Developer APIs|Mobile|Publishing|Software,1155000.0,USA,2,20,365,14822,15187,1
All Markets|Android|Apps|iPhone|Marketplaces|Mobile|Reviews and Recommendations|Storage,10671168.0,USA,5,5,2106,13970,16076,0
Education,250000.0,USA,1,1,0,16666,16666,0
Android|Communications Infrastructure|iOS|Mobile|Mobile Analytics|Mobile Software Tools|SaaS,6515000.0,USA,4,16,811,15526,16337,0
Advertising,30240000.0,USA,3,10,1094,13683,14777,1
Mobile|Sports,1700000.0,USA,3,2,504,15567,16071,1
Security,6250000.0,USA,1,2,0,15462,15462,0
Android|Cyber Security|iOS|Mobile|SaaS|Testing,618000.0,USA,2,6,144,15621,15765,1
Art|Digital Media|Mobile|Publishing,282355.0,USA,2,2,1402,14822,16224,0
Enterprise Software,6100000.0,USA,4,34,626,15857,16483,0
Corporate IT|Enterprise Software|SaaS,136000000.0,USA,7,26,2420,13832,16252,0
Apps|Big Data|Big Data Analytics|Marketplaces|Mobile,1767000.0,USA,8,23,676,15248,15924,0
Public Relations,23660962.0,USA,2,4,602,13860,14462,1
Apps,500000.0,BEL,3,5,553,16190,16743,0
Analytics|Big Data,2261000.0,USA,3,4,798,15811,16609,0
Android|Apps|iOS|Mobile|Testing,6250000.0,USA,2,19,422,15431,15853,1
Software,4500000.0,USA,2,2,337,16144,16481,0
Advertising|Android|Mobile,1400000.0,ISR,1,2,0,16209,16209,0
Curated Web,2725000.0,USA,5,8,759,15348,16107,0
Apps|CRM|Hospitality|Hotels|Mobile|Resorts|SaaS|Web CMS,500000.0,HKG,2,2,62,16009,16071,0
Accounting,100000.0,USA,1,2,0,16375,16375,0
Cloud Computing|Software|Video,3000000.0,USA,1,2,0,16134,16134,0
Apps|Computers|Software,54857.2431675304,BGR,1,1,0,16648,16648,0
Clean Energy|Electrical Distribution|Energy|Industrial Energy Efficiency|Rural Energy,30000000.0,USA,1,1,0,14304,14304,1
Biotechnology,93423231.0,USA,8,2,3027,13651,16678,0
Education,462157.0,ESP,1,3,0,16260,16260,0
All Students|EdTech|Education,15000000.0,USA,1,3,0,14166,14166,0
Health and Insurance|Health and Wellness|Lifestyle|mHealth|Personal Health|Software,75709.0,CAN,1,1,0,14791,14791,0
Medical Devices|Software,6800000.0,USA,1,3,0,13510,13510,0
Enterprise Software,14500000.0,USA,1,4,0,12784,12784,1
Software,43901134.0,USA,7,7,3670,12849,16519,0
Software,16100000.0,USA,2,6,1490,11978,13468,1
Hardware + Software,33000000.0,USA,3,10,977,13149,14126,0
All Students|Colleges|Education|Freelancers|Internet|Marketplaces|Photo Editing,20000.0,USA,1,1,0,15857,15857,0
Analytics|Big Data|Design,1875000.0,USA,1,4,0,16324,16324,0
Dental|Medical|Technology,607638.0,DNK,1,1,0,15644,15644,0
B2B|E-Commerce|Payments,400000.0,USA,1,3,0,16082,16082,0
Advertising|Analytics|Apps|Data Integration|iOS|Mobile|Mobile Analytics|Optimization|Software,22800000.0,USA,4,14,1844,14914,16758,0
Biotechnology|Health Care|Medical|Therapeutics,1000000.0,USA,2,2,32,16128,16160,0
Agriculture|Biotechnology,1117139.0,USA,4,3,1258,15340,16598,0
App Marketing|Business Intelligence|Cloud Computing,1200000.0,USA,1,1,0,14916,14916,0
Web Hosting,11200000.0,GBR,1,1,0,16366,16366,0
Biotechnology,54000000.0,USA,2,11,361,13791,14152,0
Biotechnology|Health Diagnostics,4576452.80863892,GBR,2,2,497,16146,16643,0
Business Services|E-Commerce,40000.0,HKG,1,1,0,15194,15194,0
Biotechnology|Clinical Trials|Life Sciences,41250.0,GBR,1,1,0,16405,16405,0
Cloud Computing|Enterprises|Software|Web Development,13292327.0,USA,2,2,137,14302,14439,1
Mobile,23000000.0,USA,1,1,0,13775,13775,0
Messaging,5000000.0,USA,1,2,0,13160,13160,1
Automotive,56300000.0,USA,4,3,1556,13612,15168,0
Enterprise Software|Health and Insurance|Health Care|PaaS|Privacy|Security,120000.0,USA,2,3,33,16267,16300,0
Health Care|Health Diagnostics|Test and Measurement,2750000.0,USA,1,2,0,16623,16623,0
SaaS|Software,1000000.0,USA,2,1,485,14985,15470,1
Cloud Computing|Commercial Real Estate|CRM,10375000.0,USA,3,2,379,16280,16659,0
Mobile,909161.0,PRT,1,1,0,15856,15856,0
CRM|SaaS|Software,186000000.0,USA,3,10,714,15965,16679,0
Advertising|Blogging Platforms|Curated Web|Publishing,4600000.0,USA,2,4,625,13695,14320,1
Health Care,40000000.0,USA,2,5,667,14851,15518,0
Apps|Personalization|Service Providers|Utilities,116000000.0,CHN,2,3,228,16227,16455,0
Enterprise Application|Enterprise Security,400000.0,SGP,1,1,0,16375,16375,0
Clean Technology,14000000.0,NLD,1,1,0,13868,13868,0
Energy Management|Environmental Innovation,36100000.0,USA,1,6,0,11241,11241,0
Software,28612936.0,USA,3,7,595,16162,16757,0
Biotechnology,8899100.0,FRA,1,1,0,14848,14848,0
Software,1770000.0,FRA,1,2,0,14550,14550,1
Hospitality,20000000.0,USA,2,1,1437,15034,16471,0
Clean Technology|Diagnostics|Infrastructure,13000000.0,USA,1,1,0,16702,16702,0
Clean Technology,28306478.0,GBR,2,4,310,14937,15247,0
Mobile|Security|Software|Technology,4270000.0,ESP,1,1,0,13809,13809,0
Clean Technology,3907466.0,USA,4,4,1161,15338,16499,0
Semiconductors,190624633.0,USA,8,30,3482,13053,16535,0
Biotechnology,16226758.078100301,GBR,3,11,1693,13011,14704,0
Clean Technology,6760000.0,DNK,1,2,0,13610,13610,0
Public Relations,29567009.0,FRA,2,6,423,10623,11046,0
Clean Technology,2200000.0,ISR,1,1,0,16734,16734,0
Clean Technology,8180000.0,AUS,3,4,2765,13620,16385,0
Service Providers|Water|Water Purification,30000000.0,USA,1,1,0,16556,16556,0
Biotechnology,3712304.0,USA,1,1,0,16674,16674,0
Semiconductors,20000000.0,USA,1,4,0,13570,13570,0
Health Care|Medical Devices,99600000.0,USA,4,13,2003,14083,16086,1
Energy Efficiency|Energy Management|Enterprise Software|Internet of Things|SaaS|Software,7472500.0,USA,6,5,1054,15626,16680,0
Biotechnology|Health Care,74119365.0,CAN,7,13,2122,13676,15798,1
Clean Technology,150910788.0,USA,5,18,2299,14043,16342,0
Digital Media|Mobile Advertising|Telecommunications|Wireless,16000000.0,USA,2,6,1315,15400,16715,0
Clean Technology|Water,8100000.0,ISR,2,4,1592,13963,15555,0
Fraud Detection|Security,486905.0,CAN,1,2,0,16111,16111,0
Artificial Intelligence|Enterprise Software|Information Technology|Services,55000000.0,DEU,1,1,0,16359,16359,0
Enterprise Software,2500000.0,USA,1,1,0,14019,14019,0
Biotechnology|Health and Wellness,122000000.0,USA,4,10,1226,14391,15617,1
Health Care,25000000.0,USA,1,4,0,13885,13885,1
Brokers|Cars|Direct Sales,13876040.0,FRA,1,2,0,14517,14517,0
Software,16190000.0,IRL,2,6,105,12815,12920,1
Document Management|Open Source|Software,21401781.0,CHE,5,1,4146,12317,16463,0
Biotechnology|Health Care,76750000.0,USA,4,6,1021,14981,16002,1
Distribution|Fashion|Kids|Retail,11796300.0,USA,1,1,0,15832,15832,0
Clean Technology|Energy,20000000.0,ISR,2,2,1237,14457,15694,0
Enterprise Software,39868500.0,USA,4,7,1840,13726,15566,0
Biotechnology,34800000.0,USA,1,3,0,14924,14924,0
Hardware + Software,2648258.0,USA,3,3,1973,13843,15816,1
Manufacturing,300000.0,USA,2,1,1483,15177,16660,0
Manufacturing|Medical|Medical Devices,20000000.0,USA,1,11,0,13908,13908,0
Manufacturing,1835140.0,USA,1,1,0,16520,16520,0
Analytics|Health Care|Health Care Information Technology|SaaS,9737605.0,USA,3,6,674,15902,16576,0
Publishing|Software|Technology,8750000.0,USA,1,4,0,12128,12128,1
Clean Technology|Recycling|Waste Management,150000.0,USA,1,1,0,15492,15492,0
Software,3000000.0,USA,2,4,295,13445,13740,1
Biotechnology,91850846.0,USA,9,8,3401,13210,16611,1
Gamification|SaaS,64860.0,AUS,1,2,0,16511,16511,0
Biotechnology,101000000.0,USA,5,4,3249,12949,16198,1
Software,11500000.0,USA,1,3,0,16595,16595,0
Clean Energy|Consumer Internet|Energy|Renewable Energies,1500000.0,USA,2,5,273,16314,16587,0
Health Care Information Technology,13000000.0,USA,2,2,881,15658,16539,0
Clean Technology,90000000.0,USA,1,1,0,13630,13630,0
Energy,70000.0,USA,1,1,0,13330,13330,0
Advertising Platforms|Analytics|Big Data|Digital Media,540000.0,USA,4,1,460,15579,16039,0
Environmental Innovation|Green|Natural Resources|Pets,390000.0,USA,3,2,151,14975,15126,0
Cloud Computing|Customer Service|Enterprise Software|Telecommunications,28000.0,USA,1,1,0,15645,15645,0
Games|Sensors,5000000.0,USA,1,1,0,15887,15887,0
Software,15000000.0,USA,2,6,591,13057,13648,1
Biotechnology,101750000.0,USA,2,16,601,11914,12515,0
Biotechnology,99000000.0,GBR,1,2,0,14704,14704,1
E-Commerce|Financial Services,125000000.0,USA,7,5,1734,10622,12356,1
Architecture|Databases|Design|Enterprise Software|Interior Design|Real Estate|Social Media,3508711.0,USA,3,4,248,16091,16339,0
Architecture|Interior Design|Internet|Services,111540.0,FRA,1,1,0,14501,14501,0
Software,12000000.0,USA,1,3,0,13206,13206,1
Apps|B2B|Service Providers,18000000.0,USA,1,7,0,11253,11253,0
Business Services|Enterprises|Information Technology,12500000.0,USA,2,4,413,13277,13690,0
Enterprise Software,1155981.0,USA,4,3,1274,15400,16674,0
Design|EDA Tools|Manufacturing,4500000.0,USA,1,3,0,13291,13291,0
Medical,28000000.0,USA,2,4,1649,12265,13914,1
Biotechnology,17000000.0,USA,5,2,1755,13860,15615,0
Android|Apps|iOS|Photography|Photo Sharing|Video,750000.0,USA,2,1,508,15949,16457,0
Email|Messaging,3000000.0,USA,1,2,0,14245,14245,1
Web Hosting,500000.0,ISR,1,1,0,12813,12813,0
Security,62000000.0,USA,4,21,2478,11570,14048,1
Business Analytics|Contact Management|Information Technology|Mobile|Services|Software,34060000.0,ESP,1,2,0,13005,13005,1
Security,26914000.0,USA,3,6,2372,10957,13329,1
Digital Media|Mobile|Photography|Software|Video,20000000.0,USA,1,2,0,15236,15236,0
Big Data|Services|Social Network Media,1567000.0,JPN,3,4,1717,14883,16600,0
Health Care|Health Diagnostics,3496500.0,FIN,1,1,0,15469,15469,0
Hardware + Software,28952603.0,USA,2,4,1045,15719,16764,0
Semiconductors,5294000.0,NOR,2,3,101,13805,13906,1
Network Security,27250000.0,CAN,2,4,225,15461,15686,0
Biotechnology,162000.0,USA,3,2,39,16455,16494,0
Computers|Network Security|Wireless,8000000.0,USA,1,2,0,12607,12607,0
Biotechnology,3440000.0,USA,2,3,967,13787,14754,0
Computers|Data Security|Enterprise Software,600000.0,CYP,1,1,0,16407,16407,0
Software,3650000.0,SVK,1,1,0,13224,13224,0
Biotechnology|Clinical Trials,14000000.0,USA,1,4,0,12065,12065,0
Biotechnology,112785321.0,USA,3,3,1679,14929,16608,1
E-Commerce,40000.0,USA,1,1,0,15562,15562,0
E-Commerce|Finance|Startups|Venture Capital,12500000.0,THA,2,4,476,15859,16335,0
Investment Management,10080000.0,FRA,1,3,0,13455,13455,0
Health Care,64080000.0,USA,3,8,1542,12784,14326,1
Language Learning,1955000.0,USA,2,3,12,16491,16503,0
Internet|Technology,6809333.0,USA,4,11,1114,15490,16604,0
Cyber Security|Data Security|Security,25500000.0,USA,3,20,527,16195,16722,0
Software,5500000.0,USA,1,1,0,16680,16680,0
Analytics|Bridging Online and Offline|Software,435000.0,USA,1,7,0,16405,16405,0
Application Platforms|Online Gaming|Social Games,955000.0,USA,2,1,79,16608,16687,0
Biotechnology,220260000.0,USA,3,1,938,14412,15350,1
SaaS|Software,47952301.0,USA,7,3,4586,11710,16296,0
Marketplaces|Sponsorship,20000.0,USA,1,1,0,16436,16436,0
Biotechnology,63643889.0,NLD,4,18,2077,14497,16574,1
Health and Wellness|Health Care|Pharmaceuticals,25000000.0,USA,1,2,0,12844,12844,0
Data Integration|Data Visualization|Enterprise Software|SaaS,1525000.0,USA,1,8,0,16448,16448,0
Biotechnology,15800000.0,USA,1,3,0,13689,13689,0
Algorithms|Analytics|Consumer Lending|Finance|Finance Technology|Financial Services|FinTech|Innovation Engineering|Machine Learning|Personal Finance,80050000.0,USA,4,2,413,16161,16574,0
Biotechnology|Health Care,128352074.0,USA,7,11,1667,14873,16540,1
Hardware|Software,167000.0,RUS,2,1,192,15514,15706,0
Automotive|Cyber Security,30000000.0,ISR,2,12,347,16341,16688,0
Advertising|Deep Information Technology|Mobile|Predictive Analytics,8791580.0,BEL,5,8,1264,15492,16756,0
Analytics|Brand Marketing|Online Scheduling|Social CRM|Software|Twitter Applications,1565000.0,USA,2,2,311,14883,15194,1
Software,20995129.0,USA,7,9,1598,14768,16366,0
Security,10450000.0,USA,1,1,0,14592,14592,0
Analytics|Health Diagnostics,350000.0,USA,1,1,0,13829,13829,0
Biotechnology|Innovation Management|Services,5500000.0,USA,1,4,0,12584,12584,0
Audio|Technology|Wearables,13600000.0,USA,1,9,0,16611,16611,0
Software,9050000.0,GBR,3,5,1979,14040,16019,0
Finance,4650000.0,USA,2,2,423,15373,15796,0
Billing|Cloud Computing|Enterprise Software|Monetization|SaaS|Subscription Businesses,82300500.0,USA,4,13,2204,13824,16028,0
Biotechnology|Health Diagnostics,100000.0,USA,1,1,0,15706,15706,0
Hardware + Software,1670000.0,FRA,1,1,0,14865,14865,0
Digital Media|Independent Music|Music|Music Services,15000.0,USA,1,3,0,15492,15492,0
Pharmaceuticals,2300000.0,FRA,1,1,0,14069,14069,0
Software,10948780.0,FRA,3,5,3404,13171,16575,0
Consulting|Wireless,64700000.0,USA,2,3,225,13920,14145,0
Analytics|Biotechnology|Medical,1632595.0,GBR,2,2,2118,14304,16422,0
Mobile,9513175.0,GBR,3,10,792,13914,14706,1
Software,5000000.0,USA,1,1,0,13848,13848,0
Real Estate,54000000.0,IND,2,2,190,15904,16094,0
Hardware + Software,30350000.0,USA,3,13,880,12450,13330,0
Biotechnology|Health Diagnostics,67500000.0,USA,3,5,1103,14245,15348,1
Clean Technology,7100000.0,USA,2,4,514,14057,14571,0
Health Care,4000000.0,USA,1,2,0,16534,16534,0
B2B|Business Services|Services,30000000.0,USA,1,2,0,10897,10897,0
Music,3380000.0,BEL,1,4,0,14208,14208,0
Hardware + Software,181860000.0,USA,7,24,2053,11674,13727,1
Education,2450000.0,USA,2,3,243,14840,15083,0
Software,622000.0,USA,1,2,0,13514,13514,0
Biotechnology,23500000.0,CAN,2,4,103,13105,13208,1
Health and Wellness,36000000.0,USA,1,3,0,16631,16631,0
Education|Nonprofits|Universities,1000000.0,USA,1,1,0,16114,16114,0
Search,4450000.0,USA,2,20,176,15279,15455,0
Enterprise Software,7964826.0,USA,2,2,2941,12585,15526,0
Games|Social Games,5025000.0,USA,2,1,3847,11931,15778,0
Hardware + Software,1800000.0,USA,1,3,0,15930,15930,0
Business Services|Finance Technology|FinTech|Innovation Engineering,3000000.0,USA,1,1,0,16287,16287,0
Advertising|Information Technology|Internet|Internet Marketing|Search|SEO,1000000.0,USA,1,1,0,14670,14670,0
Data Security|Flash Storage|Home & Garden|Linux|Open Source|Software,7000000.0,USA,2,4,1001,12634,13635,1
Defense|Security|Software,300000.0,USA,1,2,0,15675,15675,0
Consulting,62101270.0,GBR,5,10,3396,12486,15882,0
Games,1461360.0,ITA,1,5,0,15533,15533,0
Computers|Networking|Software,22000000.0,USA,2,5,202,16386,16588,0
Databases|Innovation Management|Software|Storage,12500000.0,USA,1,3,0,11764,11764,0
Cloud Data Services|Data Security|Information Technology|Services,4662037.0,GBR,3,6,956,15568,16524,0
Semiconductors,3000000.0,CHN,1,1,0,12843,12843,0
Biotechnology,25492899.0,USA,2,4,2,15671,15673,0
Social Media,1347000.0,USA,2,1,805,14533,15338,0
Pharmaceuticals,31300000.0,USA,2,6,161,16310,16471,0
Biotechnology,50000000.0,USA,2,7,184,16034,16218,0
Cyber Security|IaaS|IT and Cybersecurity|Security,60100000.0,USA,6,6,1132,15044,16176,0
Cloud Security|Enterprise Software|Mobile Commerce|Productivity Software,2000000.0,USA,1,3,0,15763,15763,1
Security|Web Tools,955000.0,USA,2,2,1250,13161,14411,1
Software,600000.0,USA,1,3,0,15964,15964,0
Biotechnology,5587582.0,USA,5,2,2339,14116,16455,0
Beauty|Online Shopping|SaaS,200000.0,RUS,1,1,0,16311,16311,0
Biotechnology,46000000.0,USA,2,8,1142,14866,16008,0
Finance,3500000.0,IND,1,3,0,15981,15981,0
Agriculture|Biotechnology|Consumer Goods|Food Processing,1000000.0,USA,1,1,0,16574,16574,0
Local Based Services|Mobile|Social Search,90000.0,USA,4,6,290,15935,16225,0
Fashion|Music|Social Network Media|Video Chat,275000.0,USA,1,2,0,14624,14624,0
Advertising,15564591.0,USA,3,7,1277,13330,14607,0
Dental|Health Care,110000000.0,CHN,3,8,1510,14669,16179,0
Curated Web,4242704.0,GBR,1,1,0,15918,15918,0
Biotechnology,85000000.0,USA,1,1,0,16496,16496,1
Enterprise Software,13425000.0,USA,5,5,2246,14092,16338,0
Cloud Security|Software|Web Development,45550000.0,USA,4,5,2209,11372,13581,0
Software,30000000.0,USA,1,2,0,13780,13780,0
Software,29638309.0,USA,5,10,2121,14579,16700,0
Clean Technology,14000000.0,USA,1,1,0,14846,14846,0
Lifestyle|Lifestyle Products|Real Time,105000.0,USA,1,1,0,16071,16071,0
Cars|Online Rental|Shared Services,64512.0,CHL,2,2,876,15407,16283,0
Events|Meeting Software|Social Media|Startups|Travel,10000.0,USA,1,1,0,15615,15615,0
Public Transportation,40000.0,USA,1,1,0,15772,15772,0
Logistics|Manufacturing|Storage,2250000.0,USA,1,1,0,16381,16381,0
Biotechnology|Medical,34898793.0,GBR,1,7,0,12326,12326,1
Enterprise Software|Payments,58900000.0,USA,7,10,4469,11047,15516,0
Biotechnology,65982896.0,USA,3,1,1523,14469,15992,1
Information Services,3000000.0,USA,1,1,0,16595,16595,0
Communications Hardware|Enterprise Software|Hardware|Networking,15800000.0,USA,2,5,424,9862,10286,1
Manufacturing,6750000.0,USA,1,1,0,14559,14559,0
Games,25000000.0,USA,2,9,310,12534,12844,1
Biotechnology,30400002.0,AUT,3,7,1077,14874,15951,0
Data Privacy|Data Security|Network Security,49000000.0,USA,3,5,1169,11652,12821,1
Biotechnology,28000000.0,USA,5,9,650,14623,15273,0
Biotechnology,63388808.0,USA,10,6,2803,13784,16587,0
E-Commerce,40000.0,CHL,1,1,0,15911,15911,0
Art|Design,56240000.0,USA,4,8,3187,12529,15716,0
Games,2500000.0,USA,2,1,433,16260,16693,0
Mobile,589000.0,SGP,1,2,0,15987,15987,0
Security,3239000.0,DEU,2,4,373,12965,13338,1
Art|Marketplaces|Mobile|Mobile Commerce,281000.0,USA,2,1,471,15826,16297,0
Art|Discounts|E-Commerce|Shopping,40000.0,USA,1,1,0,15380,15380,0
Art|Curated Web|Design,50880053.0,USA,6,40,1910,14610,16520,0
Art,551179.800362676,FRA,1,1,0,16741,16741,0
Architecture|Design|Interior Design,50000.0,USA,1,1,0,14903,14903,0
Biotechnology,13276082.0,USA,3,2,726,15974,16700,0
Software,3200000.0,USA,1,10,0,16252,16252,0
Design,200000.0,USA,1,5,0,16191,16191,0
Artists Globally|Internet|Social Network Media,99498.0,PER,2,2,1005,15309,16314,0
Biotechnology,30000000.0,USA,2,2,280,15266,15546,0
Analytics|Health Care|Healthcare Services|Services|Visualization,1995000.0,USA,3,4,104,15974,16078,0
Biotechnology,16550704.802611401,FRA,2,5,1044,13829,14873,0
Hardware + Software,10250000.0,USA,3,1,1244,13812,15056,0
Hardware + Software,28100000.0,USA,3,10,913,13683,14596,0
Application Platforms|Customer Service|Software,85177.2431675304,BGR,2,2,212,16436,16648,0
Banking|Business Intelligence|CRM|Enterprise Software|Finance|SaaS|Security|Social CRM|Social Media Monitoring|Software|Utilities,11176477.0,GBR,2,3,1226,15379,16605,0
Art|Crowdfunding|FinTech|Marketplaces,1200000.0,USA,2,12,171,16262,16433,0
Artificial Intelligence|Fashion|Services,67022.0,BGR,1,1,0,16283,16283,0
Hardware + Software,2336224.0,USA,2,1,358,15719,16077,0
Biotechnology,10500000.0,USA,1,1,0,12825,12825,0
Intellectual Property|Legal|Software,10000000.0,USA,2,1,811,14593,15404,0
Health and Wellness|Health Care|Medical,2200000.0,USA,1,1,0,15614,15614,0
Biotechnology,185740.0,USA,2,4,2120,12592,14712,0
Software,5250000.0,USA,2,3,2208,14425,16633,0
Mobile,18826300.0,ESP,2,2,1741,14140,15881,0
Design,800000.0,USA,1,4,0,15455,15455,0
Games|Software|Video Games|Web Development,2500000.0,USA,2,11,1174,15555,16729,0
Semiconductors,58000000.0,USA,2,10,100,13493,13593,0
Analytics|Android|Apps|CRM|iOS|Marketing Automation|Mobile|Optimization|Personalization|Software,7000000.0,USA,2,4,440,15441,15881,1
Biotechnology,85381111.0,USA,5,11,1413,13397,14810,0
Mobile,2000000.0,USA,1,4,0,15779,15779,0
Finance Technology|Financial Services|FinTech,17000000.0,USA,2,23,1219,15340,16559,0
Curated Web,775000.0,USA,2,1,460,15660,16120,0
Art,1100000.0,USA,1,5,0,16735,16735,0
Finance|Financial Services|FinTech|Information Technology|Social Entrepreneurship|Software|Technology,630000.0,IND,3,3,1773,14745,16518,0
Entertainment|Film|News|Software,125439500.0,GBR,2,2,460,14224,14684,0
Advertising|Enterprises,330000.0,USA,2,1,1374,15340,16714,0
Designers|Marketplaces|Retail,1000000.0,USA,1,1,0,16343,16343,0
Art|E-Commerce,390000.0,USA,1,9,0,15280,15280,0
E-Commerce,14450000.0,USA,4,10,1402,15062,16464,1
Software,6883956.0,USA,3,2,804,14056,14860,1
Art|Consumers|Internet|Mobile,50000.0,USA,1,1,0,14903,14903,0
Communications Hardware|Computers|Enterprise Software|Mobility|Wireless,30000000.0,USA,1,5,0,13451,13451,1
Career Management|Software,3770000.0,USA,1,1,0,14040,14040,0
Fuels|Nutrition|Oil|Renewable Energies,2500000.0,USA,1,3,0,16566,16566,0
Industrial|Oil|Renewable Energies,2500000.0,USA,1,4,0,16566,16566,0
Clean Technology|Organic|Waste Management,16111323.0,GBR,3,2,1080,15446,16526,0
Analytics|Logistics|Optimization|Security|Supply Chain Management,2254193.0,CHE,1,4,0,15918,15918,0
Biotechnology,56000000.0,USA,2,9,755,15974,16729,0
Manufacturing,1687547.0,USA,2,2,217,16444,16661,0
Security,20047324.0,USA,3,8,2592,11913,14505,1
Enterprise Software|SaaS,97166500.0,USA,7,22,2136,14386,16522,0
Chemicals|Distribution|Life Sciences|Marketplaces|Sales and Marketing,80000000.0,IRL,1,1,0,11932,11932,1
Biotechnology,83257446.0,USA,4,14,2267,12570,14837,0
Biotechnology,12000000.0,USA,1,2,0,14302,14302,0
Logistics,10000000.0,USA,1,3,0,12159,12159,1
Facebook Applications|Identity|Kids|Reputation|Security|Twitter Applications,43138.0,JPN,1,1,0,16030,16030,0
Software,1310000.0,FIN,1,2,0,13194,13194,0
Collaboration|Productivity Software|Software|Task Management,38200000.0,USA,4,21,1421,14123,15544,0
E-Commerce|Fashion|Mobile|Search,3750000.0,GBR,1,3,0,16107,16107,0
Software,2590000.0,SWE,1,2,0,13258,13258,1
Financial Services,1500000.0,USA,1,3,0,16539,16539,0
Health Care|Hospitals|Medical,20100000.0,USA,1,3,0,13600,13600,1
Biotechnology|Diagnostics|Health Diagnostics|Medical,2000000.0,USA,1,2,0,16210,16210,0
Bio-Pharm|Clinical Trials|Health and Wellness|Pharmaceuticals,85814905.17422621,USA,2,9,2545,13860,16405,1
Biotechnology,30693206.0,CHE,1,4,0,16707,16707,0
Biotechnology|Diagnostics|Health Care,39664050.0,USA,2,1,1275,13900,15175,1
Web Hosting,107000000.0,USA,1,3,0,15448,15448,0
Clean Technology,71350002.0,USA,8,2,1498,15215,16713,1
Biotechnology,18999997.0,USA,1,3,0,13822,13822,0
Biotechnology,87800180.0,USA,4,9,2593,12053,14646,0
Bio-Pharm,15500000.0,HKG,1,5,0,16661,16661,0
Software,539000.0,CAN,1,1,0,13118,13118,0
Human Resources|Software,10273803.0,USA,2,1,795,15625,16420,0
Consulting,2857456.0,SGP,2,2,396,15675,16071,0
Health and Wellness,155000000.0,USA,3,5,1701,15070,16771,0
Art|Big Data|Bitcoin|Early-Stage Technology|Intellectual Property|Internet|Machine Learning|Startups,2000000.0,DEU,1,4,0,16610,16610,0
Automotive|Insurance|Insurance Companies,500000.0,COL,1,1,0,16336,16336,0
Software,20000000.0,USA,1,3,0,13192,13192,1
Manufacturing,28000000.0,USA,1,3,0,16133,16133,0
Computers|Hardware + Software|Networking|Water,34860000.0,USA,3,7,1455,13138,14593,0
E-Commerce|Gadget|iPod Touch|Mobile,12743133.0,DEU,4,12,1512,14945,16457,0
Biotechnology,453000.0,USA,3,2,2346,12418,14764,0
Health and Wellness,213000.0,USA,1,1,0,16113,16113,0
Technology,50000.0,USA,1,1,0,16007,16007,0
Consulting,40000000.0,USA,1,1,0,15777,15777,0
Semiconductors,10000000.0,BEL,1,4,0,13522,13522,0
Manufacturing,100000000.0,CHN,1,1,0,12481,12481,0
Search|Social Media,25000000.0,USA,2,3,1155,9496,10651,1
Social Media,40000.0,CHL,1,1,0,15180,15180,0
Mobile,1850000.0,ISR,3,5,294,16020,16314,0
Messaging|Mobile|Networking,50000.0,SGP,1,2,0,14610,14610,0
CRM|Market Research|Social Network Media,600000.0,USA,2,2,1070,14339,15409,0
Analytics|Big Data|Business Intelligence|Collaboration|Retail,1800000.0,CAN,1,2,0,16218,16218,0
Curated Web|Entertainment|Events|Private Social Networking|Social Media|Startups,7500.0,CZE,1,1,0,15218,15218,0
Biotechnology,34000000.0,SGP,2,1,813,15175,15988,0
Biotechnology,16925741.0,USA,3,3,1469,13643,15112,0
Networking|Social Media,5600000.0,USA,2,1,1641,13290,14931,0
Mobile|Networking,18522536.0,ISR,5,8,2262,13019,15281,0
Hardware + Software,7000000.0,USA,1,2,0,13790,13790,0
B2B|Business Services|Financial Services,1350000.0,GBR,1,3,0,16756,16756,0
Internet|Leisure|Online Reservations,6949015.0,JPN,2,5,366,16160,16526,0
Consumer Goods|Fitness|Specialty Foods,4000000.0,USA,1,2,0,14000,14000,0
Software,300000.0,FRA,1,4,0,12965,12965,0
Advertising|Digital Media|Services,1460000.0,SGP,1,1,0,16637,16637,0
Collaboration|Contact Centers|Customer Service|Software|Unifed Communications,50000000.0,USA,1,1,0,12006,12006,0
Consumer Internet|Curated Web,2800000.0,ISR,2,3,972,15737,16709,0
Mobile,25652895.0,GBR,2,5,699,11323,12022,0
Clean Technology,136000000.0,USA,6,10,1787,14055,15842,1
Public Transportation,19932595.0,USA,3,7,920,15624,16544,0
Software,100000000.0,USA,1,1,0,12283,12283,1
Semiconductors,10000000.0,GBR,1,1,0,12524,12524,0
Software,654000.0,FIN,1,1,0,13497,13497,0
Finance Technology|Financial Services|Investment Management|Ventures for Good,20500000.0,USA,3,29,716,15979,16695,0
Enterprise Software|Human Resources,400000.0,USA,1,1,0,16269,16269,0
Biotechnology,17025000.0,USA,2,3,212,16252,16464,0
Health and Wellness,21500004.0,USA,4,7,677,15910,16587,0
Pharmaceuticals,57000000.0,CAN,1,5,0,12487,12487,1
Manufacturing,1800000.0,FIN,1,4,0,16534,16534,0
Biotechnology|Life Sciences|Marketplaces|Outsourcing|Pharmaceuticals,7000000.0,USA,3,2,2360,13794,16154,0
Pharmaceuticals,5000000.0,USA,1,1,0,12916,12916,0
Collaboration|Enterprises|Real Time|Software,28000.0,USA,2,2,200,15897,16097,1
Collaboration|Crowdsourcing|Software,2900000.0,USA,2,7,689,15706,16395,0
Security,40000.0,USA,1,1,0,15002,15002,0
News,20000000.0,USA,1,1,0,14432,14432,1
Financial Services,468489.0,GBR,1,1,0,15979,15979,0
Software,4900000.0,CHE,1,1,0,13327,13327,1
Manufacturing,1535000.0,USA,4,15,742,15765,16507,0
Real Estate|Real Estate Investors,15000000.0,USA,2,13,284,16248,16532,0
Software,3000000.0,CAN,1,1,0,12816,12816,1
Hardware + Software|RFID,200000.0,USA,1,1,0,15270,15270,0
Crowdfunding|Finance|Peer-to-Peer,4486920.0,GBR,1,1,0,16545,16545,0
Software,50800000.0,USA,3,15,668,14550,15218,0
News,1000000.0,USA,2,3,609,11412,12021,0
CRM|Customer Service|Customer Support Tools|Enterprise Software|SaaS|Tech Field Support,5700000.0,USA,2,8,264,14714,14978,1
E-Commerce|Furniture,40000.0,GBR,1,1,0,15911,15911,0
Manufacturing,250000.0,USA,2,3,327,15212,15539,0
Curated Web,21400000.0,USA,3,6,1213,13149,14362,1
Curated Web|Employment|Marketplaces|Mobile|Recruiting,13750000.0,USA,4,13,1814,14728,16542,0
Biotechnology,104680725.0,USA,9,23,2382,14045,16427,0
Curated Web,5000000.0,USA,1,1,0,13173,13173,0
Consulting|Databases|Human Resources|Intellectual Property,5000000.0,JPN,1,1,0,15586,15586,0
Network Security|Security,12900000.0,DEU,2,5,366,12173,12539,1
Hardware + Software,22420000.0,FRA,1,4,0,13094,13094,0
Analytics|Databases,53000000.0,USA,4,18,1786,13088,14874,1
Hospitals,60000000.0,ARE,1,2,0,16218,16218,0
Biotechnology,3000000.0,GBR,1,5,0,12382,12382,0
Biotechnology,8000000.0,USA,4,7,1717,12318,14035,0
Biotechnology,678000.0,GBR,1,2,0,13283,13283,0
Fashion,5473907.70659855,GBR,2,2,942,13118,14060,0
Mobile,1950450.0,AUS,2,1,270,15918,16188,0
Simulation|Software|Telecommunications,1500000.0,USA,1,1,0,15840,15840,0
Android|iPhone|Productivity Software|Social Media|Task Management,1900000.0,USA,2,5,409,15034,15443,1
Consumer Electronics|Home Automation|Mobile|Wireless,3698550.0,USA,5,4,754,15778,16532,0
Social Media|Software,300000.0,USA,1,1,0,15078,15078,0
3D Printing,250000.0,USA,1,4,0,16375,16375,0
Aerospace|Technology,7700000.0,SGP,1,6,0,16489,16489,0
Enterprises|Enterprise Software|Software,5300000.0,USA,1,3,0,11386,11386,1
Biotechnology|Health Care|Health Diagnostics,126134082.0,USA,7,15,2722,14000,16722,0
Enterprise Software,53209289.0,USA,6,13,4540,11379,15919,0
Biotechnology|Health Diagnostics,80000000.0,USA,4,5,2484,13300,15784,0
Design|E-Commerce|Ediscovery|Shopping,732225.0,DEU,2,3,138,15841,15979,0
Information Services,10000000.0,USA,1,3,0,10877,10877,1
Enterprise Software|Web Development,3160000.0,IRL,1,3,0,14173,14173,0
Information Technology|Software|Technology,13909650.0,FRA,2,4,1359,14503,15862,0
Fitness|Health and Wellness|Kids|Sports,140000.0,USA,1,2,0,16130,16130,0
B2B|E-Commerce|Fashion|Wholesale,500000.0,BRA,1,2,0,15371,15371,0
Health Care,7200000.0,USA,1,3,0,11192,11192,0
Biotechnology,52000000.0,USA,2,13,24,16056,16080,1
Games,7260000.0,USA,1,3,0,13041,13041,0
Information Technology,2000000.0,IND,1,1,0,16769,16769,0
Biotechnology,17000000.0,USA,1,2,0,16146,16146,0
Cloud Computing|Enterprise Software|Search|Software,67000.0,NOR,1,1,0,14662,14662,0
Cloud Security,118000.0,USA,1,1,0,16643,16643,0
Semiconductors,750565.0,GBR,1,3,0,14790,14790,0
Art|Design|Employment|Environmental Innovation|Human Resources|Manufacturing|Marketplaces|Social Media|Women,30000.0,SAU,1,1,0,16018,16018,0
Broadcasting|Software|Telecommunications|Video,12868200.0,FRA,2,8,1597,13181,14778,1
Software,35860000.0,USA,3,8,1620,12142,13762,1
E-Commerce,40000.0,SGP,1,1,0,15380,15380,0
Enterprise Software,25500000.0,USA,3,14,2430,12828,15258,0
Services|Testing|Web Tools,15000000.0,USA,1,4,0,11415,11415,0
Auctions|Design,6963750.0,GBR,1,1,0,15823,15823,0
3D|Augmented Reality|Delivery|Hardware + Software|Health Care|Mobile|Software|Visualization,10631795.0,USA,4,11,582,16068,16650,0
Software,4000000.0,USA,1,6,0,13542,13542,0
Health Care,2000000.0,USA,1,1,0,14489,14489,0
Semiconductors,10000000.0,USA,1,3,0,12404,12404,1
Business Services|Enterprise Software,40000000.0,USA,3,3,1666,10865,12531,1
Biotechnology,43500000.0,USA,4,18,2508,11575,14083,1
Automotive|Electric Vehicles,13000000.0,IND,2,3,177,16407,16584,0
Health Care,37673932.0,USA,6,8,1460,14589,16049,1
Enterprise Software,1840000.0,FRA,1,1,0,14270,14270,0
E-Commerce|Social Media Marketing|Sports,80000.0,USA,1,1,0,16435,16435,0
Software,1681068.0,USA,4,3,712,15295,16007,0
Fitness|Health and Wellness|Sports|Training,22500000.0,USA,2,3,2093,13438,15531,0
Recruiting|Software|Sports,25000.0,USA,3,3,612,15857,16469,0
Email|Enterprise Software|Physical Security|Security,8200000.0,USA,2,4,2638,12874,15512,1
Fashion|Fitness|Health and Wellness|Technology|Wearables,50700000.0,USA,3,13,722,16035,16757,0
Health and Wellness,225828977.0,USA,2,1,1072,14693,15765,0
Health Care|Medical|Medical Devices,3000000.0,USA,1,3,0,16567,16567,0
Automotive|Electric Vehicles|Software,131000000.0,USA,3,2,1616,14595,16211,0
Software,28787632.0,USA,3,1,2041,14659,16700,0
Biotechnology|Health Diagnostics,26733013.0,USA,4,4,1148,15547,16695,0
Databases|Market Research,73085.0,MEX,2,2,153,15918,16071,0
Restaurants,210638.0,GBR,1,1,0,16102,16102,0
Machine Learning,250000.0,CAN,1,1,0,16518,16518,0
Software,12500000.0,USA,1,3,0,12682,12682,0
Enterprise Software|Flash Storage|Storage|Virtualization,30000000.0,USA,2,7,994,14846,15840,0
Clean Technology,9000000.0,ISR,1,3,0,15748,15748,0
Fitness|Hardware + Software|Wearables,2449019.0,USA,4,3,653,15922,16575,0
Information Technology,591346.0,GBR,1,1,0,16234,16234,0
Biotechnology|Health Diagnostics,75583454.0,GBR,3,17,1291,15173,16464,0
Application Platforms|Health and Wellness|Health Care Information Technology|Information Technology,50000.0,USA,1,3,0,15967,15967,0
Leisure|Travel & Tourism,2000000.0,USA,1,19,0,16490,16490,0
Mobile|Productivity Software,700000.0,USA,1,7,0,15675,15675,0
Hardware + Software,152500.0,USA,2,1,194,15826,16020,0
Collaboration|Enterprise Software|Web Tools,210000000.0,AUS,2,3,1364,14804,16168,0
Advertising,300000.0,USA,2,2,324,16049,16373,0
Curated Web,58438.0,JPN,1,1,0,15292,15292,0
Internet,167163877.32829198,GBR,2,4,355,16408,16763,0
Games,22900000.0,USA,1,5,0,11382,11382,1
Publishing,1000000.0,USA,1,2,0,12286,12286,0
Games,2050000.0,USA,2,3,504,13570,14074,0
Publishing|Social Media,5400450.0,CAN,4,4,1130,14974,16104,0
Security,50000.0,USA,1,1,0,16496,16496,0
Games,22900000.0,USA,1,5,0,11401,11401,0
Bio-Pharm|Medical|Pharmaceuticals,6570000.0,USA,4,10,883,15706,16589,0
Biotechnology,13700000.0,USA,1,2,0,12062,12062,1
Manufacturing,8000000.0,JPN,1,1,0,16294,16294,0
Environmental Innovation|Renewable Energies|Renewable Tech|Solar,1765800.0,USA,1,1,0,14964,14964,0
Cloud Computing|Home Automation|Industrial Automation|Internet of Things|M2M,1065000.0,USA,3,16,839,15710,16549,0
Bio-Pharm|Medical|Pharmaceuticals,5073408.0,GBR,2,2,268,16351,16619,0
Advertising|E-Commerce|E-Commerce Platforms|Marketplaces|Mobile Commerce|NFC|Software,5500000.0,DNK,2,3,578,15638,16216,0
Biotechnology,26250000.0,ISR,2,4,948,15327,16275,0
Clean Technology,33649083.0,GBR,2,8,240,13579,13819,0
Biotechnology,62860000.0,USA,4,5,1478,15265,16743,0
Software,46341484.0,USA,6,17,4319,11477,15796,1
Health Care,410958.0,CAN,1,1,0,14184,14184,1
Clean Technology,8600000.0,IND,1,1,0,15869,15869,0
Web Hosting,39200000.0,USA,2,18,992,12251,13243,0
Medical Devices,8500000.0,USA,2,8,731,10957,11688,1
Bio-Pharm|Medical|Pharmaceuticals,100000.0,USA,1,1,0,16512,16512,0
Hardware + Software,52000000.0,USA,2,6,567,13762,14329,1
Internet,20000000.0,USA,1,3,0,11151,11151,0
E-Commerce,5821431.0,USA,7,4,2434,14188,16622,0
Mobile,13000000.0,USA,3,10,811,13489,14300,1
Semiconductors,10000000.0,CAN,1,4,0,12431,12431,1
Analytics|Big Data Analytics|Startups,9000000.0,USA,2,4,631,15978,16609,0
Software,2500000.0,USA,2,2,398,15035,15433,1
Information Technology|Services,7500000.0,USA,1,2,0,12303,12303,0
Software,800000.0,USA,1,2,0,13171,13171,0
Apps|Internet|Mobile|Services,25000.0,ARG,1,1,0,15553,15553,0
Mobile,200000.0,USA,1,2,0,15974,15974,0
Bridging Online and Offline|Events|Nonprofits|Software,5600000.0,USA,4,4,589,15881,16470,0
Software,5000000.0,USA,1,1,0,12926,12926,1
Fashion,3030502.0,GBR,1,4,0,16105,16105,0
Clean Technology,28600000.0,IND,4,10,2323,13987,16310,0
Biotechnology,24522872.0,USA,2,4,207,15555,15762,0
Consumer Internet|Market Research,1000000.0,GBR,1,1,0,16723,16723,0
Enterprise Software,71100000.0,USA,4,4,1867,13757,15624,0
Network Security,8000000.0,USA,1,1,0,16541,16541,0
Digital Media|News|Social Media|Video,4099999.0,USA,1,5,0,16408,16408,0
Semiconductors,3409172.0,CHE,5,6,1510,14903,16413,0
Travel,10877666.0,GBR,1,1,0,14952,14952,0
SEO|Software,27200000.0,USA,4,16,1594,13176,14770,1
Enterprise Software|PaaS|Personalization,2000000.0,USA,1,8,0,16106,16106,0
Hardware + Software,18000000.0,USA,2,10,140,13326,13466,0
Diagnostics|Health and Wellness|Health Care Information Technology|Healthcare Services|Software,16000000.0,SGP,2,4,1044,15684,16728,0
Software,10500000.0,USA,4,4,2668,12570,15238,1
Software,1100000.0,USA,1,1,0,16105,16105,0
Biotechnology,180500000.0,USA,6,16,2904,13621,16525,1
E-Commerce,21000000.0,IND,1,3,0,16175,16175,0
Marketplaces|Outdoors|Travel,25000.0,USA,1,1,0,16273,16273,0
Real Estate,141750000.0,USA,3,2,565,15569,16134,0
Auctions|E-Commerce,95648700.0,DEU,4,26,1155,15369,16524,0
Curated Web,2500000.0,USA,1,2,0,12220,12220,1
E-Commerce,2400000.0,USA,1,1,0,13573,13573,0
Auctions|Nonprofits,5500000.0,USA,1,2,0,13417,13417,1
Auctions|Curated Web|E-Commerce,400000.0,USA,2,3,0,13514,13514,1
Curated Web,163406.0,GBR,1,1,0,15195,15195,0
Audio|Mobile|Project Management|Social Media|Startups|Twitter Applications,43000.0,USA,1,1,0,16331,16331,0
Health and Wellness|Health Care|Technology,55894778.0,USA,3,1,880,15219,16099,0
Hardware + Software,3030000.0,FRA,1,2,0,13504,13504,0
Biotechnology,137500000.0,USA,3,21,817,15904,16721,0
Audio|Blogging Platforms|Browser Extensions|Mobile|Web CMS|Web Design,12160.0,GBR,2,1,93,15811,15904,0
Software,1280000.0,USA,1,2,0,14480,14480,0
Semiconductors,15000000.0,SGP,1,4,0,14276,14276,1
Analytics|Big Data|Enterprise Software|SaaS,2783000.0,USA,4,5,1611,14895,16506,0
Crowdfunding|Distribution|Events|Film|Fitness|Health and Wellness|Internet|Marketplaces|Music|Nonprofits|Sales and Marketing|Social Fundraising|Social Network Media|Sports|Ventures for Good,20000.0,USA,1,2,0,16467,16467,0
Ad Targeting|Advertising|Advertising Platforms|Databases|Digital Media|Marketplaces,56546875.0,USA,4,8,2671,13134,15805,0
Web Hosting,7710000.0,AUS,2,5,590,14040,14630,0
Home Automation,1511444.0,GBR,1,1,0,16180,16180,0
Audio|Games|Music,470945.0,GBR,4,1,4387,11526,15913,0
Business Services,15000000.0,USA,1,3,0,12131,12131,1
Internet|Marketplaces|Software,40000.0,USA,1,1,0,15190,15190,0
Guides|Travel & Tourism,400000.0,IND,1,2,0,16119,16119,0
Music,400000.0,USA,1,2,0,15903,15903,0
Software,8771500.0,USA,5,3,631,15931,16562,1
Artists Globally|Audio|Games|Music,1250000.0,USA,2,3,834,14172,15006,1
Biotechnology,9273777.0,NLD,1,3,0,16686,16686,0
Social Media|Startups,85000.0,USA,2,1,169,15281,15450,0
Semiconductors,4000000.0,ISR,1,2,0,13600,13600,0
Real Time|Software|Speech Recognition,1499800.0,USA,2,4,92,15522,15614,0
Mobile,257626.0,ESP,2,4,260,15796,16056,0
Media|Music|Technology,3482300.0,USA,4,2,1948,13879,15827,0
Travel & Tourism,277967.02128849697,POL,2,1,675,16028,16703,0
Messaging,5530000.0,FRA,1,2,0,14797,14797,0
Security,955922.0,PRT,1,1,0,16045,16045,0
Advertising|Monetization|Video,30426151.0,USA,4,7,1146,13852,14998,1
Audio|Semiconductors,8500000.0,GBR,1,2,0,13757,13757,0
Apps|Software,1400000.0,USA,1,2,0,16508,16508,0
Augmented Reality|Enterprise Software|Software|Wearables,2800000.0,USA,3,13,128,16203,16331,0
Health and Wellness|Health Care|Hospitals|Medical,23000000.0,USA,2,18,210,16237,16447,0
Health Care,20900000.0,USA,4,10,1826,14448,16274,0
Augmented Reality|E-Commerce|Mobile,1800000.0,FRA,2,3,394,15796,16190,0
Automotive|Communications Hardware|Mobile|Mobility,4073365.0,DEU,4,3,713,15309,16022,0
Advertising|Android|Augmented Reality|Computer Vision|Drones|Indoor Positioning|iPhone|Robotics,1500000.0,USA,3,4,763,15755,16518,0
Hardware + Software,8590000.0,USA,1,2,0,13007,13007,0
Consumers|Content|Gps|Leisure|Location Based Services|Mobile|Navigation|Outdoors|Recycling,1534897.0,GBR,4,3,2219,14426,16645,0
Automotive|Business Development|Data Visualization|Mobile|RFID|Software|Systems|Tracking,90000.0,USA,2,2,92,14184,14276,0
Aerospace|Biotechnology,40000.0,USA,1,1,0,15750,15750,0
Advertising|Cyber Security|Developer APIs|Mobile,118000.0,USA,1,1,0,15838,15838,0
Software,35224880.3659203,FRA,4,17,3692,12830,16522,0
Big Data|Enterprise Software|Health Diagnostics|Internet of Things,9000000.0,USA,2,9,324,16349,16673,0
Home Automation|Internet of Things|Security|Technology,48000000.0,USA,3,30,754,15765,16519,0
Clean Technology,96700000.0,USA,1,4,0,16079,16079,0
Security,11000000.0,IND,3,5,2145,13891,16036,0
Education|Online Education|Video,278197.0,VEN,2,2,90,16071,16161,0
Advertising,40000.0,CHL,1,1,0,15751,15751,0
Charities|Employment|Services|Software,1000000.0,USA,1,1,0,16070,16070,0
Messaging,270000.0,GBR,1,1,0,13028,13028,0
Biotechnology,33961728.0,USA,6,5,1646,14853,16499,0
Media|Mobile|Music|News,300000.0,USA,1,5,0,15418,15418,0
Curated Web,10349192.0,USA,5,6,1015,15492,16507,0
Biotechnology,40753400.0,USA,6,6,2152,14579,16731,0
Biotechnology,73331503.0,USA,8,9,3286,11960,15246,0
Analytics|Application Platforms|Insurance|Machine Learning|Predictive Analytics|Visualization,850000.0,SGP,1,1,0,16388,16388,0
Biotechnology,52000000.0,CAN,1,9,0,16125,16125,0
Health Care,60680000.0,CHE,2,5,1887,13924,15811,1
Biotechnology,184052388.0,USA,3,4,2302,14399,16701,0
Clean Technology,21000000.0,IND,1,2,0,14880,14880,0
Brewing|Craft Beer|Wine And Spirits,25000.0,USA,3,3,924,15638,16562,0
Clean Technology,101718192.0,USA,7,11,2259,13537,15796,0
Games,7660000.0,USA,2,2,252,14546,14798,0
Hardware + Software,15000000.0,USA,1,3,0,12328,12328,0
Biotechnology,560000.0,USA,1,1,0,13998,13998,0
Biotechnology,29693645.0,USA,6,4,5839,10561,16400,0
Biotechnology|Health Care,98817742.0,USA,10,13,1692,14386,16078,1
Health Care,11017736.0,NOR,3,4,547,16042,16589,0
Clean Technology|Solar,123300000.0,USA,4,12,599,13757,14356,1
Software,3770000.0,AUS,1,1,0,13819,13819,0
Analytics,8000000.0,USA,2,5,994,13084,14078,0
Consulting,3500000.0,USA,1,1,0,12957,12957,1
Games,40000.0,CHL,1,1,0,16051,16051,0
Biotechnology|Medical,2100000.0,USA,2,2,76,13732,13808,0
Clean Technology,2056426.0,USA,3,3,2390,13185,15575,0
Identity|Identity Management|Online Identity|Security|Software,11674955.0,USA,2,6,294,16330,16624,0
Information Security|Semiconductors,22900000.0,USA,2,2,836,11323,12159,1
Identity Management|Marketplaces|Mobile|Peer-to-Peer,17136.0,ISL,1,1,0,16571,16571,0
Data Security|Services|Software,27300000.0,USA,3,16,1807,10651,12458,1
Analytics|Optimization,5000000.0,USA,1,1,0,13180,13180,0
SaaS|Security,21000000.0,USA,2,10,341,13263,13604,0
Security,18722511.0,USA,4,1,1119,14463,15582,0
Enterprise Software,2500000.0,USA,1,2,0,13250,13250,0
Collaboration|Life Sciences|Publishing|Software,643000.0,USA,2,4,16,16335,16351,0
EdTech|Education|Presentations|Software,8700000.0,USA,2,1,283,13483,13766,0
Software,33000000.0,USA,2,10,1158,12626,13784,1
Internet Marketing|Search|SEO,15000.0,USA,1,1,0,14144,14144,0
EdTech|Education|Publishing|Writers,640000.0,USA,3,3,457,15614,16071,0
Collaboration|Curated Web|Presentations,5000000.0,IND,1,1,0,14958,14958,0
Information Security|Mobile Security|Security,3067000.0,USA,3,21,981,15340,16321,1
Biotechnology,29769365.0,GBR,4,7,1418,15208,16626,0
Ticketing,2400000.0,USA,1,2,0,16741,16741,0
Home & Garden|Software,10000.0,UKR,1,1,0,15628,15628,0
Cars|Consumers|Services|Trading,117600000.0,DEU,1,3,0,16552,16552,0
Automotive|Hardware,573000.0,USA,6,2,579,15431,16010,0
Automotive,3000000.0,USA,1,1,0,15817,15817,0
Android|Apps|iOS|Software,6000000.0,JPN,1,2,0,16463,16463,0
Automotive|Curated Web|Professional Services,7894342.0,DNK,2,4,620,15645,16265,0
Email,768049.0,SGP,2,1,342,16157,16499,0
Internet,33000000.0,USA,1,4,0,11275,11275,0
Automotive,374483.0,CHL,3,3,785,15651,16436,0
Automotive,100000.0,AUS,1,1,0,16706,16706,0
Analytics|Content Discovery|Internet of Things|Mobile,7400000.0,USA,2,3,1125,15431,16556,0
Analytics|Big Data|Energy|Services,21750000.0,USA,2,6,455,15642,16097,0
Education,1585972.0,GBR,2,3,308,15170,15478,0
Analytics|Artificial Intelligence|Automotive|Big Data|Business Intelligence,10800000.0,USA,3,13,1429,14822,16251,1
Finance,60000000.0,USA,1,1,0,13519,13519,0
Automotive|Cars|Manufacturing,24000000.0,USA,1,11,0,16611,16611,0
Blogging Platforms|Content|Curated Web|Forums|Web CMS,317300000.0,USA,5,19,3138,13057,16195,0
Automotive|Cars|Consumer Electronics|Developer APIs,5350000.0,USA,2,2,401,16160,16561,0
Analytics,10774916.0,IRL,3,8,1947,10592,12539,0
Public Transportation|Software|Transportation,40000000.0,CHN,1,7,0,13422,13422,1
Network Security|Security,34500000.0,USA,3,24,1575,11500,13075,0
Health Care,136200000.0,USA,5,21,2719,13892,16611,0
Defense|Sensors,105000.0,USA,2,3,24,16118,16142,0
Automotive|Limousines|Public Transportation|Real Time|SEO,10200000.0,USA,2,6,718,15492,16210,0
Lead Management|SaaS|Sales and Marketing|Small and Medium Businesses,23499999.0,USA,5,14,1337,15309,16646,0
Automotive|Cars|E-Commerce|Insurance|Internet|Retail|Services,53615099.0,GBR,7,11,1347,13330,14677,1
Auto|Automotive|Cars|Curated Web,875000.0,USA,2,4,288,15519,15807,0
E-Commerce,50000.0,USA,1,1,0,15431,15431,0
E-Commerce,3600000.0,RUS,2,4,402,15949,16351,0
Software,6000000.0,USA,1,2,0,13319,13319,1
Cars|Price Comparison,1101315.88848378,DNK,3,2,1564,14858,16422,0
Flash Storage|Software,23800000.0,USA,7,10,1604,13514,15118,0
Advertising|Automotive,2500000.0,USA,1,1,0,15966,15966,1
Cloud Computing|Enterprise Software|IT Management|Networking|SaaS,6000000.0,CAN,1,3,0,15840,15840,0
Semiconductors,9000000.0,USA,1,4,0,13277,13277,0
Bio-Pharm,1600000.0,USA,1,2,0,12426,12426,0
Biotechnology|Health Care|Innovation Management|Market Research,43000000.0,USA,1,8,0,12363,12363,1
Finance,198177362.629051,DEU,3,8,953,15776,16729,0
Health Care,78349551.0,USA,5,11,1140,15372,16512,0
Property Management|Real Estate|Real Estate Investors,135000000.0,USA,1,1,0,15875,15875,0
Medical Devices,2600000.0,CHE,1,2,0,16755,16755,0
Sales Automation,19000000.0,USA,2,4,821,15827,16648,0
Electronics|Mobile,17000000.0,USA,2,7,535,14155,14690,1
Messaging|Mobile|Mobile Enterprise,6300000.0,USA,1,10,0,16351,16351,0
Software,12200000.0,USA,1,3,0,13346,13346,0
Semiconductors,28200000.0,CHN,3,7,1263,12965,14228,0
Software,3606836.0,FRA,1,1,0,15043,15043,0
Enterprise Software,20200000.0,USA,3,7,613,11477,12090,1
Internet of Things|Networking|Network Security|Telecommunications,1100000.0,USA,2,5,731,15433,16164,0
Biotechnology,70653885.0,USA,3,6,285,16035,16320,1
Flash Storage,109772047.0,USA,7,16,3257,13514,16771,0
Accounting|Enterprise Application|Software,223625355.0,USA,7,9,1699,14756,16455,0
Health and Wellness,8560000.0,USA,2,3,876,12815,13691,0
Software,27000000.0,USA,2,8,891,11792,12683,1
Internet,1500000.0,USA,1,2,0,16252,16252,0
Certification Test|Licensing|SaaS|Software,10000.0,NZL,1,1,0,14775,14775,0
Cloud Data Services|E-Books|E-Commerce|E-Commerce Platforms|Financial Services|Incentives|Mobile Commerce|Online Education|SaaS|Software|Storage,7500000.0,USA,3,8,2437,13269,15706,1
Biotechnology,30000000.0,USA,1,2,0,15517,15517,1
Education,2300000.0,IND,1,1,0,15924,15924,0
Analytics|Consumers|Groceries|Internet Marketing|Predictive Analytics|Retail,106000.0,FIN,1,2,0,15737,15737,0
Analytics|Big Data|FinTech|Machine Learning|Web Development,1729000000.0,USA,10,27,874,15833,16707,0
Hardware + Software,150000000.0,IND,1,1,0,16055,16055,0
Heavy Industry|Innovation Engineering|Mining Technologies,60000000.0,CAN,2,2,159,15903,16062,0
Health Care,49761910.0,USA,10,4,2632,13453,16085,0
Clean Technology,111900000.0,NLD,3,20,2045,14181,16226,0
Internet,1278215.0,DEU,2,6,372,16113,16485,0
Security,100000000.0,CZE,2,2,1262,14844,16106,0
Games,4200000.0,USA,1,2,0,14692,14692,0
Travel|Video,275000.0,RUS,2,2,304,15461,15765,0
Biotechnology,27517913.0,USA,13,26,1511,15126,16637,0
Software|Unifed Communications|Wireless,100000000.0,USA,1,1,0,12045,12045,0
Apps|Education|Language Learning|Natural Language Processing|Neuroscience|Teachers,550000.0,IND,1,4,0,16182,16182,0
Advertising|Auctions|Internet Marketing|Mobile|Performance Marketing,48000000.0,CHN,1,1,0,16133,16133,0
Chemicals|Services|Specialty Chemicals,2500000.0,USA,1,2,0,12090,12090,0
Software,49000000.0,GBR,1,1,0,16771,16771,0
Software,26500000.0,USA,1,2,0,13811,13811,0
Health Care,143493604.0,USA,8,14,2389,14363,16752,0
Hardware + Software,9500000.0,USA,2,3,1018,13604,14622,0
Audio|Displays|Hardware|Mobile|Video,36730397.0,USA,4,13,651,16017,16668,0
Consulting,21009963.0,GBR,3,8,771,15397,16168,0
Enterprise Software,28000000.0,USA,4,11,2424,13313,15737,1
Enterprise Software|IT Management|PaaS,500000.0,IND,1,2,0,16414,16414,0
Biotechnology,21850000.0,USA,3,7,643,15680,16323,0
E-Commerce|Fashion|Online Shopping,20000000.0,USA,3,2,1496,13679,15175,0
Security,5000000.0,USA,1,1,0,13953,13953,1
E-Commerce|Online Shopping|Retail,50500000.0,ARG,3,8,803,15949,16752,0
Biotechnology,3938578.0,CAN,2,1,526,15454,15980,0
Mobile,9500000.0,DEU,2,6,302,12513,12815,0
Energy|Oil,40000000.0,USA,1,1,0,16331,16331,1
Services|Software|Sustainability|Transportation|Travel & Tourism,440000.0,MEX,3,5,882,15248,16130,1
Software,36349780.0,USA,9,14,2271,14204,16475,0
Private School,75000000.0,USA,1,2,0,15005,15005,0
Biotechnology|Health and Wellness|Health Care|Pharmaceuticals,208949997.0,USA,6,9,2799,12326,15125,1
Archiving|Cloud Computing|Flash Storage|Mobility|Security|Software|Web Development,90000000.0,USA,2,2,2713,13460,16173,0
Analytics|Cloud Computing|Data Mining|Health Care|Medical|Payments|SaaS|Software|Technology,10975000.0,USA,4,26,1308,14909,16217,0
Biotechnology,48000000.0,USA,1,11,0,12635,12635,0
Mobile,6250000.0,USA,2,3,238,15181,15419,1
Web Hosting,72000000.0,USA,4,14,1760,14501,16261,0
Hardware + Software,13940000.0,USA,3,3,1379,13444,14823,0
Biotechnology,5530000.0,IND,1,1,0,13640,13640,0
Biotechnology|Life Sciences|Medical,75000000.0,USA,4,14,773,15913,16686,0
Security|Software,252000000.0,USA,2,3,1403,13032,14435,1
Health Care Information Technology,890000.0,USA,3,6,529,16087,16616,0
Analytics|Cloud Data Services|Computers|Networking|Software,33000000.0,USA,2,5,638,15645,16283,0
Health Care|Innovation Management,6000000.0,USA,2,6,448,15887,16335,0
Enterprise Software|Health Care|Health Care Information Technology|Healthcare Services,33500000.0,USA,4,2,896,15769,16665,0
Apps|Brand Marketing|Creative|Creative Industries|Design|Mobile|Photography|SaaS|Software|Web Development,19044025.0,USA,4,10,2545,13514,16059,1
Curated Web|Hotels|Travel,10000000.0,HKG,1,1,0,16112,16112,0
Android|Mobile,1800000.0,USA,1,6,0,15836,15836,1
Enterprise Software|Information Technology|Services,10000000.0,USA,1,2,0,16688,16688,0
Enterprise Software,1000000.0,USA,1,1,0,14245,14245,1
Biotechnology,69900000.0,USA,4,19,1577,12808,14385,1
Robotics,25000.0,CAN,2,3,93,16202,16295,0
Biotechnology|Medical|Pharmaceuticals,72300000.0,USA,2,9,368,12909,13277,1
Biotechnology,15067850.0,USA,2,4,231,16119,16350,0
Payments|SaaS|Software,225000000.0,USA,1,7,0,16692,16692,0
Biotechnology,70930000.0,USA,14,34,2432,13445,15877,0
Biotechnology|Pharmaceuticals,31500000.0,USA,4,5,1614,13745,15359,1
Content Creators|Film Production|Internet Marketing|Video|Video Processing,350000.0,RUS,1,2,0,15733,15733,0
Software,7200000.0,USA,1,4,0,12878,12878,0
SaaS|Software,2500000.0,USA,1,1,0,15166,15166,1
B2B|Enterprises|Enterprise Software|Finance|Predictive Analytics|Software,23000000.0,USA,2,10,344,16190,16534,0
Biotechnology,11035003.0,USA,2,5,423,16230,16653,0
Advertising|Classifieds,1342000000.0,RUS,5,9,1607,15124,16731,1
Health Care,600000.0,USA,2,1,603,16149,16752,0
Communications Infrastructure|Health and Wellness|Health Care|Health Care Information Technology|Healthcare Services|Health Diagnostics|mHealth|Mobile Emergency&Health|Mobile Health|Telecommunications,5744992.0,USA,2,7,177,16301,16478,0
Pharmaceuticals,3170201.0,ESP,1,1,0,16370,16370,0
Audio|Creative|Messaging|Semiconductors|Wireless,77447377.0,USA,9,44,3177,12570,15747,0
Software,3947600.0,FRA,2,1,718,14879,15597,0
Games|Social Games,1500000.0,KOR,2,2,490,14944,15434,0
Android|iPhone|Mobile|Software,2150000.0,USA,2,5,543,15431,15974,0
Mobile,2161671.0,GBR,2,5,868,15706,16574,0
Semiconductors,40000000.0,USA,1,2,0,16322,16322,0
Enterprise Software,6430000.0,CAN,1,4,0,13171,13171,0
Software,9000000.0,USA,1,4,0,13430,13430,0
Pharmaceuticals,18001241.4649286,DEU,1,4,0,13007,13007,0
Android|Messaging|Mobile|Software|Telecommunications|Telephony|VoIP,500000.0,USA,1,1,0,15765,15765,0
Biotechnology,22200000.0,ISR,4,10,1527,14803,16330,0
Cloud Infrastructure|Cloud Management|Education|Mobile Devices,41250.0,HKG,1,1,0,16071,16071,0
Governments|Legal|Service Providers,1497447.0,SWE,1,1,0,15681,15681,0
Security,100000.0,RUS,2,1,731,15218,15949,0
Auto|Search,360000.0,RUS,6,2,318,15628,15946,0
Leisure|Restaurants|Travel,420727.0,GBR,3,4,483,15922,16405,0
Infrastructure|Mobile|Video|Wireless,14037121.0,CAN,1,3,0,14638,14638,0
Advertising,20000000.0,USA,1,1,0,14258,14258,1
Curated Web,1500000.0,USA,1,3,0,13300,13300,1
Advertising|Software|Technology|Travel,5595076.0,IRL,1,1,0,16378,16378,0
Legal|Marketplaces|Reviews and Recommendations,132000000.0,USA,5,13,3495,13149,16644,0
Clean Energy|Clean Technology|Renewable Energies,19427954.0,FIN,2,4,3911,12418,16329,0
Apps|Cloud Computing|Infrastructure,16691.0,USA,1,1,0,16627,16627,0
Apps|Internet|Mobile,1000000.0,USA,1,1,0,16498,16498,0
Information Technology|Social Media Marketing|Software,21948190.0,USA,4,2,1803,13717,15520,1
Advertising|Graphics|Messaging,197638.0,MEX,3,3,577,15614,16191,0
Software,60000000.0,USA,4,15,838,14657,15495,0
Consumers|Manufacturing,2500000.0,USA,1,11,0,16664,16664,0
Audio|Email|Messaging|Productivity Software|SMS,1600000.0,USA,5,13,1198,14061,15259,0
Energy Management|Impact Investing|Renewable Energies,100000000.0,USA,1,1,0,15965,15965,0
Internet|Music|Nightclubs|Video Streaming,1955250.0,FRA,1,1,0,14182,14182,0
Mobile|Wearables,650000.0,USA,2,2,23,16335,16358,0
Consumer Electronics|Gps|Wearables,480000.0,USA,2,2,0,16486,16486,0
Location Based Services|Maps,40000.0,DEU,1,1,0,15660,15660,0
Consumer Electronics|Photography|Robotics,50000.0,USA,1,3,0,16191,16191,0
Bridging Online and Offline|Social Media|Social Network Media|Video,343000.0,USA,1,4,0,16175,16175,0
Games,3500000.0,USA,1,9,0,15559,15559,1
Maps|Software,59700.0,USA,4,1,397,14729,15126,1
Communities|Knowledge Management|Q&A,40000.0,CHL,1,1,0,16222,16222,0
Software,14450000.0,USA,3,3,1637,14684,16321,0
Hardware + Software,5070000.0,FRA,1,4,0,14200,14200,0
Software,13800000.0,USA,2,6,1291,11897,13188,1
Manufacturing,9915755.0,GBR,1,1,0,14151,14151,0
Enterprise Software,12000000.0,USA,1,1,0,13285,13285,1
Archiving|Business Services|Cloud Computing|Enterprise Software|Flash Storage|Homeland Security|Storage|Virtualization,113500000.0,USA,7,22,2361,14123,16484,0
Enterprise Software|Internet of Things|M2M|Software,26000000.0,USA,4,5,1394,14543,15937,1
Software,3100000.0,FIN,1,2,0,14265,14265,0
Biotechnology,2847766.53738711,CAN,1,1,0,12850,12850,0
Aerospace,15800000.0,JPN,1,9,0,16694,16694,0
Health Care,3694598.0,USA,3,1,1519,14491,16010,0
Software,12200000.0,USA,2,4,1155,13178,14333,0
Digital Media|Software,6000000.0,CAN,1,1,0,13809,13809,0
Biotechnology,1150000.0,USA,2,2,556,14704,15260,0
Web Hosting,17650000.0,ISR,2,4,891,13045,13936,1
Games,1000000.0,CAN,1,1,0,15869,15869,0
Biotechnology,19400000.0,USA,2,6,756,12843,13599,0
Health and Wellness,9800012.0,USA,3,8,663,15967,16630,0
Marketplaces|SaaS|Software|Trusted Networks,19500000.0,USA,3,10,1376,14918,16294,0
Biotechnology,12500000.0,USA,4,2,2442,14266,16708,0
Software,1070000.0,GBR,1,2,0,13781,13781,0
Software,47628901.0,USA,1,2,0,15229,15229,0
Clean Technology,11465645.0,CAN,4,5,562,15594,16156,0
Legal|Outsourcing|Project Management,28000000.0,USA,1,1,0,15742,15742,0
Software,300000.0,USA,1,1,0,15516,15516,0
Semiconductors,29449981.0,USA,2,4,833,13552,14385,1
Financial Services|Investment Management,10000000.0,USA,1,1,0,11078,11078,0
Enterprise Software,6500000.0,SWE,1,1,0,15832,15832,0
Health Care,43873143.0,USA,8,16,4096,12093,16189,0
Biotechnology,4000000.0,USA,2,2,306,15680,15986,1
Health Care,4970000.0,USA,2,7,1173,13242,14415,0
Mobile,3000000.0,ISR,1,3,0,13650,13650,1
Biotechnology,69919779.0,USA,7,4,2811,13864,16675,1
Health Care|Health Care Information Technology|Web Tools,17700000.0,USA,1,4,0,11528,11528,1
Health Care,4000000.0,USA,2,5,760,15470,16230,0
Software,32600000.0,USA,2,3,401,16154,16555,0
Public Safety,2000000.0,USA,1,1,0,13131,13131,1
Fraud Detection|IT and Cybersecurity|Network Security,9780000.0,GBR,1,2,0,14080,14080,0
Hardware + Software,15000000.0,USA,1,4,0,13459,13459,0
Analytics|Big Data|Big Data Analytics|Business Intelligence|Distribution|Risk Management|Sales and Marketing|Software,44741834.0,USA,4,5,1639,14984,16623,0
Security,14000000.0,ISR,2,4,884,13682,14566,0
Medical,2800000.0,USA,1,6,0,12524,12524,0
Energy,4094392.0,FRA,1,1,0,16622,16622,0
Audio|Chat|Games|VoIP,1071500.0,USA,4,3,2206,12722,14928,0
E-Commerce,4500000.0,USA,3,7,2466,13879,16345,0
Analytics|Big Data|Big Data Analytics|Data Visualization|Machine Learning,106348982.0,USA,7,17,1666,14853,16519,0
Financial Services,1000000.0,IND,1,2,0,16489,16489,0
IT Management|Software,4148278.0,ISR,3,3,2464,14168,16632,0
Mobile|Services,11162400.0,CHN,4,4,418,15949,16367,0
Hardware + Software|Internet of Things|Manufacturing|Services,25400000.0,USA,3,10,850,15340,16190,0
Big Data|Blogging Platforms|Natural Language Processing|News|Semantic Web|Software,500000.0,IRL,4,4,1327,14960,16287,0
Mobile,50700000.0,USA,5,5,2356,12784,15140,0
Health Care|Hospitals,2500000.0,CAN,1,3,0,16532,16532,0
Finance|Social Media|Trading,10283444.0,GBR,6,7,2308,14245,16553,0
Biotechnology,26226850.0,DEU,3,10,803,15603,16406,0
E-Commerce,40000.0,AUT,1,1,0,15777,15777,0
Mobile,21000000.0,USA,1,4,0,13385,13385,0
Health Care|Information Technology|Software,3000000.0,USA,2,2,201,16450,16651,0
Mobile,15000000.0,USA,1,1,0,13985,13985,1
Enterprise Software|Marketing Automation|Sales and Marketing|Software,2132476.0,FRA,1,1,0,16512,16512,0
Enterprise Software|Mobile|Unifed Communications|Web Development,15000297.0,USA,2,2,524,13823,14347,1
Information Technology,29000000.0,FRA,2,8,800,10957,11757,1
Biotechnology,9715488.0,USA,3,3,214,15201,15415,0
Enterprise Software|Productivity Software|Project Management|SaaS|Social Media|Social Network Media|Task Management,2435000.0,FRA,2,3,1155,15531,16686,0
Cloud Infrastructure|Internet of Things|M2M|Software,16958397.0,DEU,3,1,1308,14488,15796,0
Curated Web|Finance Technology|Financial Services|FinTech|Personal Finance|Virtualization,31591693.0,GBR,4,17,895,15706,16601,0
Telecommunications|Test and Measurement,30900000.0,USA,3,6,1128,12366,13494,0
Internet|Mobile|Wireless,80000000.0,USA,2,2,656,13422,14078,0
E-Commerce,40000.0,ARG,1,1,0,15939,15939,0
Corporate Wellness|Farmers Market|Farming|Food Processing|Health and Wellness,650000.0,USA,1,1,0,16222,16222,0
Web Hosting,34649948.0,USA,6,8,1794,13410,15204,1
Mobile,4050000.0,USA,1,3,0,13347,13347,0
Games,34500000.0,USA,1,1,0,16155,16155,0
Enterprise Software|Video Streaming,28100000.0,USA,6,8,1860,13757,15617,1
Software,82230000.0,USA,2,15,712,13057,13769,0
Advertising|Software,109883.0,GBR,4,9,815,15181,15996,0
Web Hosting,3387542.0,USA,2,2,332,15174,15506,0
Software,3416215.0,USA,2,3,1112,15182,16294,0
Cloud Management|Enterprise Software|Marketing Automation|SaaS|Software,5180000.0,USA,3,2,661,15690,16351,0
Hospitality,10000000.0,IND,1,1,0,16629,16629,0
Clean Technology|Energy|Renewable Energies,47200000.0,IND,6,5,2051,14201,16252,0
Software,15000000.0,GBR,1,5,0,12950,12950,1
Semiconductors,11999999.0,USA,3,4,1412,13149,14561,1
Software,267689.0,GBR,1,1,0,16290,16290,0
Semiconductors,19341550.0,DEU,1,5,0,14937,14937,0
Legal,100000.0,RUS,1,1,0,15400,15400,0
Biotechnology,4200000.0,USA,1,3,0,12871,12871,0
Enterprise Software,1300000.0,BRA,1,1,0,15796,15796,0
Finance|FinTech|Networking,7500000.0,USA,2,2,601,12784,13385,1
Advertising|Information Technology|Software|Technology,3134000.0,ESP,2,4,455,13149,13604,0
Web Hosting,1000000.0,ISR,1,2,0,14641,14641,0
Automotive|Marketplaces|Recycling,885313.0,PRT,1,2,0,16261,16261,0
Environmental Innovation|Oil|Technology,217391.0,DNK,1,1,0,16028,16028,0
Games,9850000.0,USA,3,10,765,13432,14197,0
Event Management|Events|Services,6500000.0,USA,1,3,0,11403,11403,0
Hardware + Software,20000000.0,USA,1,1,0,12807,12807,0
Marketplaces|Services|Supply Chain Management,101000000.0,RUS,2,5,301,15495,15796,0
Customer Service|Hardware + Software|Mobile|Supply Chain Management|Tablets,15000000.0,DEU,2,3,1024,15340,16364,0
E-Commerce|Internet,23100000.0,CHN,2,3,593,15393,15986,0
Enterprise Search|Software|Web Development,14500000.0,USA,3,7,926,14872,15798,0
Software,20000000.0,USA,2,4,688,13557,14245,0
Digital Signage|Hardware + Software,6000000.0,CAN,3,3,1173,14917,16090,0
Software,425975.0,ITA,2,4,128,15964,16092,0
iPhone|Messaging|Mobile|VoIP,1500000.0,USA,1,1,0,15104,15104,0
E-Commerce,5000000.0,USA,2,2,468,15857,16325,0
Curated Web|Information Technology|Services|Staffing Firms,10000000.0,IND,2,3,1061,15492,16553,0
E-Commerce|Startups,4525000.0,USA,3,13,335,15126,15461,0
Local|Mobile|Social Media|Social Search,225000.0,USA,2,2,460,15584,16044,0
Media|News|Parenting,6250000.0,USA,3,6,470,14280,14750,1
Mobile|Television|Web Development,13200000.0,GBR,1,1,0,12935,12935,0
Collaborative Consumption|Communications Infrastructure|Communities|Consumer Electronics|Crowdsourcing|Curated Web|Events|Hospitality|Language Learning|Mobile|Natural Language Processing|Real Time|Skill Assessment|Social Travel|Tourism|Translation|Travel,190000.0,GBR,3,5,687,15095,15782,0
B2B|Cloud Computing|Enterprise Software|SaaS,854343.0,BEL,1,2,0,13638,13638,0
Consumers|Delivery|Hospitality,276744.12871128303,ALB,2,1,121,16617,16738,0
E-Commerce,19950000.0,USA,3,3,1519,13678,15197,0
Babies|Health Care|Wearables,65000.0,DEU,3,4,720,15898,16618,0
E-Commerce,900000.0,RUS,2,7,144,14914,15058,0
Education,2000000.0,CHN,2,2,243,15706,15949,0
Education,11000000.0,CHN,3,2,1552,13848,15400,0
Information Technology,600000.0,IND,1,2,0,16602,16602,0
E-Commerce|Parenting|Women,200000.0,USA,1,5,0,15706,15706,0
E-Commerce,650000.0,USA,2,6,329,15552,15881,0
E-Commerce,2500000.0,IND,2,3,230,15079,15309,1
Social Media,26000000.0,CHN,4,4,2584,13514,16098,0
Electronics|Health and Wellness|Health Care|Medical,37200000.0,USA,3,6,2146,11474,13620,1
DIY|Environmental Innovation,2000000.0,USA,1,9,0,16596,16596,0
Development Platforms|Software|Web Development,1710000.0,ISR,4,8,723,15459,16182,0
Software,5300001.0,USA,2,1,1197,14349,15546,0
Messaging|Social Media,200000.0,USA,1,1,0,16020,16020,0
Chat,200000.0,USA,1,1,0,16020,16020,0
Beauty|Health and Wellness|Health Care,8671127.0,USA,2,2,29,16398,16427,0
Information Technology,30000000.0,USA,1,1,0,13888,13888,0
Accounting|Financial Services|FinTech|Human Resources|Software,8650000.0,USA,3,9,254,15643,15897,0
Local Businesses|Social Commerce|Social Travel,120000.0,USA,1,1,0,16267,16267,0
Apps|Curated Web,18900000.0,USA,3,21,1298,15202,16500,0
Photography,162500.0,USA,2,1,237,15765,16002,0
Search,200000.0,USA,4,2,879,15674,16553,0
Enterprise Software,1130000.0,USA,1,7,0,16322,16322,0
Health Care,479233.0,CAN,1,1,0,16010,16010,0
Advertising,1315000.0,USA,4,12,2083,14031,16114,1
SaaS|Software|Storage,2000000.0,NLD,1,2,0,15770,15770,1
Enterprise Software,19525000.0,USA,5,19,1075,14457,15532,1
Education,105000.0,USA,2,1,1138,14245,15383,0
Broadcasting,20000000.0,USA,1,1,0,12430,12430,0
Biotechnology,6250000.0,USA,2,6,2631,12095,14726,1
Biotechnology,18420305.0,USA,4,3,809,15845,16654,0
Biotechnology|Water,1411754.0,GBR,2,2,341,15365,15706,0
Open Source,500000.0,GBR,1,1,0,15369,15369,0
Software,5000000.0,GBR,1,1,0,15134,15134,0
Games,698453.0,ITA,4,3,653,15614,16267,0
Travel,20000.0,USA,1,1,0,15626,15626,0
Mobile Software Tools,1100000.0,USA,1,3,0,16174,16174,0
Enterprise Software|Software,28000.0,USA,1,1,0,16020,16020,0
Enterprise Software,39950000.0,USA,5,17,880,14610,15490,0
E-Commerce|Facebook Applications|Fashion|Gamification|Sales and Marketing|SEO|Social Media Marketing|Twitter Applications,350000.0,USA,1,6,0,15532,15532,0
Curated Web|Online Dating|Social Network Media,30564744.0,GBR,1,1,0,13879,13879,0
Manufacturing|Transportation,83700000.0,USA,2,1,284,14578,14862,1
Medical Devices,13500000.0,USA,3,6,228,16416,16644,0
Location Based Services|Restaurants|Specialty Foods,36000000.0,KOR,1,1,0,16400,16400,0
Advanced Materials|Aerospace|Clean Technology|Space Travel,655000.0,USA,3,2,365,16161,16526,0
E-Commerce,6400000.0,GBR,2,1,190,15285,15475,0
Advertising|Search,1200000.0,BAH,1,3,0,13879,13879,0
Social Media,1476100.0,FRA,1,1,0,13848,13848,0
Search,161200000.0,CHN,4,16,3678,10988,14666,1
Enterprises|Enterprise Software,42200000.0,CHN,3,2,1123,15156,16279,0
Social Media,250000000.0,CHN,4,5,3518,13057,16575,0
Social Media,66000000.0,CHN,3,3,1900,13604,15504,0
Games,12273.0,EST,1,1,0,15553,15553,0
Android|Apps|Collaborative Consumption|Developer APIs|File Sharing|iOS|Mobile|Security|Software,1020000.0,DEU,2,4,1207,13984,15191,0
Health and Wellness,1000000.0,CHN,2,2,363,15309,15672,0
Classifieds,510000000.0,CHN,6,12,3764,12874,16638,0
E-Commerce,60000000.0,CHN,1,1,0,15309,15309,0
Security,22813005.0,USA,2,1,2231,12159,14390,1
Apps|Internet|Project Management|Software,168000.0,USA,1,2,0,15138,15138,0
Energy Management|Natural Resources|Oil & Gas,39000000.0,USA,1,1,0,16147,16147,0
Food Processing,9600000.0,IND,1,2,0,16489,16489,0
Families|Marketplaces,18330.0,SGP,1,1,0,16540,16540,0
Accounting|IT and Cybersecurity|Software,8000000.0,HUN,1,1,0,16239,16239,0
Search|Technology,1079000.0,RUS,2,2,426,15218,15644,0
Enterprise Software|Finance Technology,1500000.0,USA,2,3,314,15223,15537,1
Pharmaceuticals,21000000.0,USA,2,3,47,16513,16560,0
E-Commerce|Mobile Payments|Payments|Peer-to-Peer,3550000.0,USA,4,23,1145,15016,16161,0
Accounting|Productivity Software|SaaS,3300000.0,USA,2,6,181,16344,16525,0
Games|Music|Video|Video Streaming,871189.0,IRL,3,5,1669,13879,15548,1
Advertising|Media|Software,24500100.0,USA,7,11,2532,13422,15954,0
Internet|Services|Spas,2042993.0,FRA,2,2,1285,14975,16260,0
Clean Technology,12500000.0,CAN,2,1,927,14634,15561,1
Collaboration|Enterprise Software|Innovation Engineering|Mobile Enterprise|SaaS,88000.0,USA,3,1,844,15796,16640,0
Electronics,220777.0,LVA,1,1,0,15316,15316,0
Auto|Automotive|Cars,6000000.0,USA,1,1,0,12600,12600,0
Ticketing,8000000.0,EST,1,1,0,15975,15975,0
Gamification|Online Gaming|Video Games,118794.0,ITA,2,3,376,15787,16163,0
E-Commerce,24012806.0,CHN,1,1,0,15706,15706,0
Curated Web,45791999.0,USA,5,5,1945,14777,16722,0
Social Media Platforms,20000.0,USA,1,1,0,16671,16671,0
Mobile|Real Time|Video|Video Streaming,2500000.0,SWE,2,2,1784,14092,15876,0
Enterprise Software,10000000.0,USA,2,5,684,13670,14354,0
Events|Peer-to-Peer|Tourism|Travel,32521.0,ITA,1,1,0,15857,15857,0
E-Commerce|Mobile Payments,7704358.0,DNK,1,1,0,15894,15894,0
Consumer Electronics|Hardware + Software|Music|Startups,25000.0,USA,2,2,315,15887,16202,0
Music,378812.0,GBR,1,1,0,16035,16035,0
Content Delivery|E-Commerce|Music Services|Startups,27600000.0,USA,4,12,1368,14791,16159,0
Apps|Concerts|Ediscovery|Events|Facebook Applications|Mobile|Music|Social Media Marketing,375000.0,USA,4,2,1249,13361,14610,1
Apps|Big Data|Email Marketing|Mobile|Music|Social Search,60000000.0,USA,2,4,151,13422,13573,0
Mobile,12516053.0,USA,2,2,748,13713,14461,0
Crowdfunding|Entertainment|Music|Social Media|Startups,210082.0,MEX,2,2,486,15279,15765,0
Public Transportation|Transportation,725000.0,USA,3,1,335,16049,16384,0
Automated Kiosk|Digital Media|Marketing Automation|Media|Sales and Marketing,14000000.0,USA,1,2,0,11631,11631,0
Android|Mobile Security|Mobile Software Tools,40000000.0,CHN,3,3,1629,14791,16420,0
Games,1969350.0,ITA,1,1,0,15812,15812,0
Android|Apps|Concerts|Internet|iOS|iPad|iPhone|Location Based Services|Mobile|News|Real Time|Social Media|Social Search|Sports,121000000.0,USA,3,8,1739,14822,16561,0
Credit Cards|Curated Web|Finance|Insurance|Real Estate Investors,79000000.0,IND,3,8,1567,15051,16618,0
Finance,3000000.0,IND,2,4,419,16192,16611,0
Banking|Consumer Lending|Personal Finance,5400000.0,BRA,2,6,654,15996,16650,0
Finance,6000000.0,RUS,2,2,1188,14761,15949,0
Advertising|Internet|Media|Mobile|Sales and Marketing,66023.0,FRA,1,1,0,15706,15706,0
Banking|Enterprise Software|Finance,15290000.0,USA,4,17,1318,14549,15867,1
Curated Web,120000.0,USA,1,5,0,16267,16267,0
Manufacturing,3914505.0,AUS,1,1,0,16168,16168,0
Enterprise Software,1000000.0,USA,1,1,0,12789,12789,0
Cloud Computing|Collaboration|SaaS,144000.0,USA,2,4,273,15492,15765,0
Consulting|Facebook Applications|News|Social Media|Twitter Applications,1700000.0,USA,1,8,0,15250,15250,1
Software,950000.0,USA,2,2,90,13483,13573,0
E-Commerce,40000.0,USA,1,1,0,16028,16028,0
Entertainment|Games|Kids|MMO Games|Parenting|Virtual Worlds|Web Development,1854110.0,ESP,2,4,30,14770,14800,0
Software,15000000.0,CHN,1,2,0,14211,14211,0
Services|Video|Video Streaming,10000000.0,CHN,1,4,0,16540,16540,0
Travel,10000000.0,CHN,1,1,0,16181,16181,0
Nanotechnology|Semiconductors,1890000.0,ESP,1,1,0,14741,14741,0
Big Data Analytics|iPhone|Mobile|Nightlife,105000.0,USA,3,1,518,15765,16283,0
Customer Service|Mobile Commerce|Mobile Payments|Restaurants,63992.0,GBR,2,2,610,15765,16375,0
Web Hosting,67000000.0,ISR,2,6,238,12990,13228,0
Lifestyle Products,265064.0,ESP,1,1,0,15867,15867,0
E-Commerce,40000.0,USA,1,1,0,15138,15138,0
Hospitality,11220722.0,GBR,2,2,787,15433,16220,0
ICT|Online Travel|Travel|Travel & Tourism,571049.0,ITA,3,3,879,15492,16371,0
Hospitality|Specialty Foods,9250000.0,USA,1,3,0,15909,15909,0
News,20000.0,USA,1,1,0,15764,15764,0
Logistics,20000.0,USA,1,1,0,16290,16290,0
Computers|Startups|Technology,1353678.0,USA,2,1,97,16064,16161,0
Business Analytics|Cloud Computing|Data Visualization,500000.0,USA,1,1,0,16343,16343,0
Pets,21725000.0,USA,4,20,914,15348,16262,0
Pets,617291.0,ESP,2,1,322,16234,16556,0
Consumers,131449.227735787,EST,1,2,0,16581,16581,0
Art|Auctions|Databases|Search,4100000.0,SWE,3,11,1033,15509,16542,0
E-Commerce,300000000.0,USA,1,1,0,15460,15460,1
Biotechnology,17400000.0,USA,4,5,2548,13208,15756,0
Health Care,77800000.0,USA,4,18,3613,13149,16762,0
Biotechnology,33200000.0,USA,3,11,1719,12761,14480,1
Communications Hardware|Computers|Security,45610000.0,USA,3,3,1368,13157,14525,1
Web Hosting,65000000.0,GBR,2,1,7,14965,14972,0
Cyber Security|Design|SaaS|Security,1200000.0,IRL,2,3,98,16447,16545,0
Health Care|Medical|Technology,15000000.0,USA,1,6,0,14804,14804,1
Business Services|Curated Web|Social Network Media|Trading,40000.0,UKR,2,1,414,14549,14963,0
Social Media,2300000.0,USA,2,3,511,16071,16582,0
Games,293676.0,KOR,1,1,0,16220,16220,0
CRM|Software,52900000.0,USA,4,20,1677,15030,16707,0
Advertising|Entertainment|Mobile|Music|Sports|Television|Video|Video Streaming,14345752.0,FRA,2,3,425,15232,15657,0
Biotechnology,1710600.0,DEU,1,1,0,15219,15219,0
Curated Web|Internet|Web Design,22918631.0,GBR,5,9,1868,14335,16203,0
Big Data Analytics|Logistics|Transportation,600000.0,SGP,1,1,0,16375,16375,0
Advertising,36000000.0,CHN,2,1,365,14031,14396,0
Android|Facebook Applications|Gambling|Game|Games|iPhone|Social Media,1200000.0,USA,2,1,188,15258,15446,1
E-Commerce,2139250.0,CHN,2,1,426,14761,15187,0
Information Technology,1700000.0,EGY,1,4,0,16673,16673,0
Cloud Infrastructure|Databases|Software,57544866.0,USA,7,6,2105,14343,16448,0
Health and Wellness,141526000.0,NLD,1,2,0,16031,16031,0
Cloud Computing|SaaS|Software,688530.0,CAN,2,1,243,14883,15126,0
E-Commerce|Fashion,500000.0,BRA,1,3,0,15765,15765,0
Fitness|Health and Wellness,43500000.0,USA,3,14,931,15055,15986,1
Analytics|Language Learning|Search|Software|Text Analytics,7500000.0,USA,2,2,1056,11422,12478,0
Biotechnology,911000.0,CHE,1,1,0,14106,14106,0
Curated Web|Fashion,1000000.0,USA,1,5,0,15888,15888,0
Cyber Security|Information Security|Internet of Things|Security,16274967.0,USA,3,6,348,16323,16671,0
Security,645754.0,GBR,1,1,0,15050,15050,0
Advertising|Music|Video|Women,58500000.0,USA,5,6,3202,13239,16441,0
E-Commerce|Furniture,12879637.0,GBR,1,1,0,15894,15894,0
E-Commerce,12060066.0,GBR,2,4,543,14910,15453,0
Curated Web,2340000.0,FRA,1,1,0,14057,14057,0
Mobile,45154980.0,USA,2,5,1338,13657,14995,0
Finance|FinTech,45000000.0,USA,2,3,2267,13664,15931,0
Pharmaceuticals,35500000.0,USA,2,12,775,12103,12878,0
Software,3300000.0,USA,2,5,273,15471,15744,0
Energy|Oil|Oil & Gas,220000000.0,USA,1,2,0,16406,16406,0
Games|Video Game Tournaments,3500000.0,CAN,3,21,785,15645,16430,0
Online Travel|Services,2500000.0,USA,1,1,0,16582,16582,0
E-Commerce|Fashion|Flash Sales|Jewelry,15600000.0,USA,3,14,1362,14918,16280,0
E-Commerce,7505382.9665234005,BEL,2,1,1609,15161,16770,0
Curated Web,278485.0,ITA,3,6,592,16091,16683,0
Health Care,51200000.0,USA,3,9,1932,14124,16056,1
Big Data Analytics|Information Services|Risk Management,8000000.0,USA,1,1,0,16266,16266,0
Web Hosting,34400000.0,USA,3,16,1348,12377,13725,0
Messaging,2500000.0,IND,1,1,0,13908,13908,0
Browser Extensions|Email|Messaging,393000.0,USA,2,8,572,14497,15069,0
Big Data|Data Mining|Non Profit,120000.0,USA,1,1,0,16267,16267,0
Events|Home Owners,1420921.0,GBR,1,1,0,16169,16169,0
Reviews and Recommendations|Search|Software|Web Design,32495730.0,USA,4,9,3458,12843,16301,0
Software,14000000.0,USA,1,2,0,12898,12898,0
Android|iOS|iPad|iPhone|Mobile,40000.0,CHL,1,1,0,15411,15411,0
Banking|Insurance|Price Comparison,998999.0,ARE,1,1,0,16614,16614,0
E-Commerce|Online Shopping|Social Media,2000000.0,PHL,2,1,730,15340,16070,0
Apps|iOS|iPad|iPhone|Mobile|Photo Editing|Photography|Social Media,125000.0,ISR,2,1,475,15474,15949,0
Content|E-Commerce|Internet|Networking|Reviews and Recommendations|SaaS|Social Commerce|Social Media|Software,130552663.0,USA,5,10,2391,13269,15660,1
Content|Graphics|Software|Visualization,5000000.0,RUS,1,1,0,14944,14944,0
Biometrics|Fitness|Medical Devices,25000.0,USA,1,1,0,16467,16467,0
Advertising,10000000.0,USA,1,2,0,13896,13896,1
Web Hosting,16000000.0,USA,3,2,2847,12509,15356,1
Hardware + Software,4900000.0,GBR,2,4,483,16023,16506,0
Software,8000000.0,USA,1,1,0,13259,13259,0
Enterprise Software,11000000.0,CHN,1,1,0,13776,13776,0
Health and Wellness,1557700.0,FIN,2,2,2024,14018,16042,0
Manufacturing,700000.0,USA,2,1,3503,12531,16034,1
Entertainment|Games|Incentives|Loyalty Programs|Media|SaaS|Social Media|Virtual Currency,1950000.0,USA,2,3,27,15434,15461,0
Advertising,938830.0,KOR,2,2,348,15692,16040,1
Mobile,3986000.0,AUS,2,3,240,12843,13083,0
Clean Technology,16000000.0,USA,2,4,741,15261,16002,0
Customer Service|Online Travel|Services|Shopping,4200000.0,DEU,1,3,0,16574,16574,0
Social Media,4000000.0,ISR,2,2,303,15068,15371,0
Advertising,22500000.0,USA,2,9,652,13192,13844,0
Software,35869729.0,USA,3,8,2296,12892,15188,0
Advertising|E-Commerce|Mobile,467289.0,AUS,1,1,0,16180,16180,0
Hospitality,12748172.0,GBR,1,1,0,15279,15279,0
Hospitality,37500.0,ARG,2,2,625,16029,16654,0
Curated Web,4500000.0,USA,1,2,0,16321,16321,0
Web Hosting,5000000.0,USA,2,2,656,12146,12802,0
Software,297549.0,DNK,1,1,0,15899,15899,0
Curated Web|Match-Making|Online Dating,26517500.0,ARM,2,2,188,14008,14196,0
Enterprise Software|Finance,11512944.963490801,ESP,2,3,897,15683,16580,0
Internet,3000000.0,GBR,1,1,0,12549,12549,1
E-Commerce,74675009.0,USA,4,19,566,14774,15340,0
Travel,7500000.0,USA,1,3,0,16638,16638,0
Health Care,10335613.0,USA,3,1,584,15187,15771,0
Biotechnology,40000.0,CHL,1,1,0,15566,15566,0
Artificial Intelligence|Business Productivity|Collaboration|Information Services|Machine Learning|Natural Language Processing|SaaS,300000.0,CAN,3,3,967,15528,16495,0
Medical|Service Providers|Training,40000.0,CHL,1,1,0,16222,16222,0
VoIP,3000000.0,RUS,1,1,0,15949,15949,0
Semiconductors,1300000.0,CHE,1,1,0,14013,14013,0
Messaging|Mobile|Photo Sharing|Real Time,450000.0,CAN,1,2,0,16552,16552,0
Wine And Spirits,5170000.0,USA,1,1,0,13473,13473,0
Web Hosting,38360000.0,USA,3,7,979,12207,13186,0
Photography,9500000.0,ISR,1,2,0,16167,16167,0
Curated Web|Reviews and Recommendations,500000.0,AUS,1,1,0,16611,16611,0
Finance,40000.0,USA,1,1,0,15940,15940,0
SaaS|Small and Medium Businesses|Software|Taxis,10000000.0,USA,2,6,335,16274,16609,0
Mobile,40000.0,IRL,1,1,0,15407,15407,0
Consumer Internet,2380000.0,USA,3,3,577,15720,16297,0
Enterprise Software,955000.0,JPN,1,1,0,16065,16065,0
Communications Hardware|Consumer Electronics|Internet of Things|Mobile|Public Safety,2890000.0,USA,2,3,313,16288,16601,0
Biotechnology,2500000.0,USA,1,2,0,15811,15811,0
Local Businesses,151525.0,GBR,1,2,0,16092,16092,0
Information Technology,5000000.0,AUS,1,1,0,16651,16651,0
Consumer Goods,1000000.0,USA,2,2,309,16059,16368,0
Games|Music,97000.0,USA,2,6,59,15706,15765,0
Music,15400000.0,KOR,3,14,610,15847,16457,0
Music,1700000.0,USA,2,4,745,15435,16180,0
Music,383006.0,GBR,1,1,0,16680,16680,0
Hardware|Music,500000000.0,USA,1,1,0,15975,15975,1
Android|Internet|iOS|Music,120000000.0,USA,2,7,375,15765,16140,0
Artists Globally|Collaboration|Event Management|Events|Music|SaaS|Software,1219318.0,BEL,3,3,507,15949,16456,0
Social Media,150000.0,RUS,1,1,0,15287,15287,0
E-Commerce|Fashion|Mobile|Retail|Social Media,1218770.0,CAN,2,2,210,15400,15610,0
Machine Learning|Photography|SaaS|Social Network Media,167856.0,IRL,2,1,38,16375,16413,0
Beauty|Mobile,1200000.0,USA,1,3,0,16295,16295,0
Curated Web,775000.0,USA,2,4,0,16205,16205,0
Beauty,2200000.0,USA,1,3,0,16196,16196,0
Wholesale,1260228.0,GBR,1,1,0,16230,16230,0
Beauty|Media,2000000.0,USA,1,16,0,16330,16330,0
Beauty|Cosmetics|E-Commerce|Health Care,21269417.0,USA,1,1,0,16434,16434,0
E-Commerce,8500000.0,USA,3,11,926,14929,15855,0
E-Commerce,10200000.0,BRA,1,2,0,15778,15778,0
Babies|E-Commerce,1200000.0,MEX,2,2,377,15765,16142,0
Social Media|Social Network Media,15000000.0,USA,1,2,0,13269,13269,1
Semiconductors,97800000.0,USA,5,27,1392,12964,14356,1
Fashion|Lifestyle|Lingerie,1298719.14683085,GBR,1,1,0,13851,13851,0
Education,1400000.0,USA,1,1,0,15961,15961,0
Analytics|Big Data Analytics|New Technologies|SaaS|Sales and Marketing,23000000.0,USA,3,7,1214,15248,16462,0
Communities|Health and Wellness|Social Commerce,66299.0,DEU,1,1,0,15918,15918,0
Advertising Platforms|Comparison Shopping|E-Commerce Platforms|Performance Marketing|Search|Shopping,37200000.0,USA,4,10,1415,12662,14077,1
SNS|Social Media,100000.0,CHN,1,1,0,14244,14244,0
Health and Wellness,4003472.0,FIN,2,4,318,16000,16318,0
Biotechnology,212135.0,GBR,1,3,0,15930,15930,0
Social Media,500000.0,CHN,2,3,1522,12996,14518,0
Data Integration|SaaS|Software,3100000.0,USA,1,4,0,16538,16538,0
All Students|Hospitality|Peer-to-Peer|Rental Housing|Travel,3515401.0,FRA,4,3,1703,14488,16191,0
Games,10850000.0,USA,5,4,843,15744,16587,0
Big Data|Media|Software,500000.0,TUR,1,1,0,14301,14301,0
Education,20000.0,USA,1,1,0,16270,16270,0
EdTech|Education|Technology,389590.0,ESP,2,5,147,15628,15775,0
Advertising|Incentives|Sales and Marketing|Social Media,9522.0,CAN,1,1,0,14610,14610,0
Software,3500000.0,USA,2,1,1233,15034,16267,0
Biometrics|E-Commerce|Fraud Detection|Identity|Security,70000.0,USA,3,3,211,15809,16020,0
Big Data,580000.0,USA,2,4,479,16269,16748,0
E-Commerce|Email Marketing|Marketing Automation|SaaS|Social Commerce,225000.0,SGP,3,1,395,16314,16709,0
Advertising,20000.0,USA,1,1,0,16357,16357,0
Navigation,11240000.0,AUS,1,3,0,11954,11954,1
Collaboration|Digital Media|Enterprises|Enterprise Software|Human Resources|Mobile|SaaS|Small and Medium Businesses|Social Business,573614.0,GBR,2,4,202,15890,16092,0
Software,25000.0,USA,1,1,0,15400,15400,0
Consumer Electronics|Mobile|Sensors|Wireless,4000000.0,USA,2,22,183,16222,16405,0
Automotive|E-Commerce,78950000.0,USA,4,29,350,16084,16434,0
News|Social Media,400000.0,GBR,1,3,0,15175,15175,1
Communities|Retail|Services,90000000.0,JPN,2,6,176,16525,16701,0
Craft Beer,165992.0,GBR,1,1,0,16164,16164,0
Consumer Goods|Lifestyle Products|Wine And Spirits,246841.0,GBR,1,1,0,16102,16102,0
Automotive|B2B|Field Support Services|Fleet Management|Government Innovation|Hardware + Software|Internet of Things|Parking|Taxis,320000.0,NLD,2,1,317,15675,15992,0
Software,500000.0,DEU,1,1,0,15126,15126,0
iPad|Reviews and Recommendations|Social Television|Software|Television|Video on Demand,9500000.0,ITA,2,2,713,14398,15111,0
Advertising|Video,3250000.0,USA,2,1,754,13879,14633,0
Entertainment|Music|Music Services,7216281.0,FRA,2,2,642,14245,14887,1
Software,2540000.0,USA,1,2,0,13248,13248,0
Information Technology|Outsourcing|Technology,45000000.0,RUS,3,2,366,15340,15706,0
Advertising,10000000.0,RUS,1,1,0,15645,15645,0
Finance|Internet|Payments,129000000.0,USA,2,7,694,15951,16645,0
Creative Industries|Internet,6500000.0,USA,1,8,0,15474,15474,1
Advertising|Analytics|Big Data|Machine Learning,250000.0,USA,2,2,92,16010,16102,0
Software,355000.0,USA,1,1,0,15492,15492,1
Biometrics|Security,8186733.0,SWE,3,10,2533,13879,16412,0
E-Commerce,124400000.0,CHN,2,7,161,16297,16458,0
Biotechnology,171600000.0,CHN,2,6,178,16389,16567,0
Biotechnology,770416.0,CHN,3,1,1977,13118,15095,0
Advertising,7458702.0,CHN,2,3,1004,13818,14822,0
Consulting,3000000.0,CHN,1,1,0,13027,13027,0
E-Commerce,10000000.0,CHN,1,1,0,15248,15248,0
Enterprises,1465559.0,CHN,1,1,0,14365,14365,0
Clean Technology,3883928.0,CHN,1,1,0,13818,13818,0
Curated Web,20000000.0,CHN,1,1,0,14718,14718,0
Biotechnology,2194051.0,CHN,1,1,0,14123,14123,0
Advertising,8830000.0,CHN,1,2,0,14840,14840,0
Mobile,8759124.0,DEU,1,1,0,14214,14214,0
Enterprise Software,7342309.0,CHN,1,1,0,15187,15187,0
Games,17747691.0,CHN,4,4,1492,13695,15187,0
Messaging,86370000.0,CHN,5,5,3103,11566,14669,0
Mobile,3174603.0,CHN,1,1,0,15431,15431,0
Software,30000000.0,CHN,1,6,0,13291,13291,0
Software,8500000.0,CHN,2,2,1280,10286,11566,0
Games|Video,12000000.0,CHN,2,2,421,14705,15126,0
Mobile,162364.0,CHN,1,1,0,15006,15006,0
Security,3000000.0,CHN,2,3,625,14470,15095,0
Photography,7540262.0,CHN,2,1,182,14579,14761,1
Software,6000000.0,CHN,2,1,913,12570,13483,0
Mobile,6500000.0,CHN,2,5,516,13118,13634,0
E-Commerce,70500000.0,CHN,5,14,2434,13088,15522,0
Search,1000000.0,CHN,1,1,0,13301,13301,0
Advertising,50000000.0,CHN,5,14,1012,14791,15803,0
EdTech|Education,10000000.0,CHN,1,1,0,15218,15218,0
Games,2100000.0,CHN,3,3,640,15309,15949,0
Games,1000000.0,CHN,2,1,640,15400,16040,0
Public Transportation,11623640.0,CHN,2,1,515,14641,15156,0
Search,3578158.0,CHN,2,2,62,13695,13757,0
E-Commerce,340000000.0,CHN,2,7,204,16553,16757,0
Education,2435460.0,CHN,1,1,0,15187,15187,0
Games,16820910.0,CHN,2,2,1640,14278,15918,0
Enterprise Software,2435460.0,CHN,1,1,0,15887,15887,0
Manufacturing,20000000.0,CHN,2,2,881,14153,15034,0
Mobile,16236400.0,CHN,1,1,0,15979,15979,0
Enterprise Software,4390000.0,CHN,1,1,0,14678,14678,0
Health Care|Medical,10248901.0,CHN,1,2,0,14700,14700,0
Web Hosting,8000000.0,ISR,2,5,700,12793,13493,1
Advertising|Apps|Data Integration|Mobile|Mobile Advertising|Software,7550000.0,USA,3,3,288,15328,15616,0
Consulting,1603420.0,CHN,3,4,1824,14730,16554,0
Games,755700.0,CHN,1,1,0,15498,15498,0
E-Commerce,6914294.0,CHN,2,2,181,14975,15156,0
Mobile|Wireless,60900000.0,CAN,4,26,1377,12500,13877,1
Freelancers|Internet|Marketplaces,40000.0,BGD,2,1,530,16040,16570,0
Design|E-Commerce|Fashion,40000.0,CHL,1,1,0,15918,15918,0
Beauty|Cosmetics|E-Commerce|Retail,45000000.0,BRA,3,4,1627,14975,16602,0
Apps|Automotive|Cars|Innovation Management|Mechanical Solutions|Mobile|Transportation,10198.022943285401,EGY,1,1,0,16258,16258,0
Curated Web|Wine And Spirits,7000000.0,USA,1,1,0,12935,12935,1
Machine Learning|Predictive Analytics|Software,3486023.0,USA,2,1,172,14214,14386,0
Curated Web,60000000.0,FRA,1,4,0,16589,16589,0
Fashion,375000.0,IND,1,4,0,16674,16674,0
Biotechnology,5310250.0,USA,2,3,925,15613,16538,0
Curated Web,10300000.0,USA,1,3,0,14595,14595,0
Hardware + Software|Health Care,4500000.0,USA,1,14,0,16213,16213,0
E-Commerce,4070000.0,SGP,2,7,602,15726,16328,0
Collaborative Consumption|Labor Optimization,7800000.0,USA,4,15,747,15645,16392,0
Biotechnology,145932588.0,USA,10,15,2514,13795,16309,1
Design|Innovation Management|Mobile|Mobile Commerce,13000000.0,KOR,1,2,0,15879,15879,1
Advertising|Android|Incentives|iPhone|Loyalty Programs|Marketing Automation|Mobile|Small and Medium Businesses,24975000.0,USA,4,10,758,15187,15945,0
Clean Technology,40000.0,CHL,1,1,0,15404,15404,0
Internet,5000000.0,IND,1,6,0,16608,16608,0
Public Relations,928135.0,ITA,1,1,0,14628,14628,0
Video,2000000.0,USA,1,2,0,16644,16644,0
Business Services|Project Management|SaaS|Service Providers|Small and Medium Businesses,100000.0,USA,1,1,0,15681,15681,0
Curated Web|Fashion|Photography,150000.0,USA,4,3,487,14092,14579,0
Crowdsourcing|Market Research|Shopping,2767387.0,ITA,1,4,0,16199,16199,0
Travel,3540000.0,SGP,3,5,365,15706,16071,0
Consumer Goods|Eyewear|Sunglasses,640000.0,IND,1,2,0,16469,16469,0
Consulting|Customer Support Tools|Tech Field Support,350000.0,USA,2,2,365,13970,14335,0
Accounting|Enterprises|Finance|Network Security|SaaS|Small and Medium Businesses|Software,10000000.0,CAN,4,14,1064,15400,16464,0
Advertising,241903.0,CHL,5,5,427,15522,15949,0
Biotechnology,5900000.0,USA,3,6,420,16121,16541,0
Android|Certification Test|Colleges|Education|iPad|iPhone|Testing,8200000.0,USA,2,4,580,14944,15524,0
Health Care,35513893.0,USA,4,3,1254,14502,15756,0
Software,6524375.0,GBR,1,1,0,15255,15255,0
Charter Schools|E-Commerce|Gift Card|Mobile|Mobile Payments|Non Profit|Nonprofits,1200378.0,USA,2,1,609,15979,16588,0
Enterprise Software,40000000.0,USA,1,3,0,10989,10989,0
Health and Insurance|SaaS|Services|Software,7157090.0,USA,3,3,612,15614,16226,1
Manufacturing,15688169.737727,FIN,2,4,1243,13742,14985,0
Health Care|Medical|SaaS|Services|Software,9590000.0,USA,5,17,825,15882,16707,0
Design|Telecommunications|Wireless,822997.0,IRL,1,1,0,16650,16650,0
Information Technology|Interface Design|SaaS|Software,29264085.0,CAN,1,1,0,16638,16638,0
Marketing Automation|Software,1700000.0,POL,2,2,575,16133,16708,0
Apps|Discounts|Mobile,525750.0,USA,6,1,358,16142,16500,0
Entrepreneur|Innovation Management|Mobile Commerce,150000.0,USA,1,1,0,15861,15861,0
Education,22818.0,GBR,1,1,0,15887,15887,0
Career Planning|Education|Technology,20000.0,USA,1,1,0,16436,16436,0
Creative|Crowdsourcing|Gamification|Innovation Management|Social Innovation,400000.0,USA,1,1,0,16003,16003,0
Biotechnology,8380971.0,USA,7,9,964,15709,16673,0
Advertising|Brand Marketing|E-Commerce|Sporting Goods,75000000.0,USA,1,1,0,16339,16339,0
Financial Services|FinTech|Small and Medium Businesses,2500000.0,USA,1,4,0,16477,16477,0
Apps,2000000.0,USA,1,8,0,16505,16505,0
Internet|Restaurants|Startups|Web CMS,1200000.0,USA,1,4,0,16727,16727,0
Apps,1500000.0,USA,1,6,0,16611,16611,0
Internet Infrastructure|Mobile|Mobile Infrastructure|Telecommunications|Wireless,63730248.0,USA,4,9,799,15936,16735,0
Health Care,149465921.0,USA,8,17,2354,13885,16239,0
Finance|FinTech|News|Online Education,1500000.0,USA,1,1,0,15120,15120,0
Beauty|Local Services|Online Reservations|Search,240000.0,CHL,2,1,250,16306,16556,0
Blogging Platforms|Colleges|Education|Networking|Recruiting|Sports,1200000.0,USA,1,1,0,13818,13818,1
Software,1300000.0,GBR,1,3,0,16006,16006,0
Health Care|Medical Devices|Medical Professionals,1825000.0,USA,1,1,0,16413,16413,0
Biotechnology,28272646.0,USA,4,2,1071,15035,16106,0
Mobile,12000000.0,USA,2,3,426,13300,13726,0
Advertising|Data Privacy|Internet Service Providers,7500000.0,CAN,2,5,663,14553,15216,1
Hardware + Software|Wearables,36824722.0,USA,4,1,1458,14950,16408,1
Nanotechnology,20250000.0,USA,3,5,1582,12022,13604,1
Mobile,26500000.0,USA,4,5,1069,11610,12679,1
Communications Infrastructure|Wireless,12000000.0,USA,1,3,0,11661,11661,1
Advice|Consulting|Financial Services|Health and Insurance|Health Care|Hospitals,4000000.0,USA,2,1,576,15768,16344,0
All Students|Hospitality|Travel,278088.0,ESP,1,6,0,16197,16197,0
Customer Service|E-Commerce|Specialty Foods,1250000.0,IDN,2,3,385,16244,16629,0
Organic Food,499367.0,GBR,1,1,0,16161,16161,0
E-Commerce|Fashion,5000000.0,IDN,2,3,321,15708,16029,0
Banking|FinTech,291841.0,ESP,2,3,308,16384,16692,0
Content|Education|Social Network Media,4000000.0,RUS,1,1,0,16043,16043,0
Development Platforms|E-Commerce|Education|Marketplaces|Social Media,2000000.0,USA,2,6,403,16233,16636,0
B2B|Creative|Enterprises|Enterprise Software|Media|Mobile|Startups|Technology,75000.0,USA,1,2,0,16024,16024,0
E-Commerce,3911643.0,USA,5,1,985,15239,16224,0
Health Care,2100000.0,USA,2,1,124,14826,14950,0
Curated Web,875000.0,USA,3,10,662,15131,15793,0
Broadcasting|iPhone|News|Services|Video,1470551.0,GBR,2,1,1472,13071,14543,0
Health Care,65500000.0,USA,2,2,494,15078,15572,0
Education,15906680.0,CHN,1,2,0,15614,15614,0
Public Transportation,27804097.0,CHN,3,3,1492,13514,15006,0
Internet|Trading,700000.0,USA,1,1,0,16161,16161,0
Clean Technology,21500000.0,CHN,1,1,0,14666,14666,0
Curated Web,3450000.0,USA,1,2,0,13732,13732,1
Financial Services,3000000.0,IND,1,3,0,16700,16700,0
News,38930000.0,USA,2,2,798,14070,14868,1
Fashion|Online Shopping|Shopping,248000000.0,DEU,1,1,0,15559,15559,0
Education,10000000.0,CHN,3,2,1188,13787,14975,0
B2B|Network Security|Software,4225000.0,USA,4,9,320,15051,15371,1
E-Commerce|Fashion|Shoes,10000000.0,IND,1,1,0,15492,15492,0
Human Resources|Professional Services|Recruiting|Startups,77594.35023165849,ESP,1,6,0,16668,16668,0
Medical Devices,2000000.0,ISR,2,2,4039,12485,16524,0
Games,18500000.0,GBR,2,30,484,15530,16014,0
E-Commerce|Fashion,23204000.0,USA,5,7,2136,14593,16729,0
Enterprise Software|SaaS,618000.0,USA,2,11,38,16622,16660,0
E-Commerce,59063.0,KOR,2,1,78,14379,14457,1
Coworking|Social Media,47500000.0,USA,3,23,2153,13879,16032,0
Android|Big Data|Cloud Computing|Cloud Data Services|File Sharing|General Public Worldwide|iOS|Mobile Devices,55000.0,USA,2,2,107,16207,16314,0
Curated Web|Gambling,5000000.0,GBR,1,1,0,13879,13879,0
Health and Wellness|Technology,5000000.0,USA,1,2,0,16176,16176,0
Consumer Goods|Recycling|Storage,1500000.0,USA,2,4,264,16101,16365,0
Information Technology,2512245.0,USA,2,3,56,16335,16391,0
Clean Technology,925000000.0,USA,6,10,1828,13818,15646,1
Health Care|Medical Devices|Mobility,600000.0,USA,3,5,645,15838,16483,0
Cloud Security|Enterprise Software|Google Apps|SaaS,46850000.0,USA,5,27,1050,15470,16520,0
Social Network Media,7700000.0,USA,2,11,404,16170,16574,0
Apps|Consumers|Doctors|Health and Wellness|Health Care|Internet|Marketplaces|Mobile|SaaS|Search,13125000.0,USA,3,21,791,15461,16252,0
E-Commerce,37000000.0,USA,4,16,1477,14245,15722,0
Health and Wellness|mHealth,443000.0,USA,3,2,306,15492,15798,0
All Students|Curated Web|Education|Teachers,2500000.0,USA,3,4,1066,14872,15938,0
Curated Web,5358914.0,USA,3,7,1333,14330,15663,0
Education|K-12 Education,29910691.0,DEU,5,5,1464,14294,15758,0
Finance|Investment Management,105000000.0,USA,5,23,1569,14914,16483,0
Enterprise Software|Information Technology|SaaS,15000000.0,USA,3,9,1391,14945,16336,0
E-Books|E-Commerce|Internet,4500000.0,USA,1,1,0,15362,15362,0
Consulting|Gambling|Sports,14168.0,MDA,1,1,0,14457,14457,0
Games,2000000.0,ESP,1,1,0,14231,14231,0
Curated Web|Networking|Social Network Media|Training|Women,200000.0,USA,2,1,261,15584,15845,0
Mobile|Photo Sharing,4000000.0,KOR,3,8,832,15279,16111,0
Analytics|Business Intelligence|Data Visualization|Social Media|Social Network Media|Software,1700000.0,ESP,1,1,0,14669,14669,0
3D|3D Printing|CAD|SaaS|Software|Web Development,661260.0,ESP,6,7,516,15675,16191,0
Consumer Electronics,8000000.0,USA,3,3,428,16344,16772,0
Web Hosting,10000000.0,USA,1,4,0,12891,12891,1
Distribution|Retail|Software,6090000.0,USA,3,2,459,16157,16616,0
Coupons|E-Commerce|Group Buying|Hospitality|Nightclubs,100000.0,USA,1,1,0,15114,15114,0
Social Media,1200000.0,USA,1,2,0,13787,13787,0
Consulting|Security,14000000.0,USA,1,1,0,16273,16273,0
Curated Web,1050000.0,CAN,2,3,95,16051,16146,0
Recruiting,13500000.0,USA,2,2,3465,10134,13599,0
Software,7000000.0,CAN,1,2,0,13843,13843,0
Marketplaces,75000.0,USA,2,2,30,15064,15094,0
Software,1060000.0,IRL,1,1,0,14547,14547,0
Development Platforms|Mobile|Mobile Games,800000.0,USA,2,9,435,15979,16414,0
B2B|Health and Wellness|Health Care|Mobile Emergency&Health|Software,1159500.0,USA,5,3,1046,14913,15959,0
Consumers|Health and Wellness|Health Care|Specialty Foods,17000000.0,USA,2,3,443,16280,16723,0
Mobile|Music,87000000.0,USA,2,3,319,14721,15040,0
Big Data|Real Estate|SaaS|Travel,1500000.0,USA,1,5,0,16520,16520,0
Fashion,98600000.0,TUR,7,21,1707,14637,16344,0
Analytics|Big Data|Cloud Computing|Health and Wellness|Internet of Things|Mobile|Personal Health,7100000.0,ISR,3,4,498,15833,16331,0
Analytics|Software,9000000.0,USA,1,1,0,16119,16119,0
Enterprise Software,13100000.0,USA,3,12,1120,12788,13908,0
Consumer Electronics|Mobile|Wearables|Wireless,1200000.0,USA,1,1,0,16648,16648,0
Design|E-Commerce|Marketplaces,2250000.0,USA,1,20,0,16375,16375,0
Biotechnology|Health Care,96029290.0,USA,8,5,5163,11413,16576,1
Public Transportation,323351.0,GBR,1,1,0,15630,15630,0
Consumer Goods|Non Profit|Organic,3000000.0,USA,2,3,790,15706,16496,0
Hospitality,39000000.0,USA,1,1,0,16140,16140,0
Clean Technology,15350000.0,IND,2,1,476,15160,15636,0
Curated Web|Match-Making,11750000.0,IND,1,3,0,13914,13914,0
E-Commerce,22000000.0,IDN,1,1,0,16750,16750,0
Aerospace|Engineering Firms|Mining Technologies|Pharmaceuticals|Waste Management,4438488.0,GBR,1,1,0,16252,16252,0
Analytics,6570000.0,FRA,1,2,0,13270,13270,0
Advertising|Business Intelligence,7000000.0,USA,3,8,852,15584,16436,0
Health Care,44271141.0,USA,7,5,1914,14712,16626,0
Fashion|Fitness|Health and Wellness|Women,3300000.0,USA,4,2,655,15535,16190,0
Biotechnology,1694742.0,PHL,1,2,0,16699,16699,0
Analytics|Biotechnology|Health Care,3572446.0,DEU,2,5,1817,14882,16699,0
Diagnostics|Health Care|Health Diagnostics,11988175.7201105,IRL,2,4,1000,13502,14502,1
Ad Targeting|Advertising|Web Tools,25071584.0,USA,2,2,2083,13363,15446,0
Collaborative Consumption|E-Commerce|Fashion|File Sharing,600000.0,USA,1,1,0,15868,15868,0
Mobile,15515000.0,USA,2,7,144,15737,15881,0
E-Commerce|Fashion|Retail|Women,48600000.0,IND,1,2,0,16044,16044,0
Digital Media|Education,42183.0,GBR,2,5,217,16283,16500,0
Software,240000.0,GBR,1,1,0,13692,13692,0
Software,2145715.0,FRA,1,4,0,16548,16548,0
Biotechnology|Health Care|Medical,250000000.0,CHN,2,3,851,14549,15400,0
Biotechnology,38027784.0,GBR,2,10,673,15684,16357,0
Auctions|E-Commerce|Entertainment|Experience Design,1430000.0,ESP,3,5,521,15776,16297,0
E-Commerce|Shopping,16700000.0,USA,4,3,2861,13117,15978,0
Online Shopping,95954.0,ESP,1,4,0,16066,16066,0
Application Platforms|Low Bid Auctions|Real Time,1000000.0,ISR,1,1,0,16699,16699,0
Analytics,24600000.0,USA,3,6,1106,15635,16741,0
Auctions|Nonprofits|SaaS|Software,16579175.0,USA,10,7,1979,14336,16315,0
Advertising|Advertising Exchanges|Advertising Platforms|Algorithms|Mobile|Mobile Advertising|PaaS|SaaS,500000.0,SGP,1,1,0,16040,16040,1
Advertising|Publishing|Social Media Marketing,26797834.0,USA,2,3,1292,15340,16632,0
E-Commerce|Financial Services|Insurance,8900000.0,BRA,1,1,0,16188,16188,0
Local Advertising|Local Services|Marketplaces,1640000.0,GBR,2,2,123,16344,16467,0
Realtors,400000.0,AUS,1,1,0,16612,16612,0
Entertainment|Music|Video,500000.0,USA,1,1,0,13818,13818,0
Software,40000.0,USA,1,1,0,15749,15749,0
Discounts|Retail|Shopping,552500.0,USA,3,3,153,15492,15645,0
Big Data|E-Commerce|Software|Travel,2440000.0,GBR,2,4,344,16344,16688,0
Big Data|Big Data Analytics|Consulting|Machine Learning|Software,6807327.0,GBR,2,2,336,16226,16562,0
Big Data Analytics|Enterprises,650000.0,USA,1,1,0,16162,16162,0
Manufacturing,1150000.0,USA,2,1,119,16612,16731,0
Designers|Service Providers|Web Development,41250.0,HKG,1,1,0,16648,16648,0
Email,6500000.0,USA,1,1,0,12045,12045,0
Entertainment|Gambling|Games|Mobile|Video Games|Video Streaming,95244796.0,USA,2,4,1314,14134,15448,1
Advertising|Video|Video Streaming,3425000.0,USA,2,14,118,15400,15518,1
Public Relations,450000.0,USA,1,1,0,13822,13822,1
Health Care|iOS|Medical,3300000.0,GBR,1,2,0,16188,16188,0
Android|Augmented Reality|Coupons|Data Visualization|iPhone|Mobile|QR Codes|RIM|Web Tools,700000.0,USA,1,1,0,14140,14140,0
Apps|Finance|FinTech|Mobile|Senior Citizens,122738.0,CZE,2,2,181,16010,16191,0
Chat|Fashion|Music|Social Media|Social Network Media|Television|Video|Video Streaming,4715359.0,USA,5,1,847,14998,15845,0
Software,250000.0,USA,2,1,318,15340,15658,0
Entertainment|Games,10600000.0,USA,2,6,775,13573,14348,1
Software,44300000.0,USA,3,13,549,14791,15340,0
Business Services|Media|Sports,10731587.6617404,GBR,1,1,0,16720,16720,0
Telecommunications|Web Hosting,42000000.0,USA,2,7,357,11869,12226,1
Hospitality,18783.0,GBR,1,1,0,15320,15320,0
E-Commerce|Groceries|Online Shopping,85799999.0,IND,3,6,484,16175,16659,0
E-Commerce|Online Shopping|Web Development,125204369.0,USA,5,9,1381,15187,16568,0
Curated Web,4500000.0,USA,1,3,0,14448,14448,0
Biotechnology,3027477.0,GBR,2,2,351,13835,14186,0
Advertising|Brand Marketing|Customer Service|Entrepreneur|Game Mechanics|Gamification,13065000.0,USA,7,4,915,14518,15433,0
Security,26400000.0,USA,3,7,1814,11956,13770,1
Healthcare Services|Medical Devices|Mobile Health,12350000.0,USA,3,3,276,16392,16668,0
Email|Email Marketing|Services,6000000.0,USA,1,9,0,11710,11710,1
Hardware + Software|Interface Design|Technology,20750000.0,USA,3,7,1352,13213,14565,1
Internet,1500000.0,USA,1,4,0,16526,16526,0
Travel,25000000.0,RUS,2,2,278,15340,15618,0
Application Performance Monitoring|Cloud Infrastructure|Data Centers|Developer Tools|Enterprise Software|Infrastructure|IT Management|SaaS|Software,23000000.0,USA,2,5,338,16371,16709,0
FreetoPlay Gaming|Game|Games|MMO Games|Publishing,460488000.0,DEU,2,4,1051,14039,15090,0
Android|Apps|Software,2238677.0,CAN,4,3,411,15309,15720,0
Customer Service|Design|E-Commerce|Web Hosting,6500000.0,GBR,1,8,0,11590,11590,0
Beauty,1000000.0,IND,1,2,0,16747,16747,0
SaaS|Sports,5000000.0,USA,2,4,258,16182,16440,0
Curated Web|Networking,8000000.0,USA,2,2,588,13879,14467,1
Software,3113168.0,USA,2,4,976,15250,16226,0
Mobile,5000000.0,USA,1,1,0,16122,16122,0
Software|Transportation,10000.0,USA,1,1,0,14304,14304,0
Curated Web,80300000.0,USA,2,1,5478,10804,16282,0
Games|Music,25000.0,GHA,1,1,0,16175,16175,0
Advertising,10000000.0,CHN,1,1,0,14039,14039,0
Artificial Intelligence|Developer Tools|Embedded Hardware and Software|Robotics|Software|Video Games,384000.0,ESP,1,2,0,15650,15650,0
Networking|Web Hosting,169020.0,CZE,1,1,0,14635,14635,0
Biotechnology|Health Diagnostics|Nanotechnology,120000.0,USA,1,4,0,16267,16267,0
Bicycles|Distribution|Manufacturing,520833.0,DNK,1,1,0,15644,15644,0
Automotive,195072.0,GBR,2,2,409,15706,16115,0
Insurance|Security,83457.0,DEU,1,5,0,16627,16627,0
Finance,72407.0,GBR,1,1,0,15156,15156,0
Software,250000.0,GBR,1,2,0,15065,15065,0
E-Commerce|Mobile|Shopping|Transaction Processing,40000.0,CHL,1,1,0,15324,15324,0
Software,3750000.0,TUR,1,1,0,15944,15944,0
Finance|SaaS,129100000.0,USA,8,44,2963,13514,16477,0
Billing|Financial Services|SaaS|Subscription Businesses,120000.0,USA,1,1,0,16267,16267,0
Fashion,382106890.0,AUS,2,2,361,15541,15902,0
Billing|Collaboration|CRM|Project Management|SaaS|Software|Tracking,196079.0,ESP,1,1,0,16317,16317,0
Financial Services|Payments,15260000.0,USA,3,11,2283,13239,15522,0
E-Commerce|Events|Promotional|Ticketing,2877820.0,GBR,1,1,0,15689,15689,0
Accounting|Billing|Digital Media|Finance|Software,483410.0,IRL,2,2,730,15315,16045,0
Business Development|Enterprise Software,500000.0,USA,1,1,0,14897,14897,0
Consumer Lending|Credit|Credit Cards|Crowdsourcing|FinTech|Fraud Detection|IT and Cybersecurity|Personal Finance|Security,16500000.0,USA,3,16,1585,14757,16342,1
Mobile,7240000.0,USA,4,6,222,14924,15146,0
Billing|SaaS|Software,18584.0,NLD,1,1,0,15492,15492,0
Credit|E-Commerce|Payments,100000000.0,USA,3,5,640,13208,13848,1
E-Commerce|Parenting|Teenagers|Young Adults,3400000.0,USA,1,1,0,14937,14937,0
Billing|Cloud Computing|Enterprise Software|SaaS,3255000.0,SWE,3,1,1448,14862,16310,0
Customer Support Tools|Marketplaces|Online Shopping,250000.0,USA,1,1,0,16191,16191,0
E-Commerce,3100000.0,USA,2,2,166,15673,15839,0
Curated Web,9000000.0,USA,2,3,442,13724,14166,0
Business Services|Software,54000000.0,USA,3,4,3102,13438,16540,0
Mobile,60400000.0,SWE,2,4,475,16162,16637,0
Child Care|Kids|Parenting,500000.0,RUS,2,2,603,15748,16351,0
Analytics,10304545.0,USA,4,10,831,15085,15916,1
Apps|Games|Software,1800000.0,KOR,1,1,0,16497,16497,0
Analytics|Health Care|Reputation|Social Media Management,21700000.0,USA,2,4,614,16092,16706,0
Technology,400000.0,USA,1,1,0,16700,16700,0
Genetic Testing,20000.0,USA,1,1,0,16629,16629,0
Biotechnology|Health Care,137847684.0,USA,6,10,2124,13844,15968,1
College Recruiting|Recruiting,43889.0,USA,1,2,0,16405,16405,0
Cloud Computing|Finance|FinTech|Insurance|SaaS|Web Development,500000.0,USA,1,1,0,15340,15340,0
E-Commerce,1800000.0,USA,1,4,0,16218,16218,0
Collaboration|Document Management|Project Management|Software,1250000.0,USA,2,4,623,13987,14610,0
Manufacturing|Semiconductors|Telecommunications,38805883.0,USA,6,18,3569,12824,16393,1
App Stores|Internet|Marketplaces|Mobile|Open Source|Software,1000000.0,USA,1,13,0,15978,15978,0
Clean Technology,33500000.0,USA,5,5,893,13969,14862,0
Analytics|Biotechnology,925000.0,USA,2,1,512,15655,16167,0
Biotechnology,135585460.0,USA,6,9,1155,15098,16253,1
Biotechnology,2033700.0,ESP,1,1,0,13641,13641,0
Biotechnology,896000.0,IRL,1,1,0,14767,14767,0
Biotechnology,2700000.0,FRA,1,4,0,16036,16036,0
Biotechnology,12150000.0,CAN,1,4,0,12923,12923,0
Health and Wellness|Machine Learning,650000.0,USA,1,8,0,15918,15918,0
Biotechnology|Health Diagnostics,33213808.0,USA,11,4,2218,13546,15764,0
3D|3D Printing,1550000.0,USA,3,6,302,16379,16681,0
Biotechnology|Health Diagnostics,321184551.0,CHE,8,25,1785,14532,16317,1
Cyber|Cyber Security|Fraud Detection,11600000.0,USA,3,5,838,15400,16238,0
Biotechnology|Health Care,17102999.0,USA,5,1,1699,13322,15021,1
Biotechnology,2485000.0,USA,3,2,868,15201,16069,0
Biotechnology,1900000.0,GBR,1,2,0,14626,14626,0
Biotechnology,8347600.0,USA,2,2,463,15678,16141,0
Biotechnology,2850000.0,ZAF,1,1,0,12962,12962,0
Biotechnology,19024912.0,USA,5,3,2620,13353,15973,0
Biotechnology,15000000.0,USA,1,2,0,16167,16167,0
Biotechnology,1018959.43862128,GBR,1,1,0,13791,13791,1
Biotechnology,8399999.0,USA,3,1,67,16244,16311,1
Software,1010000.0,USA,5,2,455,15896,16351,0
Biotechnology|Health Care,48500002.0,USA,2,2,413,15107,15520,1
Biotechnology,15350009.0,USA,2,3,1400,14595,15995,0
Biotechnology,50000.0,USA,1,1,0,16155,16155,0
Biotechnology,4450000.0,USA,2,3,1145,14827,15972,0
Biotechnology,7410000.0,USA,1,3,0,13633,13633,0
3D Printing|Biotechnology|Health and Wellness,100000.0,PER,2,2,84,16384,16468,0
Biotechnology|Health Diagnostics,70000000.0,USA,2,2,225,15602,15827,1
Biotechnology,7415000.0,USA,6,10,2627,13452,16079,0
Biotechnology|Chemicals,13600000.0,USA,3,9,1143,15412,16555,0
Biotechnology|Health Diagnostics,6945919.0,GBR,3,9,688,14753,15441,0
Clean Technology,14660000.0,USA,2,4,779,13805,14584,0
Fitness|Health and Wellness|Medical,3800000.0,ISR,2,3,1280,15095,16375,0
Enterprise Software,13023790.0,USA,2,1,540,15918,16458,0
Biotechnology,946520.0,USA,5,1,4376,11485,15861,1
Biotechnology|Health Diagnostics,26000000.0,USA,1,5,0,14110,14110,1
Biotechnology|Health and Wellness|Mobile Health,928942.0,USA,2,2,141,14496,14637,0
Biotechnology,2389999.0,USA,4,2,1823,14463,16286,0
Biotechnology,49024004.0,USA,3,1,1213,15166,16379,1
Biotechnology,5000000.0,USA,1,2,0,14621,14621,0
Biotechnology,196664126.0,USA,9,39,3042,12285,15327,0
Biotechnology,63100000.0,ISR,4,3,3960,12542,16502,1
Emerging Markets|Energy|Outdoors|Technology,5000000.0,USA,1,6,0,16644,16644,0
Biotechnology,26800000.0,USA,1,4,0,16744,16744,0
Advanced Materials|Manufacturing|Renewable Energies,50000.0,USA,1,2,0,16478,16478,0
Biotechnology,61100000.0,USA,5,6,1890,14538,16428,0
Biotechnology|Health Diagnostics,1000000.0,ISR,1,1,0,15428,15428,0
Analytics|Biotechnology,9216231.0,USA,3,1,660,15020,15680,0
Agriculture|Green|Organic,1580000.0,SGP,1,1,0,15758,15758,0
Clean Technology|Consumer Electronics|Product Design|Remediation,250000.0,USA,1,1,0,16436,16436,0
Biotechnology,45000000.0,USA,1,1,0,15323,15323,0
Biotechnology,1188702.0,USA,3,1,618,16076,16694,0
Biotechnology|Mobile Health|Security,1292799.0,USA,3,1,198,15901,16099,0
Security,12000000.0,USA,1,2,0,11600,11600,0
Security,9474450.0,GBR,3,3,1038,13333,14371,0
Software,40000.0,CHL,1,1,0,15440,15440,0
Biotechnology,2020000.0,USA,1,3,0,13783,13783,0
Health Care,12149999.0,USA,2,5,741,15513,16254,0
Biotechnology,36618955.0,USA,3,7,1693,12727,14420,1
Biotechnology|Health Diagnostics,1000000.0,USA,1,3,0,14684,14684,1
Biotechnology|Health Diagnostics,2106889.0,PRT,2,5,1550,14963,16513,0
Health and Wellness|Medical,11073775.0,GBR,2,4,291,16223,16514,0
Biotechnology,4640000.0,DNK,1,1,0,14060,14060,0
Biotechnology|Medical|Therapeutics,116185.0,GBR,1,1,0,15754,15754,0
Biotechnology,81406790.0,USA,4,4,1065,15588,16653,0
Biotechnology,43867126.0,FRA,2,7,1049,15639,16688,0
Biotechnology|Health Diagnostics|Maps,107182814.0,USA,7,18,2430,13964,16394,0
Biotechnology,817620.0,ESP,1,1,0,15024,15024,0
Health Care|Health Diagnostics,140000.0,USA,2,4,381,15568,15949,0
Bio-Pharm|Medical|Pharmaceuticals,6800000.0,USA,1,1,0,12240,12240,0
Bio-Pharm|Health Care|Health Care Information Technology,1300000.0,ISR,1,1,0,16322,16322,1
Games,800000.0,USA,2,3,75,15356,15431,0
Biotechnology,599205.0,USA,1,2,0,15932,15932,0
Biotechnology|Health Diagnostics,20469183.0,AUS,2,1,1120,14490,15610,0
Biotechnology|Cosmetics,2390000.0,ESP,1,2,0,13070,13070,0
Health Care|Medical,1500000.0,USA,1,1,0,15645,15645,0
Biotechnology,63320500.0,USA,3,1,2953,12699,15652,0
Hardware + Software,15400000.0,CAN,3,18,418,15918,16336,0
Biotechnology,40000.0,CHL,1,1,0,15539,15539,0
Clean Technology,8000000.0,ISR,2,2,650,13488,14138,0
Biotechnology,2000000.0,CAN,2,2,802,14225,15027,0
Biotechnology,20369775.0,USA,3,1,439,16073,16512,1
Biotechnology,8000000.0,DEU,1,2,0,12916,12916,0
Hardware + Software,1000000.0,USA,1,1,0,15979,15979,0
Biotechnology,2600000.0,FRA,1,3,0,15614,15614,0
Clean Energy|Clean Technology,1000000.0,CHE,3,2,358,16102,16460,0
Biotechnology,5000000.0,USA,1,1,0,13074,13074,0
Biotechnology|Media|Technology,16010000.0,USA,2,8,2012,11719,13731,1
Health Care|Medical Devices,1650000.0,ISR,1,1,0,14042,14042,0
Biotechnology,4650000.0,USA,3,1,1967,14328,16295,0
All Students|EdTech|Education,40000.0,CHL,1,1,0,15329,15329,0
Biotechnology,40664199.0,USA,7,11,1761,13675,15436,0
Biotechnology,18000000.0,USA,1,2,0,14672,14672,1
Biotechnology|Health Diagnostics|Life Sciences,74639282.0,USA,6,5,2017,13878,15895,0
Biotechnology,3307299.0,USA,4,1,2097,13038,15135,1
Biotechnology,150000.0,USA,1,1,0,15180,15180,0
Biotechnology,10000000.0,USA,1,1,0,13656,13656,1
Biotechnology|Health Diagnostics|Medical,4494680.0,IRL,2,7,1413,13914,15327,0
Biotechnology,216000.0,SWE,1,1,0,13747,13747,0
Biotechnology,11771486.0,USA,2,6,2469,12635,15104,0
Bio-Pharm|Biotechnology|Life Sciences,3392314.0,FIN,1,2,0,16232,16232,0
Communities|Game|Internet,1500000.0,USA,1,3,0,14080,14080,0
Technology,27000000.0,USA,1,4,0,12346,12346,0
Biotechnology,5500000.0,USA,1,1,0,14228,14228,0
Biotechnology,8320000.0,USA,2,5,139,13523,13662,0
Biotechnology|Health and Wellness|Therapeutics,10099999.0,USA,2,4,2919,12286,15205,0
Biotechnology|Infrastructure|Life Sciences,3900000.0,USA,2,3,67,15471,15538,0
Biotechnology,1400000.0,CAN,1,4,0,14470,14470,0
Biotechnology,1870081.0,DNK,1,2,0,16576,16576,0
Biotechnology,3978000.0,USA,4,9,1358,13818,15176,1
Biotechnology,11187700.0,FRA,3,2,1935,12874,14809,1
Biotechnology,423000.0,AUS,1,1,0,14726,14726,1
Hardware + Software,3000000.0,USA,2,2,581,14280,14861,0
Biotechnology,608000.0,DEU,1,2,0,13643,13643,0
Biotechnology,5193705.0,USA,2,2,514,16126,16640,0
Information Technology|Services|Software,5000000.0,USA,1,1,0,16713,16713,0
3D|Cloud Computing|Medical Devices|SaaS|Software,2015106.0,GBR,2,1,1613,13879,15492,0
Biotechnology,24213329.0,USA,2,4,1953,12446,14399,1
Organic Food,106879.168331517,BGR,3,3,713,15966,16679,0
Hardware|Hardware + Software|Robotics,35000.0,IND,2,1,387,15838,16225,0
Biotechnology,10870000.0,USA,1,3,0,13916,13916,0
Diagnostics|Health Care|Health Diagnostics|Medical Devices,12000000.0,USA,1,1,0,16371,16371,0
Biotechnology|Medical|Pharmaceuticals,133314585.0,GBR,4,34,2227,12331,14558,1
Biotechnology,6700000.0,USA,1,4,0,13291,13291,0
Biotechnology,6513865.0,USA,1,3,0,15887,15887,0
Curated Web|Health and Wellness,1100000.0,USA,2,2,267,13614,13881,0
Biotechnology,3345160.0,BEL,1,1,0,16035,16035,0
Biotechnology,1933105.0,GBR,1,2,0,15617,15617,0
Biotechnology,9300000.0,USA,4,1,1024,15062,16086,0
Biotechnology|Health and Wellness,73000000.0,USA,4,18,1484,12772,14256,1
Enterprises|Enterprise Software|Finance|Finance Technology|Financial Services|FinTech|Hedge Funds|Intellectual Asset Management|Investment Management|Stock Exchanges,2000000.0,USA,1,3,0,16392,16392,0
Beauty|E-Commerce|Marketplaces,71900000.0,USA,3,29,1272,14909,16181,0
Bicycles|Manufacturing|Sporting Goods,74426.0,GBR,1,1,0,16071,16071,0
Enterprise Software,2400000.0,USA,1,4,0,16107,16107,0
Finance|Photography|Photo Sharing,1000000.0,USA,2,2,197,15477,15674,0
Outsourcing,4000000.0,USA,1,2,0,16260,16260,0
Hardware + Software|Health and Wellness|Home Automation|Internet of Things|Security,1272199.0,USA,3,4,418,16109,16527,0
Apps|Mobile|Transportation,320000.0,IND,2,2,298,16045,16343,0
Design,28000000.0,USA,1,2,0,15940,15940,1
Analytics|Business Intelligence|Enterprise Software|Web Development,129000000.0,USA,3,12,1050,15461,16511,0
Advertising|B2B|Health and Wellness|Sales and Marketing,100000.0,CAN,1,1,0,14883,14883,0
Hardware + Software|Television|Video,9019109.0,USA,8,1,1653,14900,16553,0
Artificial Intelligence|Finance|Venture Capital,1235000.0,USA,3,4,835,15705,16540,0
Hospitality|Restaurants|Services,5000000.0,CAN,1,2,0,12167,12167,0
Hardware + Software,1971253.0,USA,3,1,758,14501,15259,0
Curated Web|Video,3200000.0,USA,1,8,0,16532,16532,0
Analytics|Enterprise Software|Internet of Things|M2M|Smart Grid,25700000.0,CAN,3,6,509,16058,16567,0
Security,177683533.0,USA,9,27,3676,13046,16722,0
Bitcoin|Cloud Management|Finance|FinTech,11000000.0,CAN,3,6,176,16091,16267,0
Finance|FinTech,3920000.0,TUN,1,1,0,14741,14741,0
Automotive|Location Based Services|Mobile|Real Time|Software|Transportation|Travel,2000000.0,TUR,1,2,0,15880,15880,0
Security,5250000.0,USA,2,3,1348,13006,14354,1
E-Commerce|Technology,44700000.0,CHN,5,11,1218,13208,14426,1
Analytics,264993.0,KOR,1,1,0,15575,15575,0
Mobile,3000000.0,FIN,3,11,1165,15411,16576,0
Finance|Personal Finance,941049.0,DEU,2,4,279,16296,16575,0
Hardware + Software,4788800.0,FIN,1,1,0,13188,13188,1
Game,20265.0,BRA,1,1,0,16102,16102,0
Cloud Computing|Cloud Data Services|Enterprise Software|Storage,20825000.0,USA,5,16,1045,14975,16020,0
Education|Tutoring|Video,20000.0,USA,1,1,0,15874,15874,0
Bitcoin|Cloud Computing|Enterprise Hardware,394104.0,DEU,1,1,0,15826,15826,0
Bitcoin|E-Commerce,2300000.0,USA,1,3,0,16547,16547,1
Software,2000000.0,CHN,1,1,0,13300,13300,0
Software,7000000.0,ROM,1,2,0,13853,13853,0
E-Commerce,500000.0,IND,2,6,266,16503,16769,0
Real Time|Restaurants|Search,800000.0,USA,1,2,0,15286,15286,0
Consumer Electronics|Hardware + Software|Health and Wellness|Home Automation|Internet of Things|Quantified Self,1370000.0,USA,1,8,0,16478,16478,0
Bitcoin|Crowdfunding|E-Commerce,6936000.0,JPN,4,5,386,16273,16659,0
Mobile,21000000.0,USA,4,17,1097,12233,13330,1
Bitcoin|Data Centers|Hardware|Semiconductors,60000000.0,USA,3,13,405,16220,16625,0
Cloud Security|Mobile,35000000.0,USA,2,5,515,15772,16287,0
Bitcoin|Financial Services|Security,12000000.0,USA,2,12,80,16237,16317,0
Internet,31711985.0,CAN,5,6,319,16265,16584,0
Content Delivery|Video on Demand|Video Streaming|Web Hosting,2500000.0,USA,1,2,0,14092,14092,0
Gadget|Games|Tablets,25000.0,USA,3,3,1305,15095,16400,0
Software,2000000.0,CAN,1,2,0,16399,16399,0
Fashion,1500000.0,USA,1,2,0,15843,15843,0
Cloud Computing|Identity|Identity Management|SaaS|Software,8900000.0,USA,2,21,318,15812,16130,0
Hardware + Software,130000.0,USA,1,1,0,13788,13788,1
Apps|Big Data|Computer Vision|Media|Mobile|Startups,910000.0,CAN,2,4,278,15935,16213,0
Analytics|Brand Marketing|Computers|Curated Web|Publishing|Sales and Marketing|Social Media|Software,31400000.0,USA,6,30,1652,13879,15531,0
Semiconductors,31400000.0,USA,2,1,253,13514,13767,0
Bitcoin|E-Commerce|Payments,14500000.0,USA,2,15,263,16100,16363,0
Internet,30000.0,CHL,1,2,0,16504,16504,0
Bitcoin|Finance|Mobile Payments|Payments,1921592.0,USA,5,8,738,15949,16687,0
Curated Web,13300000.0,USA,2,10,428,12234,12662,0
Bitcoin|Finance,32510000.0,USA,3,18,491,15712,16203,0
Bitcoin|Payments,1700000.0,KEN,2,5,404,16071,16475,0
Advertising|Auctions,1931647.0,GBR,2,6,263,16054,16317,0
Analytics|Big Data|Fitness|Health and Wellness,40000.0,CHL,1,1,0,15826,15826,0
Startups,420000.0,USA,2,1,351,16314,16665,0
Security,48035000.0,USA,3,13,1532,15079,16611,0
Bitcoin|Finance|FinTech|Payments,41250.0,HKG,1,1,0,16252,16252,0
Bitcoin,10000000.0,GBR,1,1,0,16056,16056,0
3D|3D Technology|Android|Augmented Reality|Construction|Manufacturing|Virtual Worlds,665000.0,USA,1,1,0,16328,16328,0
Curated Web|Digital Media|Entertainment|Messaging,11000000.0,CAN,2,4,321,16051,16372,0
Apps|Peer-to-Peer|Software,35750000.0,USA,3,6,1111,13027,14138,0
Bitcoin|Finance Technology|Security|Software,4900000.0,USA,4,34,436,16091,16527,0
Big Data|Real Time|Software,4750000.0,USA,2,2,274,16147,16421,0
Bitcoin|Enterprise Software|Financial Services|Software,750000.0,USA,2,7,343,16415,16758,0
Mobile|Wireless,27550000.0,USA,4,6,2135,12418,14553,0
Messaging,22500000.0,USA,2,2,1008,13149,14157,0
Financial Services,4800000.0,SGP,2,3,336,16301,16637,0
Analytics|Big Data|Internet|SaaS,10000000.0,USA,3,7,394,15210,15604,0
Mobility|Software,6333407.0,USA,2,2,400,15321,15721,1
Analytics|Health and Wellness|Health Care,2275000.0,USA,2,1,294,16183,16477,0
Security,40800000.0,USA,6,16,3083,11139,14222,0
Manufacturing,1000000.0,CAN,1,1,0,15960,15960,0
Design|Designers|E-Commerce|Fashion,45000.0,ARG,2,1,0,15218,15218,1
Energy,25000.0,USA,1,1,0,14714,14714,0
Analytics,24300000.0,USA,3,9,1819,12192,14011,1
Messaging,8000000.0,USA,1,2,0,14292,14292,1
E-Commerce,50000000.0,CHN,2,2,241,14610,14851,0
Fitness|SaaS|Software|Startups,870000.0,USA,2,8,0,15092,15092,0
Software,365000.0,USA,2,1,181,14853,15034,0
Business Services|Enterprise Software|Finance|FinTech|Local Businesses|Small and Medium Businesses,5100000.0,USA,1,1,0,16353,16353,0
SaaS,25000.0,RUS,1,1,0,16040,16040,0
Business Services|Human Resources|Small and Medium Businesses,823712.033567913,JPN,1,2,0,16734,16734,0
Analytics|Finance|Startups,10548000.0,USA,4,15,1090,15218,16308,0
Advertising,28500000.0,USA,4,9,1862,14019,15881,1
Curated Web|Entrepreneur|Startups|Travel,40000.0,GBR,1,1,0,15754,15754,1
Business Services|Networking|Services,3200000.0,USA,1,1,0,11528,11528,0
Business Services|CRM|Visualization,100000.0,USA,1,1,0,15918,15918,0
Reputation|Reviews and Recommendations|Social Media,250000.0,USA,1,1,0,15586,15586,0
Human Resources|Services|Technology,2213123.0,JPN,1,1,0,14686,14686,0
E-Commerce,700000.0,USA,1,2,0,15818,15818,0
Events|Location Based Services|Mobile|Networking|Social Media,4000000.0,ISR,2,5,805,15491,16296,0
Software,1700000.0,USA,1,2,0,13675,13675,0
Wholesale,2500000.0,IDN,1,1,0,16622,16622,0
Information Technology|Internet|Software,5500000.0,USA,2,3,79,16085,16164,0
Mobile,3700000.0,FIN,2,4,305,14974,15279,0
Advertising|Analytics|Media|Publishing|Social Media Marketing,13001842.0,USA,4,4,670,15737,16407,0
Advertising|Big Data Analytics|Curated Web|Digital Signage|Market Research|Media|Sales and Marketing,180000.0,USA,3,1,921,15522,16443,0
Collaborative Consumption|Peer-to-Peer|Transportation|Travel,336521944.31335497,FRA,3,11,1340,15355,16695,0
Online Dating,200000.0,RUS,1,1,0,15765,15765,0
Open Source|Software|Software Compliance,75500000.0,USA,8,49,3950,12625,16575,0
Services,8000000.0,USA,1,2,0,12916,12916,0
Internet Service Providers|Security,9500000.0,USA,2,2,166,16001,16167,1
Curated Web,100000000.0,USA,1,1,0,15218,15218,0
Games,20265.0,CHN,1,1,0,16102,16102,0
Energy,10500000.0,CAN,1,2,0,16764,16764,0
Electronics|Semiconductor Manufacturing Equipment|Semiconductors,28200000.0,USA,3,6,1660,13724,15384,1
Advertising,59763076.0,USA,5,19,2359,12753,15112,1
Entertainment|Games|Video Games,19889.0,IND,1,1,0,15918,15918,0
Enterprise Software|Mobile|Mobility|Online Scheduling,6246474.0,GBR,2,2,3037,13237,16274,0
Hardware + Software|Mobile|RIM|Wireless,1000000000.0,CAN,1,1,0,16013,16013,1
Cloud Computing|Enterprise Software|Human Resources|SaaS|Software|Weddings,1250000.0,USA,1,2,0,15218,15218,0
Data Centers|Defense|Geospatial,22000000.0,CAN,1,2,0,16206,16206,0
Web Hosting,2500000.0,USA,1,2,0,13312,13312,0
Analytics,1270324.0,GBR,1,2,0,15656,15656,0
Software,3135000.0,USA,2,31,178,15461,15639,0
Professional Services|Public Transportation|Startups|Technology,22531561.0,DEU,6,19,1167,15218,16385,0
Enterprise Software|SaaS,220000000.0,USA,1,2,0,15933,15933,0
Analytics,2500000.0,USA,2,3,546,14610,15156,1
E-Commerce|Enterprise Software|Logistics|SaaS|Wine And Spirits,2623007.0,CAN,3,1,1084,14882,15966,0
Manufacturing,5465777.0,GBR,1,1,0,15553,15553,0
Advertising|Apps|Brand Marketing|Creative|Design|Film|Internet|Mobile|Public Relations|Sales and Marketing|SEO|Services|Social Media|Technology|Video,2700000.0,IDN,2,1,245,15959,16204,0
Software,12600000.0,USA,1,5,0,11479,11479,0
Software,13500150.0,USA,2,1,3045,12369,15414,0
Analytics,8406249.0,DNK,3,7,704,15886,16590,0
Games,5926462.0,USA,2,3,217,14351,14568,0
Cloud Computing|Storage|Web Hosting,10000000.0,USA,1,3,0,14496,14496,1
Infrastructure|Software,17000000.0,USA,2,8,961,12079,13040,1
Manufacturing,205510.0,GBR,1,1,0,16130,16130,0
E-Commerce|Fashion|Mass Customization|Online Shopping|Shopping,1100000.0,USA,1,7,0,16548,16548,0
Games,1611610.0,IRL,1,2,0,13835,13835,0
Application Platforms|Game|Mobile,128865.0,CHN,1,1,0,15819,15819,0
Life Sciences,100000.0,USA,1,1,0,13369,13369,0
Automotive|Hardware|Hardware + Software|Manufacturing|Product Design|Recycling|Startups,500000.0,GBR,2,4,440,15675,16115,0
Advertising,7500000.0,USA,2,5,0,12784,12784,0
Hardware + Software,10000000.0,USA,1,3,0,13584,13584,0
Software,1000000.0,CAN,1,3,0,14921,14921,1
Health Care,200000.0,USA,2,1,952,15455,16407,0
Computers|Developer Tools|Enterprise Software|Information Services|Information Technology|PaaS|SaaS|Software|Testing,7700000.0,USA,2,4,889,15314,16203,0
Enterprise Software,51275260.0,USA,7,17,4397,11688,16085,0
Big Data Analytics,118000.0,USA,1,1,0,16600,16600,0
Blogging Platforms|Publishing|Sports,40500000.0,USA,5,11,1392,13818,15210,0
Hardware + Software|Health and Wellness|mHealth,100000.0,GBR,1,1,0,15949,15949,0
Search,60200000.0,USA,9,25,2104,13757,15861,1
Mobile|Mobile Advertising|Photo Sharing|Social Media,9000000.0,USA,3,28,380,16182,16562,0
Healthcare Services|Health Diagnostics|Medical|Nanotechnology|Therapeutics,45801164.0,USA,4,9,1097,15345,16442,0
Financial Services,5000000.0,ISR,1,2,0,16628,16628,0
Coworking|Office Space|Real Estate|Shared Services,3000000.0,USA,1,2,0,16601,16601,0
Enterprises|Software,25000.0,USA,1,1,0,14064,14064,0
News,3800000.0,NLD,1,2,0,16369,16369,0
Apps,25000.0,USA,1,1,0,16750,16750,0
Education|Software|Video Conferencing,2100000.0,GBR,2,4,919,14975,15894,0
Enterprise Software|Loyalty Programs|Mobile|NFC|Payments|Social Media,28000000.0,USA,2,2,120,14427,14547,0
Content|Journalism|Location Based Services|Media|News|Photography|Product Development Services|Real Time|SaaS|Search|Video,1025000.0,USA,2,4,365,16130,16495,0
Software,20000000.0,JPN,1,3,0,16370,16370,0
Electronics,5800000.0,USA,1,2,0,16755,16755,0
Apps|Hotels|Internet|Mobile|Online Reservations|Travel,4400000.0,ESP,1,8,0,15400,15400,1
Music|Video Streaming,6000000.0,GBR,2,7,1302,13879,15181,0
Photography,553000.0,USA,2,1,357,16083,16440,0
Analytics|Big Data Analytics|Social Media|Social Television|Sports,900000.0,USA,1,9,0,16336,16336,0
Hardware|Lighting|Manufacturing,25000.0,USA,1,2,0,15728,15728,0
Apps,100000.0,USA,1,1,0,16375,16375,0
Mobile,45290624.0,CAN,6,10,1707,15012,16719,0
Advertising|Games|Television|Video|Video Streaming|Web Hosting,27300000.0,USA,7,10,2343,13208,15551,1
Advertising|Augmented Reality|Computer Vision|Education|Image Recognition|Mobile|Wearables,45000000.0,USA,2,2,1161,15342,16503,0
Mobile,12931223.0,USA,2,12,98,14623,14721,0
Consumer Goods|E-Commerce|Online Shopping,300000.0,THA,1,3,0,16534,16534,0
Advertising|App Marketing|Apps|Auctions|Location Based Services|Mobile|NFC|Tablets|Wireless,2341414.0,GBR,2,4,1795,13514,15309,0
Consumer Lending|Credit Cards|Financial Services|Mobile Payments,1249999.0,USA,1,3,0,16420,16420,0
Biotechnology,500000.0,USA,1,3,0,15013,15013,0
Art|E-Commerce|Flash Sales|Retail,5575000.0,USA,3,16,657,15905,16562,0
Games,1200000.0,USA,1,1,0,16550,16550,0
Apps,500000.0,CAN,1,4,0,16575,16575,0
Android|Education|iOS|Web Design|Web Development,8250000.0,USA,3,10,922,15470,16392,0
Health Care,9378646.0,USA,3,2,960,15789,16749,0
Curated Web,500000.0,USA,1,1,0,15512,15512,1
Location Based Services|Mobile,1000000.0,USA,1,8,0,14756,14756,1
Bitcoin|Cloud Infrastructure,3500000.0,USA,2,21,74,16375,16449,0
Hardware + Software|Wearables,360000.0,GBR,2,2,54,16667,16721,0
Fraud Detection|Identity|Risk Management|Software,2025000.0,USA,2,7,389,15857,16246,0
Design,3520000.0,USA,2,3,378,16267,16645,0
Bitcoin|Payments,21000000.0,CAN,1,12,0,16391,16391,0
Finance|Insurance|Tracking,118000.0,GBR,1,1,0,16517,16517,0
Big Data Analytics|Bitcoin|Information Technology|Services,669209.0,USA,1,1,0,16300,16300,0
Information Services,53098.7855342482,GBR,2,2,100,16535,16635,0
Analytics|Business Analytics|Energy Management,25000.0,USA,1,1,0,16129,16129,0
Curated Web,6536608.0,USA,3,6,1183,13514,14697,0
News,8340000.0,CHN,3,6,488,12600,13088,0
Advertising|Blogging Platforms|Brand Marketing|Social Media|Software|Startups,8200000.0,USA,2,4,551,15407,15958,0
Blogging Platforms|Curated Web|Journalism,125000.0,ISR,1,2,0,14031,14031,0
Blogging Platforms|Curated Web|Women,15500000.0,USA,3,6,669,13709,14378,1
Blogging Platforms|Software,20000.0,USA,1,1,0,15140,15140,0
Curated Web,11065763.070472099,SWE,5,16,1223,15499,16722,0
Broadcasting|Chat|Games,3000000.0,ISR,1,1,0,13514,13514,1
Curated Web|PaaS|SaaS|Social Media|Software,70000.0,ROM,1,1,0,15706,15706,0
CAD|Creative|Design|Games|Kids|Software|Toys,600000.0,USA,1,1,0,15949,15949,0
E-Commerce|Social Commerce|Social Media,1573650.0,ITA,1,1,0,15544,15544,0
Data Integration|Health Care Information Technology|Medical,50000.0,USA,1,2,0,16205,16205,0
Health and Wellness,20000.0,MEX,1,1,0,16485,16485,0
Mobile,4770000.0,USA,4,9,518,15210,15728,0
Application Platforms|Medical|Services,3000000.0,USA,1,6,0,12017,12017,0
Analytics|Chat|Content|Ediscovery|Messaging|Social Media,158865.0,GBR,2,4,153,15218,15371,0
Health and Insurance|Health and Wellness|Health Care|Health Care Information Technology,5000000.0,USA,2,2,288,14616,14904,0
Consumer Electronics|Consumer Goods|Elder Care|Social Media|Technology|Wearables,1000000.0,USA,1,2,0,16489,16489,0
Clean Technology,1110000000.0,USA,6,21,2583,13879,16462,0
E-Commerce,3878283.0,GBR,1,4,0,16643,16643,0
Biotechnology,85000000.0,CHN,1,1,0,16745,16745,0
Education,12200000.0,USA,3,6,1521,15095,16616,0
Blogging Platforms|Collaboration|Education|Social Media|Software|Training|Video|Web Tools,20000000.0,USA,3,5,429,15425,15854,0
E-Commerce|Flowers,7150000.0,USA,2,12,348,16002,16350,0
Startups,3935960.0,NLD,1,1,0,16680,16680,0
Enterprise Software,41000000.0,USA,3,7,1508,14123,15631,0
E-Commerce|Flash Sales,51050000.0,USA,4,18,942,14245,15187,1
Consumer Goods|E-Commerce|Flowers|Mobile,7600000.0,USA,2,24,490,16107,16597,0
Finance|Investment Management,4000000.0,USA,1,5,0,16723,16723,0
Software|Startups|User Experience Design,40000.0,USA,1,4,0,15425,15425,0
Content|Journalism|News,769035.0,GBR,2,4,9,15748,15757,0
Manufacturing,34392386.0,CHN,3,3,1371,14700,16071,0
Beauty|Mobile,975000.0,USA,2,1,173,16093,16266,0
Entertainment|Games,50000000.0,USA,1,1,0,13818,13818,0
Health and Wellness,7070000.0,USA,5,1,1322,14958,16280,0
Real Estate,197500000.0,USA,5,6,1350,15099,16449,0
Hardware + Software,3030502.0,GBR,1,3,0,15960,15960,0
Analytics|Application Platforms|Apps|Internet of Things|Mobile|Mobile Commerce|Retail|SaaS|Sensors,40000.0,CHL,1,1,0,16316,16316,0
Analytics|Databases|Internet|Technology,100000.0,IND,2,1,521,16161,16682,0
Application Platforms|Computers|Software,968755.0,FIN,6,2,480,16216,16696,0
Content Creators|Digital Media|Entertainment|Events|Television,65500000.0,CAN,3,9,609,15309,15918,0
Cooking|Delivery|E-Commerce|Hospitality,193000000.0,USA,4,28,840,15755,16595,0
Curated Web|Fashion|Lifestyle,63906.0,GBR,1,2,0,15591,15591,0
Coffee|E-Commerce,115700000.0,USA,3,30,1250,15340,16590,0
Cloud Management|Enterprise Software,26600000.0,USA,6,6,797,15644,16441,1
Information Technology,658543.0,USA,2,2,326,15005,15331,0
Direct Marketing|Marketing Automation|Sales and Marketing,160056.0,CHE,2,2,17,15505,15522,0
Software,125000.0,GBR,1,1,0,15567,15567,0
News,1310000.0,USA,1,4,0,14803,14803,0
Software,13500000.0,USA,5,6,1119,14825,15944,0
Android|Apps|iPad|iPhone|Publishing|Travel,98262.0,GBR,1,1,0,16219,16219,0
Mobile,23692500.0,USA,2,3,670,15897,16567,0
Clinical Trials|Diagnostics|Medical,28040440.0,GBR,1,1,0,16639,16639,0
Clean Technology,5170000.0,USA,1,1,0,13453,13453,0
Analytics,6000000.0,USA,1,1,0,12935,12935,0
Public Relations,10235710.0,CHN,2,2,1887,14031,15918,0
Software,1249990.0,USA,2,3,1047,13665,14712,0
Hospitality,180000.0,USA,2,1,1204,13356,14560,0
Biotechnology,3680000.0,USA,1,3,0,13529,13529,0
Web Hosting,55000000.0,BRA,1,1,0,15337,15337,0
Chat|Collaboration|Enterprise Software|SaaS|Software|Video Conferencing,175000000.0,USA,5,20,2152,14549,16701,0
Web Hosting,13400000.0,USA,1,2,0,12815,12815,1
E-Commerce,2000000.0,USA,1,1,0,12996,12996,0
Games,300000.0,USA,1,1,0,14837,14837,0
Enterprise Software,5850000.0,USA,2,6,903,15712,16615,0
Apps|Services|Small and Medium Businesses,400000.0,KOR,1,1,0,16512,16512,0
Consumers|E-Commerce|Retail,49000000.0,USA,2,10,462,11064,11526,1
Aerospace|Defense|Solar,200000000.0,USA,1,1,0,16693,16693,0
Big Data Analytics|Curated Web|Recruiting,25000.0,USA,1,1,0,16083,16083,0
Computers|Digital Media|Technology,20000.0,USA,1,1,0,15994,15994,0
Software,25732374.0,USA,4,7,1712,14798,16510,0
Consulting|Services|Software,19200000.0,USA,1,8,0,15179,15179,1
Curated Web,16680511.0,USA,3,6,3703,11607,15310,0
Agriculture|Hardware + Software,13345000.0,USA,3,7,555,15593,16148,0
Enterprises|Internet|iOS|Software,701204.0,GBR,3,3,630,15887,16517,0
Software,3000000.0,USA,1,1,0,16000,16000,0
Digital Entertainment|Mobile|Sports,20000.0,USA,1,1,0,16436,16436,0
Security,3000000.0,TAN,1,1,0,12877,12877,0
Batteries|Clean Technology,24306925.0,USA,5,1,3083,13598,16681,0
Energy|Renewable Energies|Utilities,27000000.0,USA,1,1,0,16478,16478,0
Apps|Lifestyle|Mobile|Price Comparison,4000000.0,USA,2,4,238,15995,16233,0
Analytics|Business Analytics|E-Commerce|Mobile Commerce|Predictive Analytics|Retail Technology|SaaS,2121750.0,USA,4,6,672,16069,16741,0
Public Relations,4000000.0,USA,1,3,0,13047,13047,0
Big Data Analytics|Predictive Analytics|Productivity Software,75000000.0,DEU,1,1,0,16420,16420,0
Web Hosting,221000000.0,USA,7,20,4591,10227,14818,1
Clean Technology,81000000.0,CAN,1,2,0,16377,16377,0
Games,600000.0,CAN,1,1,0,15902,15902,0
Information Technology,1965121.0,NLD,1,1,0,16575,16575,0
Web Hosting,6124490.0,GBR,1,2,0,14904,14904,0
Biotechnology,150500000.0,USA,6,21,2942,12698,15640,1
Employer Benefits Programs|Enterprise Software|Health and Wellness|Human Resources|Incentives|Lifestyle,2075000.0,USA,2,9,189,16455,16644,0
Security,27500000.0,USA,2,9,580,15510,16090,0
Enterprise Software|Mobile|Mobile Security,11500000.0,ITA,2,3,374,15993,16367,0
Curated Web,4750000.0,USA,4,8,274,16329,16603,0
Computers|Enterprise Software|Networking|Virtualization,27800000.0,CAN,2,3,631,14545,15176,0
Advertising|Software,51745818.0,USA,8,5,1780,14900,16680,0
Software|Startups|Web Development,4667517.0,USA,1,4,0,16314,16314,0
Big Data|Internet Marketing|Marketing Automation|Multi-level Marketing|Optimization|Real Time,8900000.0,USA,4,7,1765,14822,16587,0
Mobile Commerce|Social Media,31600000.0,CHN,2,3,253,16124,16377,0
Big Data|Big Data Analytics|Software,39000000.0,USA,3,13,922,15750,16672,0
Biotechnology,2500000.0,CAN,1,1,0,16448,16448,0
Licensing|Mobile|Payments|Technology,2784223.0,AUS,6,2,461,15980,16441,0
Android|Email|iPhone|Mobile|SMS|Soccer|Sports,2727683.0,USA,4,15,1432,15145,16577,0
Analytics|Search|Social Television|Video,20350000.0,USA,4,13,1393,13970,15363,1
Cyber Security,16000000.0,USA,2,9,567,12004,12571,0
E-Commerce,24600000.0,USA,4,4,4152,11961,16113,1
E-Commerce,1070000.0,IND,5,8,1296,15371,16667,0
Diabetes|Medical|Medical Devices,4500000.0,USA,1,3,0,16281,16281,0
Groceries|Leisure|Retail|Wholesale,15492311.0,GBR,3,3,1982,11339,13321,0
Advertising,50100000.0,USA,4,13,1389,13970,15359,1
Curated Web,37500000.0,USA,2,3,4544,11170,15714,1
Collaboration|Enterprises|Networking|Social Media|Social Network Media,12300000.0,FRA,2,3,882,13514,14396,1
Enterprise Software,5410000.0,FRA,1,1,0,13669,13669,0
Health Care|Healthcare Services|Medical Professionals|Mobile Health,82629.6045347127,GBR,1,1,0,16740,16740,0
Mobile|Mobile Emergency&Health|Networking|Unifed Communications,3800000.0,USA,1,1,0,16526,16526,0
Advertising|Search,11500000.0,USA,1,2,0,12815,12815,1
Software,3216500.0,ESP,1,3,0,16113,16113,0
Enterprise Software,4000000.0,USA,1,1,0,13921,13921,0
Enterprise Software|Predictive Analytics|SaaS,10000000.0,USA,2,3,306,15723,16029,0
Enterprise Software,23400000.0,USA,2,5,161,13052,13213,1
Manufacturing,36499999.0,USA,3,3,988,15243,16231,0
IT and Cybersecurity|Mobile Security|Security|Software,1700000.0,USA,1,1,0,15137,15137,0
Biotechnology|Health Diagnostics,3900000.0,FIN,1,1,0,16314,16314,0
Artificial Intelligence|Internet|Video Streaming,1000000.0,USA,2,3,426,14914,15340,0
Biotechnology|Health Care,115000000.0,USA,3,15,1311,15075,16386,1
Enterprise Software,53200000.0,CAN,3,6,1999,14757,16756,0
Mobile,6000000.0,USA,1,1,0,13604,13604,0
Curated Web,20300000.0,USA,3,9,1547,12479,14026,1
Architecture|Construction|Tablets,56900.0,GBR,1,1,0,15887,15887,0
CRM|Real Estate|Software,550000.0,USA,2,1,126,15463,15589,0
Automotive|Incubators|Startups|Travel,450000.0,USA,3,7,628,15247,15875,0
Internet,2579996.0,USA,1,3,0,16378,16378,0
Semiconductors,14000000.0,USA,2,3,940,13339,14279,0
Consumer Electronics|Hardware + Software|Travel,13500000.0,USA,3,17,592,16130,16722,0
E-Commerce|Payments,183000000.0,USA,3,5,2311,14067,16378,0
Mobile,37028546.0,USA,4,17,2488,12142,14630,1
Hardware + Software,13250000.0,USA,5,4,2149,13216,15365,0
Software,10000000.0,USA,1,1,0,15323,15323,1
Android|Apps|Mobile|Mobile Games,30040690.0,USA,5,15,1163,15111,16274,0
Curated Web,30800000.0,IND,3,8,1262,15363,16625,0
Software,1700000.0,USA,1,1,0,16667,16667,0
Software,6000000.0,USA,1,3,0,12878,12878,0
Mobile,39000000.0,CAN,4,11,1389,12877,14266,1
IT Management|Software|Web Development,13525000.0,USA,3,3,2754,13514,16268,1
Big Data|Data Security|Information Security|Information Technology,11399994.0,USA,3,8,511,16122,16633,0
Local Businesses,33500000.0,USA,2,10,2367,13542,15909,0
Clean Technology|Oil,2600477.0,CHE,2,6,660,15795,16455,0
Software,900727.0,SWE,1,2,0,14914,14914,0
Mobile|Web CMS|Web Design,1530000.0,USA,1,4,0,15818,15818,0
Health Care|Healthcare Services|Public Safety,50000.0,USA,1,2,0,16489,16489,0
Consumer Lending|Finance|FinTech|Small and Medium Businesses,24000000.0,USA,5,10,773,15922,16695,0
Information Services|Mobile|Telecommunications,409975.0,USA,1,1,0,16647,16647,0
Clean Technology,35765086.0,GBR,1,2,0,15425,15425,0
Clean Technology,100000000.0,USA,1,1,0,16702,16702,0
Consulting|Creative|Crowdsourcing|Sales and Marketing,2000000.0,GBR,1,3,0,15447,15447,1
Collaboration|E-Commerce|Marketplaces|Publishing|Textbooks,24050000.0,USA,6,9,3329,12923,16252,0
Consumer Goods|Curated Web|Messaging|Photography|Social Media,59000.0,USA,2,1,40,15177,15217,0
Internet|Mobile|Web Hosting|Wireless,3272210.0,GBR,1,1,0,14449,14449,0
Customer Service|Supply Chain Management|Technology,12600000.0,USA,1,4,0,16379,16379,0
Advertising|App Marketing|Messaging|Weddings,107764700.0,FIN,4,4,1716,13149,14865,0
Software,750000000.0,USA,1,1,0,16168,16168,1
Software,6000000.0,USA,1,1,0,13389,13389,0
Mobile|SaaS|Web Development,1500000.0,USA,1,2,0,15462,15462,0
Energy|Energy Efficiency|Energy Management|Utilities,62700000.0,DEU,1,3,0,16461,16461,0
Analytics|Archiving|Ediscovery|Flash Storage|Social Media,874687.0,USA,3,3,715,14396,15111,0
Mobile,240000.0,USA,4,5,951,15240,16191,0
Software|Video,16000000.0,USA,1,5,0,14894,14894,1
Brand Marketing|Creative|Curated Web|Design|Events|File Sharing|Promotional|Sales and Marketing|Social Media|Testing|Web Design,5000000.0,USA,1,1,0,14641,14641,0
Dental|Doctors|Health and Wellness|Health Care,2000000.0,BRA,2,6,505,15561,16066,0
Enterprise Software,525000.0,USA,4,2,372,15861,16233,0
Nonprofits,100000.0,USA,1,1,0,14092,14092,0
Outdoors|Sporting Goods|Sports,40000.0,CHL,1,1,0,15440,15440,0
Web Hosting,59390.0,JPN,1,1,0,15275,15275,0
Social Media,3050000.0,USA,2,1,614,15379,15993,0
Collaboration|Mobile|SaaS,5500000.0,USA,1,2,0,12733,12733,0
Health Care,1600000.0,USA,3,2,671,15974,16645,0
Finance|News|Social Media,450000.0,USA,2,2,487,15400,15887,0
Databases|Enterprise Software,500000.0,USA,4,8,2885,13422,16307,0
E-Commerce|Peer-to-Peer|Services,4460000.0,USA,6,16,821,15340,16161,0
Curated Web,32000000.0,GBR,3,6,503,10864,11367,0
Adventure Travel|Boating Industry|Collaborative Consumption|Peer-to-Peer|Social Travel|Travel & Tourism,1900000.0,USA,2,2,298,15777,16075,0
Finance|Software,1400000.0,USA,1,2,0,15237,15237,0
Software,13500000.0,USA,2,10,534,12796,13330,0
Enterprise Software,7330000.0,CHN,2,2,609,15187,15796,0
Event Management|Photography|Services|Weddings,381680.0,COL,1,1,0,16248,16248,0
E-Commerce|Weddings,50000.0,MEX,1,1,0,14641,14641,0
Analytics|Business Intelligence|Finance|News|Optimization|Small and Medium Businesses,3400000.0,USA,2,2,391,15812,16203,0
3D Technology|Big Data|Business Analytics|Developer APIs,14299999.0,USA,3,8,355,16387,16742,0
Fruit,20000000.0,USA,1,1,0,16659,16659,0
Health and Wellness|Wearables,27800000.0,USA,6,13,3269,12214,15483,1
Fitness|Health and Wellness|Medical,120000.0,USA,1,1,0,16665,16665,0
Mobile,11250000.0,USA,3,6,825,15218,16043,0
Music,279233.0,USA,3,3,522,15758,16280,0
Delivery,150000.0,IND,1,2,0,16742,16742,0
Software|Telecommunications,125000000.0,USA,3,10,4070,12335,16405,1
News,13840000.0,CHN,4,4,1492,12753,14245,0
Mobile|Mobile Payments|Payments,73000000.0,USA,5,18,1261,14153,15414,1
Colleges|Education|SaaS|Software,739000.0,USA,3,2,373,15857,16230,0
Business Intelligence|Optimization|Real Time,7646324.0,USA,2,1,1011,14929,15940,0
Restaurants,10000000.0,USA,2,2,1284,13703,14987,0
E-Commerce,2414.0,THA,1,1,0,15621,15621,0
Curated Web|Financial Services|Home Renovation|Insurance,750000.0,USA,1,1,0,15342,15342,0
Finance Technology|Small and Medium Businesses,2325000.0,USA,2,7,686,15777,16463,0
Software,16000.0,USA,1,1,0,15737,15737,0
Venture Capital,3900000.0,USA,1,8,0,15756,15756,0
Finance|FinTech,29786274.0,USA,3,6,1883,12662,14545,0
Consumer Goods|Fashion|Manufacturing,39999999.0,USA,2,10,194,16396,16590,0
Games,500000.0,USA,1,1,0,15855,15855,0
E-Commerce|Fashion,730000.0,USA,5,15,1027,15431,16458,0
Recreation|Sports,1486000.0,USA,1,8,0,16071,16071,0
Medical,2656672.85376256,USA,1,5,0,16764,16764,0
Customer Service|Customer Support Tools|Meeting Software|Software,11000000.0,USA,3,5,3119,13073,16192,0
Fashion,2200000.0,USA,1,7,0,15553,15553,0
Bitcoin,950000.0,USA,3,5,368,16100,16468,0
B2B|E-Commerce Platforms|Home Decor|Marketplaces,3500000.0,DEU,1,3,0,16764,16764,0
Art|Beauty|Collectibles|E-Commerce|Fashion|Marketplaces|Online Shopping|Shopping|Social Buying|Textbooks,1000000.0,USA,1,5,0,14725,14725,0
E-Commerce|Gift Card|Social Media,3481173.0,DEU,5,10,1072,15309,16381,0
Direct Marketing|E-Commerce|Marketing Automation|Mobile Commerce|Personalization|Professional Services|SaaS,1000000.0,USA,1,4,0,16161,16161,0
Finance|FinTech,112200000.0,USA,4,18,483,16121,16604,0
Finance,16249.0,ISR,1,1,0,16635,16635,0
Consumer Lending|Finance,7012586.0,EST,4,1,2015,14478,16493,0
Finance,23100000.0,USA,2,9,279,15034,15313,1
Curated Web|Finance|Peer-to-Peer|Social Commerce|Social Network Media,754466.0,USA,2,7,49,15473,15522,0
Biotechnology|Health Care|Medical,2000000.0,USA,1,1,0,16562,16562,0
Biotechnology,10351880.0,BEL,1,3,0,15733,15733,0
Health Care,64074933.0,SWE,5,15,3351,13189,16540,0
E-Commerce|Fashion|Lifestyle|Retail,2350000.0,USA,2,2,153,15431,15584,1
Advertising|Design|Local Advertising|Search|Search Marketing|Social Media,500000.0,USA,2,2,215,15522,15737,0
Enterprise Software|Events|Messaging|Mobile|Photo Sharing|Private Social Networking|SaaS,2980000.0,USA,4,3,843,15340,16183,0
Content|Location Based Services|Mobile|Navigation|Proximity Internet|Retail,1000000.0,USA,1,1,0,15706,15706,0
Software,27000000.0,FRA,3,10,1338,14503,15841,0
E-Commerce|Fashion|Retail|Shoes,127649865.0,USA,7,32,2130,14123,16253,0
Biotechnology,10000000.0,USA,1,1,0,14966,14966,0
Application Platforms|Artificial Intelligence|Developer Tools|Development Platforms|EdTech|Operating Systems,2520000.0,USA,3,9,367,16161,16528,0
Employment|Enterprises|Enterprise Software|Human Resources|Peer-to-Peer,2000000.0,USA,2,2,355,16406,16761,0
Advertising|E-Commerce|Loyalty Programs,3104702.0,FIN,4,3,756,15636,16392,0
Advertising,40000.0,BRA,1,1,0,15911,15911,0
Advertising|Social Media|Technology,300000.0,BRA,2,5,1095,13834,14929,0
Consumer Goods,5000000.0,DEU,2,6,161,16261,16422,0
All Students|Education|Marketplaces|Tutoring,18000.0,USA,1,1,0,16111,16111,0
Hospitality|Online Reservations|Services,2256114.0,BEL,1,1,0,16695,16695,0
E-Commerce|Event Management|Online Scheduling|SaaS|Sports,500000.0,USA,2,20,490,15583,16073,0
Collaborative Consumption|Hospitality|Restaurants|Travel,569000.0,USA,4,2,629,15826,16455,0
Education|Mobile|Textbooks,10000.0,USA,1,1,0,15684,15684,0
E-Books,76605.0,GBR,1,1,0,16283,16283,0
Event Management|Events|Software,40000.0,USA,1,1,0,15379,15379,0
E-Books|Publishing,10800000.0,USA,2,8,383,16191,16574,0
Hardware + Software,2133000.0,FRA,1,1,0,14396,14396,0
Enterprises|Group Buying|Internet Marketing|Local Advertising|Mobile|SaaS|Social Commerce|Software|Web Development,77000000.0,USA,3,13,1231,15266,16497,0
Curated Web,1500000.0,USA,3,7,1290,14110,15400,1
Analytics|Ediscovery|Internet|Mobile|Publishing|Textbooks|Writers,637500.0,USA,2,3,210,15426,15636,0
Hardware + Software|Online Reservations|SaaS|Ticketing|Travel|Travel & Tourism,2000000.0,AUS,1,4,0,16595,16595,0
Curated Web|Online Reservations,100000.0,USA,1,2,0,13726,13726,0
Enterprise Software|Online Reservations|Software|Web Tools,1350000.0,GBR,2,3,1015,15076,16091,0
Hotels|Online Travel|SaaS|Vacation Rentals,978000.0,USA,4,23,518,15567,16085,0
Leisure|SaaS|Travel|Vacation Rentals,6509999.0,USA,2,7,555,15930,16485,0
Internet|Online Dating|Social Media|Women,387700.0,ESP,1,1,0,14031,14031,0
E-Commerce,10000000.0,USA,1,1,0,16083,16083,0
News,2115950.0,KOR,4,3,1048,15470,16518,0
Accounting|Business Services|Finance Technology|Financial Services,5800000.0,USA,1,1,0,16497,16497,0
Analytics|E-Books|Publishing|Textbooks|Writers,500000.0,USA,1,1,0,14975,14975,1
E-Books|News|Social Media,6500000.0,GBR,3,3,1603,14610,16213,0
E-Commerce|Fitness|Health and Wellness|Health Care,100000.0,IND,1,1,0,16430,16430,0
Information Technology,377000.0,IND,1,2,0,16671,16671,0
Child Care|Elder Care|Human Resources|Staffing Firms,150000.0,IND,1,1,0,16744,16744,0
Public Transportation,6500000.0,IND,2,3,572,15548,16120,0
Entertainment|Entertainment Industry|Ticketing,43000000.0,IND,2,4,664,15575,16239,0
Social Bookmarking,75000.0,KEN,1,4,0,16282,16282,0
Health Care|Medical|Mobile Devices,5700000.0,USA,3,1,1121,15187,16308,0
Databases|Search,350000.0,USA,1,1,0,14351,14351,0
EdTech|Education|Entertainment|Software|Technology|Textbooks,10000000.0,USA,3,9,945,15692,16637,0
E-Commerce|Publishing,720000.0,USA,3,12,515,16040,16555,0
Curated Web,808227.0,ESP,4,4,760,15796,16556,0
Comics|Entertainment|Graphics,2184267.0,USA,2,2,481,13930,14411,0
Artists Globally|Curated Web|Families|Mass Customization,400000.0,USA,1,3,0,16327,16327,0
Consumer Electronics|Gadget|Hardware|Hardware + Software|Mobile,4000000.0,USA,2,16,576,15524,16100,0
Advertising Platforms|Apps|Internet,5500000.0,USA,1,5,0,16731,16731,0
Digital Media|Music|Music Services,50000.0,USA,1,1,0,16500,16500,0
Advertising|Gift Card|Incentives|Mobile,1000000.0,USA,1,1,0,15552,15552,0
Analytics|E-Commerce|Internet|Retail,8500000.0,USA,1,2,0,16267,16267,0
Non-Tech,267000.0,USA,3,3,1535,14885,16420,0
Cloud Computing|Enterprise Software|IaaS|SaaS,4900000.0,USA,2,4,2373,11688,14061,1
Apps,2214805.0,USA,2,1,193,16495,16688,0
Games|Mobile|Tablets,3600000.0,FIN,2,5,525,15671,16196,0
Web Hosting,3600000.0,CHN,1,1,0,10926,10926,0
Event Management|Events|Mobile,151000.0,USA,3,2,265,15435,15700,0
Real Estate|Sales and Marketing|Software|Technology,20100000.0,USA,1,2,0,16318,16318,0
Business Services|Tech Field Support,8032882.0,USA,3,6,554,16071,16625,0
Email Marketing|Mobile|Personalization|Software,13966279.0,USA,3,8,1076,15645,16721,0
Games|Video Games,10000000.0,USA,1,4,0,12971,12971,1
E-Commerce|Mobile Commerce|Retail Technology,5607625.0,AUS,3,8,576,15584,16160,0
Advertising|Marketing Automation,3000000.0,USA,2,17,768,15546,16314,1
Big Data|Business Intelligence|E-Commerce|Mobile|Reviews and Recommendations,10000.0,BRA,1,1,0,15614,15614,0
Advertising,5955071.0,NOR,2,4,728,15398,16126,0
Advertising,3222000.0,USA,2,24,280,16085,16365,0
Advertising|Crowdsourcing|Optimization|Semantic Search,31990000.0,USA,6,20,1345,15047,16392,0
Agriculture,215000.0,USA,2,3,366,16327,16693,0
Transportation,4112016.0,USA,3,3,35,16583,16618,0
Game,1475000.0,SGP,1,2,0,16225,16225,0
Games,5000000.0,NLD,1,2,0,15961,15961,0
K-12 Education|Mobile|Nonprofits|Payments|Social + Mobile + Local,30000.0,USA,3,3,699,15737,16436,0
Automotive|CRM|Crowdfunding|Finance|Incentives|Lead Generation|Real Estate,1000000.0,USA,2,4,546,16001,16547,0
Services,9000000.0,USA,1,6,0,12115,12115,0
Cloud Data Services|Television|Video Streaming,578970.0,FIN,1,2,0,16149,16149,1
Discounts|Entertainment|Games|Gps|iPhone|iPod Touch|Location Based Services|MMO Games|Mobile|Mobile Games|Online Reservations|Social Games,59500000.0,USA,4,7,1793,13999,15792,0
E-Commerce|Fashion|Lifestyle Products|Retail,28771405.0,SWE,1,4,0,16622,16622,0
Music,2000000.0,USA,2,4,220,16040,16260,0
Digital Signage|Information Services|Wireless,40000000.0,USA,1,9,0,11151,11151,0
Pets,25000000.0,CHN,1,1,0,16132,16132,0
Business Services|Credit Cards|E-Commerce|Online Shopping,16400000.0,USA,3,10,3928,11599,15527,1
E-Commerce,735000.0,USA,5,5,621,15492,16113,0
Analytics|Biotechnology,24499999.0,USA,2,3,1099,14883,15982,0
Biotechnology,5220000.0,DNK,1,4,0,12865,12865,0
Android|Mobile|Mobile Software Tools|Social Media,41972725.0,CHN,5,8,2361,13939,16300,0
Clean Technology,50000000.0,USA,3,1,108,14351,14459,0
Finance|Technology,171572758.0,GBR,5,12,2314,14162,16476,0
Credit|Finance|Financial Services,5400000.0,CAN,1,5,0,16407,16407,0
Consumers,2319850.70471909,GBR,2,1,774,15954,16728,0
Fashion,31348387.0,CHN,1,2,0,14488,14488,0
Curated Web|Journalism|Media|News,1300000.0,USA,1,1,0,15149,15149,0
Biotechnology|Health and Wellness|Medical,10286000.0,USA,3,2,547,14326,14873,1
Health and Wellness|Health Care|Hospitals|Medical,21000000.0,USA,1,1,0,16415,16415,0
Brokers|Software|Trading,3225000.0,USA,2,2,13,15134,15147,0
Batteries|Clean Technology|Technology,370600000.0,USA,9,25,3010,13458,16468,0
Agriculture|Biotechnology|Cosmetics|Organic Food|Water Purification,4200000.0,ISR,1,1,0,16062,16062,0
E-Commerce|Fashion|Jewelry|Marketplaces,6500000.0,GBR,2,8,843,15110,15953,1
Analytics|Big Data|Ediscovery|Real Time|Search|Social Media|Twitter Applications|Video Streaming|Web Development,35200000.0,USA,7,36,861,15614,16475,0
Design|E-Commerce|Fashion|Flash Sales|Gift Card|Jewelry|Marketplaces|Sales and Marketing,275759.0,GBR,1,4,0,14610,14610,0
Manufacturing,4800000.0,USA,2,3,571,15457,16028,0
Clean Technology,43000000.0,USA,2,2,228,15008,15236,0
Enterprises|Enterprise Software|SaaS,7850000.0,USA,3,11,777,15880,16657,0
Advertising|Email|Security,6957993.0,USA,3,5,753,15796,16549,0
Apps|Chat|Social Network Media,1200000.0,USA,2,3,416,16344,16760,0
Application Performance Monitoring|Cloud Computing|Enterprise Software,41100000.0,USA,4,8,870,15293,16163,0
Education,9700000.0,USA,2,9,343,15092,15435,1
Advertising,12000000.0,USA,4,3,1500,13514,15014,1
Collaboration|Software,5255000.0,USA,2,2,313,15840,16153,0
Search|Shopping|Venture Capital,15000.0,USA,1,1,0,13665,13665,0
Curated Web|Human Resources|Marketplaces|Recruiting,29805235.0,USA,5,8,2850,13149,15999,0
Crowdfunding|Enterprise Software|Open Source,1100000.0,USA,1,2,0,15903,15903,0
E-Commerce|Marketplaces,520000.0,USA,3,1,244,15742,15986,0
Biotechnology,5303380.0,GBR,1,1,0,16105,16105,0
Bridging Online and Offline|Location Based Services|Payments|Point of Sale|Retail Technology|SaaS|Shopping,75000.0,USA,1,1,0,16636,16636,0
Curated Web,650000.0,USA,1,2,0,15860,15860,0
Mobile,53750.0,USA,2,2,181,16071,16252,0
Cloud Computing|Mobile|Tracking,808370.0,BRA,7,7,708,15667,16375,0
Health Care,10000002.0,USA,2,1,1320,14736,16056,1
Fashion,1200000.0,USA,1,5,0,16100,16100,0
Enterprises|Software,1550000.0,USA,2,6,262,16102,16364,0
Clean Technology|Energy,11245754.0,GBR,2,3,484,15645,16129,0
Bridging Online and Offline|E-Commerce|Local|Software,5546950.0,DNK,3,6,1389,15340,16729,0
Cloud Computing|File Sharing|Flash Storage|SaaS|Storage|Web Hosting,558950000.0,USA,11,46,3225,13027,16252,1
Software,1411000.0,FRA,2,2,1066,14305,15371,0
Food Processing,3500000.0,IND,1,4,0,16562,16562,0
Email|Messaging|Social Media,1500000.0,USA,1,2,0,13522,13522,1
Logistics|Storage,7300000.0,USA,3,19,594,15826,16420,0
E-Commerce,725000.0,CHN,2,3,95,15857,15952,0
Apps|iPhone|Mobile|Real Time|Software,150000.0,FRA,1,1,0,15414,15414,1
Photography,250000.0,USA,1,1,0,15887,15887,0
Apps|Mobile|Mobile Commerce|Mobile Shopping|Shopping|Software|Wholesale,32600000.0,USA,3,37,510,15939,16449,0
Software|Television,26500000.0,ISR,3,11,833,14201,15034,1
Messaging,3000000.0,USA,1,1,0,15994,15994,1
Big Data Analytics|Personalization|Software|Startups|Travel,7000000.0,IRL,3,7,916,15218,16134,0
Analytics|Big Data|Content|Real Time|Search|Software|Television,10000000.0,USA,2,6,961,15185,16146,0
E-Commerce,94000.0,USA,2,1,684,15940,16624,0
Lifestyle Businesses|Logistics|Mobile|Self Storage,8100000.0,HKG,2,7,156,16441,16597,0
Internet|Storage|Transportation,87489.0,GBR,1,1,0,16210,16210,0
Services,3200000.0,IND,1,3,0,16630,16630,0
Android|Enterprise Software|iOS|iPad|iPhone|Mobile|Mobile Devices|Telecommunications,13514000.0,USA,4,2,940,14487,15427,1
Games,6000000.0,CHN,1,1,0,15156,15156,1
Curated Web,700000.0,CHN,1,2,0,16009,16009,0
Software,3700000.0,ZAF,1,1,0,16316,16316,0
Automotive|Clean Technology|Electric Vehicles|Sports,1700000.0,USA,2,1,516,14245,14761,0
Internet|Services|Software,81299969.0,USA,6,14,2121,13559,15680,1
Billing|Cloud Computing|Distribution|Enterprise Software|SaaS,5049575.0,JPN,2,4,528,14057,14585,0
Music|Music Services|SaaS|Video,518754.0,PER,2,2,174,15987,16161,0
Delivery|Hardware|Utilities,5586592.0,BRA,1,1,0,14598,14598,0
Software,10100000.0,USA,2,6,587,12899,13486,1
Software,131700000.0,USA,3,17,1413,15309,16722,0
Analytics|Brand Marketing|Sales and Marketing,25000.0,USA,1,1,0,16236,16236,0
Business Services|Internet|Promotional,25000.0,USA,1,2,0,15380,15380,0
Analytics,382500.0,USA,5,4,1204,15383,16587,0
Consumer Goods|Nutrition,3900000.0,USA,2,3,224,16239,16463,0
Security,14000000.0,USA,4,5,2093,13381,15474,0
Curated Web|Gambling|Sports,1203653.0,IRL,6,6,1673,14853,16526,0
Social Media,3500000.0,GBR,1,2,0,13922,13922,1
Biotechnology,77766000.0,DEU,1,2,0,15671,15671,0
Information Technology,330813.0,GBR,1,2,0,16316,16316,0
Business Development|Enterprise Software|Sales and Marketing,48701.0,CAN,1,1,0,15765,15765,0
Hardware + Software,1254000.0,USA,3,3,825,15435,16260,0
Health and Wellness,20000.0,USA,2,2,1520,15095,16615,0
Education|Games,10000000.0,GBR,2,15,743,15798,16541,0
Biotechnology,74672769.0,USA,6,12,2371,12979,15350,0
Health and Wellness,745000.0,USA,2,1,168,16503,16671,0
Enterprise Software|iPhone|Mobile|Software|Web CMS|Web Development|Windows Phone 7,200000.0,NPL,1,1,0,13879,13879,0
Advertising|Mobile|Startups|Video,2650000.0,GBR,3,12,842,14512,15354,0
Software,7300000.0,DEU,1,1,0,13450,13450,0
Cloud Data Services|Collaboration|Document Management|File Sharing|IT and Cybersecurity|SaaS|Security,9919940.0,DEU,5,1,5201,11445,16646,0
All Students|Education,9500000.0,USA,2,6,761,15596,16357,0
Education,469542.0,CAN,1,1,0,11688,11688,0
Medical Devices,1963489.0,GBR,1,2,0,16337,16337,0
Education,2000000.0,USA,2,7,457,15887,16344,0
Biotechnology,36113750.0,USA,10,3,2249,14432,16681,0
Health Care,60500000.0,ISR,3,12,3454,13007,16461,0
Business Services|Sales and Marketing|Training,20900000.0,USA,2,5,1743,11204,12947,0
E-Commerce|Personalization|Reviews and Recommendations|SaaS|Software,1065750.0,ESP,3,8,1726,14730,16456,0
Information Technology|SaaS|Training,6400000.0,USA,1,2,0,16772,16772,0
Biotechnology,18139599.0,USA,5,1,727,15548,16275,1
Software,3000000.0,USA,1,1,0,14559,14559,0
Accounting|Billing|Credit Cards|Payments|Software,69000000.0,USA,2,7,446,15154,15600,1
Education,40000.0,IND,1,1,0,16028,16028,0
Games|Graphics,2100000.0,COL,3,2,699,14641,15340,0
Automotive|Batteries|Clean Technology|Energy,66000000.0,USA,5,6,1464,14874,16338,0
Curated Web|Messaging,2000000.0,USA,1,9,0,15405,15405,1
Software,18050000.0,USA,3,11,270,16222,16492,0
Charter Schools|Education|K-12 Education|Marketplaces|Neuroscience|Parenting|Personal Health|Skill Assessment|Teachers,1350170.0,USA,6,4,386,16215,16601,0
Career Management|Employment|Facebook Applications|Mobile|Networking|Social Network Media,49000000.0,USA,3,26,580,14869,15449,1
Game,68627.0,LVA,2,2,203,16204,16407,0
Advertising,27500000.0,USA,2,11,617,14845,15462,0
Analytics|B2B|Brand Marketing|Customer Service|Customer Support Tools|Sales and Marketing|Social Media|Software,1000000.0,USA,1,2,0,16120,16120,0
Advertising,27000000.0,USA,3,6,953,13829,14782,1
Data Integration|Services|Social Media Advertising|Social Media Management|Social Media Marketing|Software,68000000.0,USA,1,1,0,15862,15862,0
Specialty Foods,15000000.0,USA,1,4,0,12829,12829,0
Brand Marketing|Browser Extensions|Public Relations|Web Browsers,1660000.0,USA,3,4,293,13979,14272,0
Advertising|News|Web Development,500000.0,USA,2,1,111,15260,15371,0
Enterprise Software|Sales and Marketing|Web CMS,3300000.0,USA,2,1,366,15340,15706,0
Advertising,175769.0,GBR,1,2,0,15923,15923,0
Advertising|E-Commerce|Gift Card|Promotional|Sales and Marketing,6600000.0,PHL,2,4,223,14357,14580,0
Mobile|SaaS,15000.0,USA,1,1,0,16289,16289,0
Brand Marketing|Creative|Design|Sales and Marketing|Software,3118000.0,USA,3,2,690,15765,16455,0
Fashion|Marketplaces|Mobile Commerce,2312671.0,GBR,3,1,770,15568,16338,0
Entertainment|Mobile Games,20395.0,EST,1,1,0,15737,15737,0
Apps|E-Commerce Platforms|Mobile|Mobile Commerce|Mobile Software Tools|Web Development,17000000.0,USA,2,7,353,15614,15967,0
Mass Customization|SaaS|Software,1715000.0,USA,4,3,1168,14791,15959,0
Messaging,1609875.0,IRL,1,1,0,13377,13377,0
Software,30000000.0,DEU,1,2,0,16336,16336,0
Advertising|Brand Marketing|Celebrity|Public Relations|Sales and Marketing|Social Media,25025.0,MEX,1,1,0,16010,16010,0
Advertising|Social Media Advertising|Social Media Marketing,2170000.0,DEU,2,2,390,15918,16308,0
Venture Capital,12000000.0,CAN,1,1,0,15920,15920,0
E-Commerce,17000000.0,BRA,2,2,381,14365,14746,0
Internet|SaaS|Security,1469800.0,USA,2,2,205,16113,16318,0
Advertising|Brand Marketing|Curated Web|Public Relations|Sales and Marketing|Social Media|Social Media Monitoring,3350000.0,CHN,2,1,1487,14361,15848,1
Advertising|Web Development,53087864.0,IRL,3,11,1407,15187,16594,0
Marketing Automation|Mobile|Software,120000.0,CAN,2,1,957,14245,15202,0
Analytics|Big Data,227793.0,GBR,2,2,110,16442,16552,0
Analytics|Social Media,64732745.0,GBR,6,7,3468,13269,16737,0
Advertising Platforms|Finance Technology|Software,410000.0,USA,3,5,281,16442,16723,0
Brand Marketing|Curated Web|Employment|Entrepreneur|Human Resources|Internet|Personalization|Reputation|Search|SEO|Social Media,6215000.0,USA,6,8,2256,13970,16226,0
Games,400000000.0,USA,1,4,0,13667,13667,0
Android|Apps|Games|iPhone,750000.0,USA,1,2,0,15357,15357,0
Communities|Education|Enterprise Software|Knowledge Management,1845836.0,USA,3,2,1127,14669,15796,0
Finance Technology,550000.0,USA,1,2,0,15979,15979,0
Health and Wellness,22000000.0,USA,1,1,0,16294,16294,0
Software,8080000.0,USA,2,15,654,13011,13665,0
Consumer Internet|Crowdsourcing|Fashion|Lingerie|Marketplaces|Personalization,1450000.0,USA,3,1,822,15765,16587,0
Services,640254.0,FRA,1,1,0,15793,15793,0
Enterprise Software,6800000.0,USA,4,6,2001,14610,16611,0
Business Services|Financial Services|Investment Management,2000000.0,TTO,1,1,0,16406,16406,0
Consumer Electronics|Embedded Hardware and Software|Enterprise Software|Telecommunications,1200000.0,KEN,1,6,0,16259,16259,0
Automotive|Clean Technology,6300000.0,USA,3,5,728,15616,16344,0
Security,31000000.0,USA,4,8,1087,13298,14385,1
Advertising,4400000.0,USA,2,15,31,14975,15006,1
Emerging Markets|Location Based Services|Mobile,40000.0,CHL,2,2,90,16132,16222,0
Travel,62000000.0,CHN,3,6,661,15765,16426,0
Advertising|Entertainment|Games|Internet|Mens Specific|Sales and Marketing|Video,21400000.0,USA,2,3,487,13208,13695,1
Sports,295000.0,GBR,1,1,0,14217,14217,0
Digital Media,2000000.0,JPN,2,5,224,16072,16296,0
Security,20000000.0,USA,2,2,892,13829,14721,1
E-Commerce|Manufacturing|Marketplaces|Mobile Commerce,2081497.0,USA,2,2,326,16163,16489,0
Health and Wellness|Health Care|Marketplaces|Medical|Therapeutics,5900000.0,USA,2,12,332,15565,15897,0
Games|Mobile Games|Social Games,17363449.0,USA,4,1,504,15292,15796,0
Apps|Technology,30000.0,USA,1,1,0,16310,16310,0
Health and Wellness,29800000.0,USA,4,3,1922,14050,15972,0
Health and Wellness,38810000.0,USA,3,8,2495,13966,16461,0
Collaborative Consumption|Hospitality|Mobile|Real Estate,27500000.0,CAN,4,20,834,15861,16695,0
Clean Technology,3403684.0,GBR,2,6,1211,14434,15645,0
Hardware + Software|Health Care|Internet of Things|Mobile,4600000.0,USA,2,8,317,15995,16312,0
Semiconductors,43000000.0,USA,2,10,760,11330,12090,0
Enterprise Software,61200000.0,TUR,2,1,0,14336,14336,1
Automotive|Hardware|Payments|RFID,10000.0,USA,1,2,0,16040,16040,0
Enterprise Software,1580000.0,GBR,1,2,0,14050,14050,0
Ticketing,3000000.0,RUS,1,1,0,15765,15765,0
Local|Mobile,7000000.0,USA,2,18,435,15957,16392,0
Apps|Developer APIs|Environmental Innovation|Mobile|Mobile Health,1800000.0,USA,1,3,0,16611,16611,0
Apps|Enterprises|Enterprise Software|Mobile|Printing,2750000.0,USA,2,9,1084,15041,16125,0
Software,5000000.0,USA,1,1,0,15533,15533,0
Clean Technology,200000000.0,BRA,1,3,0,13587,13587,1
Energy,20000.0,UGA,1,1,0,16495,16495,0
Big Data|Online Travel|Peer-to-Peer|Reviews and Recommendations|Travel & Tourism,120000.0,USA,1,2,0,16036,16036,0
Customer Service|Software,50000.0,USA,1,1,0,15945,15945,0
Advertising|App Marketing|Mobile|SMS,2000000.0,USA,1,1,0,15083,15083,0
Advertising|App Marketing|Mobile|Web Development,100000.0,CAN,1,1,0,15216,15216,0
Internet Marketing|Real Estate|Services,171420.0,ARE,1,3,0,15124,15124,0
Biotechnology,25414587.0,USA,4,2,1663,14806,16469,0
Digital Media|Mobile|Software,385000.0,EST,4,3,516,15584,16100,0
Analytics|Retail,44368583.0,USA,7,9,4336,12129,16465,0
E-Commerce|Finance|Real Estate,1000000.0,GBR,2,1,71,16552,16623,0
Crowdfunding|Investment Management|Real Estate|Stock Exchanges,931087.0,AUS,1,1,0,16283,16283,0
Product Design,2809272.0,FRA,1,1,0,16610,16610,0
Real Estate,23000000.0,USA,2,1,1141,13803,14944,0
Games|Internet|Technology,920000.0,KOR,1,1,0,16467,16467,0
Curated Web,1053485.0,USA,2,1,861,15679,16540,0
Apps|FinTech|Payments,100000.0,ARE,1,1,0,16617,16617,0
Clean Energy|Clean Technology|Consulting|IT Management|Software,11000000.0,USA,2,1,14,15236,15250,0
EdTech|Education,16000000.0,KEN,2,2,421,16091,16512,0
Biotechnology,37188388.0,USA,2,1,905,13558,14463,0
Building Products|Construction|Home Renovation|Software,900000.0,USA,3,3,496,15675,16171,0
Advertising Platforms|Financial Services|Services,5000000.0,USA,1,1,0,16618,16618,0
Apps|Audio|Consumer Electronics|Media|Networking|Software,82800000.0,CHE,6,32,2532,12062,14594,1
Analytics|Health Care Information Technology|Mobile|Mobile Health,30000.0,USA,2,1,243,16071,16314,0
Messaging|Mobile|Telecommunications,340000.0,USA,3,4,395,16161,16556,0
Manufacturing,344789135.0,USA,10,27,2142,13241,15383,1
Health Care,35301007.0,USA,5,8,1522,13536,15058,1
Software,23000000.0,USA,2,6,1014,12444,13458,1
Software,15000000.0,USA,3,9,778,12465,13243,1
Big Data Analytics|EdTech|Education|Enterprise Software|SaaS,2900000.0,GBR,2,9,380,16375,16755,0
Advertising|Internet Marketing|Software,19150000.0,USA,5,5,1980,12418,14398,0
Mobile|Wireless,47893037.0,USA,9,33,3747,11962,15709,0
Big Data|Crowdsourcing|Transportation,4000000.0,USA,2,5,132,16317,16449,0
Defense|Law Enforcement|Security|Software,14300000.0,ISR,3,3,1449,14328,15777,0
Software,318000.0,USA,2,5,217,15839,16056,0
Apps|Freelancers|Real Time,320621.0,GBR,3,4,142,16286,16428,0
Politics|Social Media|Social Network Media,9000000.0,USA,1,2,0,16288,16288,0
Hospitality,10865285.0,USA,3,1,1112,15350,16462,0
Recruiting|Social Media|Social Network Media,120000.0,GBR,1,1,0,16405,16405,0
Finance Technology|Residential Solar,4120000.0,USA,2,6,160,16491,16651,0
Cars|Mobile,370000.0,RUS,2,2,273,15645,15918,0
Wine And Spirits,2020000.0,USA,3,6,260,16405,16665,0
Big Data|Curated Web|Recruiting,20000000.0,USA,2,2,456,15510,15966,1
Software,17000000.0,USA,2,5,1426,14853,16279,0
Consumer Internet|Financial Services|Nonprofits|Social Commerce,2950000.0,USA,3,15,849,15747,16596,0
Enterprise Software|Health Care Information Technology|Mobile Health|SaaS,4500000.0,USA,2,8,177,16371,16548,0
Contact Centers|Customer Service|Customer Support Tools|Enterprise Software,7000000.0,USA,3,2,1099,14883,15982,0
Energy|Energy Management|Solar,6500000.0,USA,2,2,565,15856,16421,0
Analytics|B2B|Big Data|Finance Technology|FinTech|Startups|Venture Capital,200000.0,GBR,1,3,0,16083,16083,0
Hardware + Software,26500000.0,USA,3,6,1207,13149,14356,0
Enterprise Software,139764.0,NOR,1,1,0,15008,15008,0
Analytics|Big Data|Big Data Analytics,51470000.0,USA,5,12,1235,15402,16637,0
Analytics|Enterprise Software|Technology|Video,198007658.0,JPN,8,35,3268,12843,16111,1
Games|Video,4900000.0,JPN,1,4,0,14021,14021,0
Internet|Real Estate|SaaS,2200000.0,USA,2,2,507,13616,14123,0
Search|SEO,61900000.0,USA,4,14,1768,14099,15867,0
Curated Web,28000000.0,USA,3,6,1032,14975,16007,0
Energy|Energy Efficiency|Energy IT|Energy Management|Enterprise Software,5100000.0,USA,2,2,655,15263,15918,0
Clean Technology|Organic Food,25250000.0,USA,4,13,1424,15321,16745,0
Enterprise Software,8948000.0,USA,4,23,1034,15737,16771,0
Android|Chat|Finance|Gps|iPhone|Local|Location Based Services|Maps|Mobile|Social Media|Social Network Media,2094920.0,USA,4,2,705,13726,14431,1
Legal,3000000.0,USA,1,1,0,14700,14700,0
Advertising|Messaging|Television,30000000.0,USA,1,2,0,15174,15174,0
Automotive|Fleet Management,430875.0,USA,1,1,0,16379,16379,0
Curated Web|Home Owners|Internet,950000.0,USA,1,5,0,15279,15279,1
Creative|Curated Web|Design|E-Commerce|Franchises|Image Recognition|Internet|Marketplaces|Photography|Sales and Marketing|Search|Stock Exchanges|Web Development,850000.0,USA,2,2,392,13634,14026,0
Advertising|Advertising Platforms|Online Video Advertising|Software,40242738.0,USA,6,17,2876,13361,16237,1
Finance,5900000.0,USA,3,2,1565,14030,15595,0
Apps|Film Production|Video,1600000.0,USA,1,22,0,16222,16222,0
Clean Technology|Energy|Solar,845000000.0,USA,9,25,2458,13453,15911,1
Distribution|Insurance|Mobile|Mobility|Supply Chain Management|Wireless,283000000.0,USA,1,1,0,13703,13703,1
Education|Video,6000000.0,USA,1,1,0,14173,14173,0
Ad Targeting|Advertising|CRM|Email|Enterprise Software|Mobile|SaaS|Social Media,50000000.0,USA,4,20,1178,14846,16024,0
Advertising|Lead Generation|Semantic Web|Software|Video|Video Streaming,20500000.0,USA,1,1,0,15244,15244,0
Clean Technology,6000000.0,ISR,1,2,0,14245,14245,0
Advertising,3200000.0,USA,3,9,1008,15181,16189,1
Software,14000000.0,USA,1,1,0,13745,13745,1
Human Resources|Recruiting|Staffing Firms,1287500.0,USA,1,1,0,13837,13837,0
E-Commerce,8943200.0,DEU,2,2,410,15183,15593,0
Bicycles|Design|Fitness,1500000.0,USA,1,6,0,16582,16582,0
Web Hosting,28426018.0,USA,6,15,1212,13545,14757,0
Curated Web|E-Commerce|Payments|SaaS|Social Commerce,2100000.0,USA,2,11,201,16344,16545,0
Games,4340000.0,USA,3,3,912,14004,14916,1
E-Commerce Platforms|Local|Restaurants,66047.0,ITA,1,1,0,15911,15911,0
Bridging Online and Offline|E-Commerce|Internet,450000.0,USA,2,5,439,15813,16252,0
Analytics|Internet Marketing,2831931.0,USA,5,3,1202,15056,16258,0
Semiconductors,19000000.0,USA,1,3,0,12539,12539,1
Enterprise Software,182094.08194233698,SWE,1,3,0,15860,15860,0
Mobility|Technology|Transportation,30000.0,CAN,1,1,0,16495,16495,0
Apps|Online Dating|Private Social Networking,41799.0,GBR,1,1,0,16546,16546,0
Digital Media|E-Commerce|Education|Media,27550000.0,USA,3,24,1135,15460,16595,0
Design|Manufacturing|Semiconductors,30600000.0,CHN,3,8,2252,14245,16497,0
Nanotechnology,16674.0,USA,2,1,193,16423,16616,0
Billing|Customer Service|Mobile|Telecommunications,3697600.0,IRL,3,3,230,14730,14960,0
B2B|Industrial Automation|Manufacturing|Marketplaces,640000.0,USA,1,11,0,16085,16085,0
Curated Web,3900000.0,USA,3,5,976,13514,14490,0
Security,10000000.0,USA,1,9,0,13074,13074,0
Industrial|Industrial Automation|Solar,1000000.0,USA,1,1,0,16160,16160,0
Biometrics|Data Security|Enterprise Software|Internet of Things|Mobile Security|Privacy,500000.0,USA,4,3,329,15706,16035,0
Computers|Networking|Services|VoIP,25100000.0,USA,2,5,1289,11085,12374,1
Mobile,1600000.0,ARE,1,1,0,16217,16217,0
Information Technology|Services|Software,5400000.0,USA,1,4,0,11555,11555,0
Biotechnology,132500000.0,USA,2,3,659,15365,16024,0
Maps,17000.0,USA,1,1,0,16191,16191,0
Broadcasting,11050000.0,USA,2,2,1171,12556,13727,0
Curated Web|Internet|Price Comparison|Television,16130527.0,GBR,1,1,0,15614,15614,0
Hardware + Software,57000000.0,USA,3,15,1054,11967,13021,1
Mobile,25000.0,ARG,1,1,0,15592,15592,0
Broadcasting,30000000.0,USA,1,1,0,11180,11180,0
Internet|Internet Service Providers,8000000.0,USA,1,3,0,11750,11750,0
Web Hosting,5750095.0,USA,2,4,446,14461,14907,1
Software,44900000.0,USA,4,24,1161,12606,13767,1
Manufacturing,300000.0,CHN,1,2,0,16040,16040,0
Web Hosting,41551329.0,USA,3,10,1692,12734,14426,1
Software,44000000.0,USA,3,14,2611,11939,14550,1
Software|Telecommunications,5700000.0,USA,1,2,0,12626,12626,1
Games,7500000.0,USA,1,6,0,12087,12087,1
Public Relations,2154000.0,USA,3,1,285,14483,14768,0
Education|Games|Mobile Games,60000.0,AUS,2,2,234,15431,15665,0
Apps,1000000.0,IND,1,1,0,16640,16640,0
Computers|Software|Technology,10402868.417585,DEU,1,1,0,10903,10903,1
Security,75800000.0,USA,4,16,854,15147,16001,0
Crowdfunding|Impact Investing|Social Network Media|Startups,374000.0,CHL,3,1,336,15720,16056,0
Assisted Living|Design|E-Commerce|Furniture|Home & Garden|Internet,1478309.50380542,AUS,1,1,0,16637,16637,0
E-Commerce,60000.0,IND,3,4,246,15918,16164,0
Software,55000.0,USA,1,5,0,15034,15034,0
Software,5800000.0,USA,1,3,0,13151,13151,0
Logistics,10000000.0,USA,2,1,861,15705,16566,0
Gps|Location Based Services|Mobile,4205000.0,USA,5,5,1278,13970,15248,0
Transportation,166791.0,GBR,1,1,0,16128,16128,0
E-Commerce|Enterprise Software|Retail,8200000.0,USA,2,4,2019,14276,16295,0
Health Care|Navigation|Software,51000000.0,USA,1,1,0,16162,16162,1
Clean Technology,6660000.0,AUS,2,5,790,14054,14844,0
Banking|Bitcoin|Finance|Financial Services|Payments|Trading,450000.0,SGP,2,2,396,15765,16161,0
Bitcoin,175000.0,USA,2,2,348,15949,16297,0
Bitcoin|Finance|FinTech|Payments,5000000.0,CHN,1,5,0,16027,16027,0
Bitcoin,303204.0,LVA,1,1,0,16436,16436,0
Bitcoin|Consumer Lending|Finance,7300000.0,USA,2,13,202,16226,16428,0
Hardware + Software,7000000.0,ISR,1,2,0,13544,13544,1
Curated Web,22400000.0,IND,1,1,0,16038,16038,0
Software,132787385.0,USA,14,24,3617,12879,16496,0
Clean Technology,1623640.0,CHN,1,1,0,14822,14822,0
Digital Entertainment|Social Media|Video Editing,125000.0,USA,1,4,0,16223,16223,0
Manufacturing,120794.0,GBR,1,1,0,15175,15175,0
Audio|Messaging|Mobile|Mobile Commerce|Social Media|Social Network Media,40000000.0,SGP,5,12,2173,13402,15575,1
Social Media,1000000.0,RUS,1,2,0,15890,15890,0
Curated Web,909150.0,GBR,2,4,45,16014,16059,0
Biotechnology,2401000.0,DEU,2,4,1684,13357,15041,0
Hardware + Software,4935000.0,CAN,2,2,629,16051,16680,0
E-Commerce|Fashion,300000.0,USA,1,3,0,16338,16338,0
E-Commerce|Internet,16360000.0,USA,7,17,1690,14920,16610,0
E-Commerce|Local Businesses|Logistics|Software|Specialty Foods,281169.0,NZL,5,4,457,15363,15820,0
Beauty|E-Commerce|Health and Wellness|Marketplaces,1438301.0,ESP,4,11,668,15949,16617,0
Cloud Data Services|Development Platforms|Enterprise Software|Internet of Things|Mobile,5404028.0,USA,5,9,713,15490,16203,0
Health and Wellness|mHealth|SaaS|Social Business,640215.0,GBR,2,1,607,16010,16617,0
Mobile Commerce,225000.0,USA,2,1,460,15584,16044,0
Analytics|Celebrity|Curated Web|Incentives|Social Media Marketing,560393.0,GBR,3,4,822,15645,16467,0
Apps|Enterprise Software|Facebook Applications|Media|SaaS|Social Media|Social Media Marketing|Social Network Media|Software,90000000.0,USA,5,19,1444,13757,15201,1
Mobile|Mobile Software Tools|Social + Mobile + Local|Software|Technology,1281000.0,USA,5,3,700,15993,16693,0
Games|Television,10550000.0,USA,4,4,2409,13634,16043,0
Information Services|Investment Management|Startups,33887.0,CZE,1,1,0,16467,16467,0
Curated Web|Finance|Personal Finance,25000.0,USA,1,2,0,15881,15881,0
Bicycles,750000.0,USA,1,1,0,16191,16191,0
Wearables,17000000.0,USA,2,2,9,16552,16561,0
Advertising,125000.0,USA,2,2,759,14032,14791,0
Internet|Social Media|Twitter Applications,3900000.0,USA,3,24,1122,15248,16370,0
E-Commerce,1000000.0,CAN,1,8,0,15553,15553,1
Software,1100000.0,CHE,2,3,344,16014,16358,0
Crowdsourcing|Data Security|Information Security|Security,9099999.0,USA,3,8,846,15680,16526,0
Consumer Goods|Food Processing|Organic Food|Specialty Foods,20000.0,USA,1,2,0,16556,16556,0
Gadget|Hardware|Hardware + Software|Open Source,7500000.0,USA,4,4,1758,13247,15005,0
Analytics|Android|iOS|Mobile|Windows Phone 7,100000.0,USA,1,1,0,15006,15006,1
B2B|SaaS|Software,8600000.0,USA,2,4,736,15887,16623,0
IT and Cybersecurity|Security|Software,3340608.0,ESP,1,1,0,16617,16617,0
Enterprise Software,705000.0,USA,6,6,1826,14123,15949,0
Enterprise Software,228771.0,CAN,3,4,1096,14610,15706,0
E-Commerce,112214350.0,CAN,5,8,898,15516,16414,0
Software,1100000.0,USA,1,8,0,15925,15925,0
Real Estate,4000000.0,USA,1,2,0,15134,15134,0
Software,6000000.0,USA,1,1,0,13038,13038,1
Databases|Data Centers|Information Technology,630000.0,USA,1,1,0,16751,16751,0
Commercial Real Estate|Energy Efficiency|Enterprise Software|Green Building|Office Space|Real Estate|Robotics|Smart Building,6640000.0,USA,2,11,488,15857,16345,0
Construction|Software,10700000.0,USA,2,13,1,16742,16743,0
Software,23376606.0,USA,6,5,1311,15194,16505,0
Developer APIs|Maps|Navigation|Software,20000.0,USA,1,2,0,15126,15126,0
Software,2000000.0,USA,1,2,0,12027,12027,0
Logistics|Services|Storage,1500000.0,USA,1,1,0,14988,14988,0
Real Estate,120000.0,USA,1,1,0,16405,16405,0
Construction|Home Renovation|Marketplaces|Real Estate,14563000.0,USA,4,21,1047,15675,16722,0
Communities,805000.0,USA,1,6,0,16223,16223,0
Application Platforms|Internet of Things|Software,600000.0,USA,1,2,0,15657,15657,0
Curated Web|Internet|Search|Shopping,200000.0,AUS,1,1,0,15384,15384,0
Social Media,261104.0,JPN,2,1,209,15034,15243,0
Clean Technology,60000000.0,USA,1,1,0,13676,13676,0
Advertising,5000000.0,USA,1,1,0,13594,13594,0
Health Care Information Technology,1400000.0,USA,1,3,0,12349,12349,0
Android|Events|Games|Interest Graph|iPhone|Local Businesses|Mobile,3000.0,USA,1,1,0,16059,16059,0
Active Lifestyle|Fitness|Nutrition,9000000.0,CAN,1,1,0,16639,16639,0
Software,5000000.0,GBR,1,1,0,14222,14222,0
Business Services|CRM|PaaS|Predictive Analytics|Professional Services|Recruiting|SaaS|Software,27500000.0,USA,2,7,722,13307,14029,0
Consumer Electronics|Manufacturing|Mobile Devices|Product Design|Telecommunications,5448036.0,GBR,1,1,0,15749,15749,0
Advertising|Media,450240.0,ITA,1,2,0,15840,15840,0
E-Commerce|Ediscovery|Fitness|Health and Wellness|Lifestyle|Nutrition|Personal Health|Subscription Businesses,4150000.0,USA,2,10,609,15588,16197,0
Games,45457.0,GBR,1,1,0,15870,15870,0
Analytics|Discounts|SaaS|Software,8500000.0,USA,4,5,1149,14733,15882,0
Mobile,19900000.0,USA,3,14,588,14396,14984,1
Software,1650000.0,CAN,1,4,0,14000,14000,1
Social News|Web Hosting,1000000.0,CAN,2,1,250,15625,15875,0
Games|Software,12500000.0,USA,3,7,1716,13422,15138,0
Collaboration|Freemium|Photo Sharing|Productivity Software|SaaS,40000.0,USA,1,1,0,16440,16440,0
Apps|Computer Vision|Image Recognition|Machine Learning|Photography|Photo Sharing|Private Social Networking,575144.0,NLD,2,1,180,16400,16580,0
Coupons|E-Commerce|Finance|Group Buying,35000.0,USA,1,1,0,14245,14245,0
Rental Housing,513186.0,NLD,1,2,0,16378,16378,0
Content|Curated Web|Photography,20521.0,PRT,1,1,0,15000,15000,0
E-Commerce,750000.0,USA,2,5,324,16071,16395,0
Software,23470000.0,USA,3,9,924,13028,13952,0
Flash Sales|Hospitality|Hotels,65000.0,CHL,2,3,311,15089,15400,0
Advertising,550000.0,USA,1,5,0,14791,14791,0
Industrial|Information Technology|Software,1000000.0,FRA,1,1,0,16366,16366,0
E-Commerce,1200000.0,USA,1,2,0,15610,15610,1
Clean Technology,40000.0,CHL,1,1,0,16034,16034,0
Restaurants,350000.0,IND,1,4,0,16713,16713,0
Consumer Internet|Consumers|Hospitality|Mobile|Photography|Social Media,6500000.0,SGP,2,7,1236,15534,16770,0
Curated Web|Local,2150000.0,IND,2,1,335,13483,13818,0
Curated Web,3450000.0,USA,1,3,0,15510,15510,0
Games,100000.0,USA,1,1,0,15352,15352,0
Advertising|Analytics|iPhone|Mobile Advertising,7300000.0,USA,2,6,610,14698,15308,1
Advertising,15000000.0,USA,1,1,0,10988,10988,0
Advertising|Analytics|Big Data|Business Intelligence|Services,8500000.0,SWE,3,1,1265,14365,15630,0
Art|Design|E-Commerce|Internet|Retail|Startups,1826193.0,ITA,3,7,840,15553,16393,0
Advertising,5000000.0,CHN,2,1,700,12449,13149,0
Software|Travel,10000000.0,CAN,2,10,406,15854,16260,0
Apps|Outdoors,44376.1601166017,BGR,2,1,31,16556,16587,0
E-Commerce,6500000.0,BRA,2,5,225,10896,11121,1
Dental|Doctors|Health and Wellness,40000.0,ARG,1,1,0,15485,15485,0
Travel,4000000.0,RUS,2,4,456,16231,16687,0
Advertising|Crowdsourcing|Marketplaces,323537.0,GBR,2,2,240,16279,16519,0
Software,4000000.0,USA,1,3,0,13028,13028,1
Advertising Networks|B2B|Business Services|Curated Web|Lead Generation|Reputation|Reviews and Recommendations|Sales and Marketing,135000.0,USA,1,3,0,16042,16042,0
Curated Web|News,55600000.0,USA,7,25,2388,14076,16464,1
Accounting|Software,1175000.0,USA,2,1,399,15778,16177,0
Software,8240000.0,CAN,2,5,628,12797,13425,0
Software,602400.0,USA,1,1,0,16189,16189,0
Business Services|Curated Web|Gadget|SaaS|Sales and Marketing|Web Tools,1700000.0,USA,3,1,959,13514,14473,0
Comparison Shopping|E-Commerce|Transportation|Travel,250000.0,PER,2,1,283,16042,16325,0
CRM|Limousines|Public Transportation|Technology|Transportation,2954999.0,USA,2,1,538,15959,16497,0
Curated Web,27000000.0,USA,3,12,492,15930,16422,0
EdTech|Education|Language Learning|Social Media|Social Network Media,11400000.0,GBR,4,5,1962,14669,16631,0
CRM|Events|Lead Management|Mobile,1865000.0,USA,5,3,1091,15371,16462,0
Mobile,1225000.0,USA,1,2,0,15797,15797,0
E-Commerce,12500.0,HKG,1,1,0,16405,16405,0
Hospitality,100000.0,USA,3,3,228,15765,15993,0
Bitcoin|Software,1250000.0,USA,2,9,30,15936,15966,0
Consumer Electronics|Hardware + Software|Home Automation|Internet of Things|Software|Startups|Video Streaming,1935200.0,USA,3,1,493,16222,16715,0
Health and Wellness,23056409.0,USA,2,1,610,15952,16562,0
Software,100000000.0,USA,1,2,0,16376,16376,0
Mobile,14250000.0,USA,2,24,196,16261,16457,0
Advertising|Hospitality|Hotels,16924999.0,USA,5,8,924,14679,15603,1
Educational Games|Financial Services|Mobile Games|Stock Exchanges|Trading,3798698.0,NLD,4,4,622,16071,16693,0
Finance,315000.0,USA,2,3,90,13514,13604,0
Manufacturing,18600000.0,USA,1,2,0,16091,16091,0
E-Commerce|Mobile Commerce|Social Commerce|Social Media|Social Network Media,300000.0,BRA,1,1,0,15584,15584,0
Apps|E-Commerce|Mobile Commerce,2300000.0,USA,1,4,0,16195,16195,0
E-Commerce|Social Commerce,7600000.0,GBR,2,3,571,15996,16567,0
E-Commerce|Enterprise Software|Payments|Social Commerce,2300000.0,FRA,1,2,0,15727,15727,0
Cloud Infrastructure|Enterprise Software|Procurement|SaaS,12000000.0,USA,3,2,1373,15340,16713,0
Organic Food,174083.0,ESP,1,2,0,16511,16511,0
E-Commerce|Internet,1000000.0,IND,1,2,0,16563,16563,0
E-Commerce|Marketplaces|Sports,28753.0,AUS,1,2,0,15870,15870,0
E-Commerce,355000.0,USA,1,4,0,16223,16223,0
E-Commerce|Fashion|Search|Shopping|Social Commerce,325000.0,CAN,1,3,0,15344,15344,0
Advertising|Online Scheduling|Sales and Marketing,6860000.0,USA,3,3,487,15339,15826,0
Software,14450000.0,USA,2,3,1702,12858,14560,0
Finance,1369974.0,USA,3,5,468,15461,15929,0
Advertising,24030000.0,USA,3,11,1233,14187,15420,1
E-Commerce|Search,1000000.0,IND,1,1,0,15882,15882,1
E-Commerce|Online Shopping|Sales and Marketing,20000009.6565487,ESP,2,7,624,13713,14337,1
E-Commerce|Group Buying|Social Commerce,36962500.0,USA,6,6,702,14424,15126,1
E-Commerce,625000.0,ESP,1,4,0,13979,13979,1
Publishing|Social Media,72000000.0,USA,5,8,1661,13512,15173,0
Advertising|Startups,1335000.0,USA,4,8,306,15064,15370,0
Software,1222000.0,USA,2,1,463,15908,16371,0
Advertising|Mobile|Technology|Wireless,10000000.0,SGP,2,2,491,14119,14610,0
Advertising,750000.0,ISR,1,1,0,15362,15362,0
Education|Marketplaces|Peer-to-Peer,400000.0,BRA,2,2,334,14822,15156,0
Entertainment|Internet|Media|News,296300000.0,USA,6,25,2596,14069,16665,0
Analytics|Business Intelligence|Enterprise Software|SaaS|Social CRM|Social Media,1569585.0,USA,2,3,1241,13970,15211,0
Analytics|Social Media,2000000.0,ISR,2,1,3,15156,15159,0
Social Media,2600000.0,USA,3,2,654,14975,15629,0
Advertising|E-Commerce|Lead Management|Sales and Marketing,1330822.0,GBR,3,7,641,15826,16467,0
Advertising|Digital Media|Video|Video Streaming,2500000.0,GBR,1,1,0,16386,16386,0
Content|Digital Media,6000000.0,USA,1,2,0,13657,13657,0
Information Technology|Internet|Mobile|Opinions|Search|Social Media,889120.0,KOR,1,1,0,14975,14975,0
Analytics|Mobile Payments,257320.0,NLD,1,1,0,15992,15992,0
Advertising|Video,3000000.0,RUS,2,2,886,15340,16226,0
Advertising|Social Media|Social Media Advertising,1231588.0,ITA,2,8,617,16021,16638,0
Advertising|Social Media|Social Media Marketing,20000.0,USA,1,1,0,15958,15958,0
Analytics|Lead Generation|Search Marketing|Social Media,600000.0,USA,4,3,309,16007,16316,0
Mobile|Restaurants,1025000.0,USA,3,2,695,15131,15826,1
Apps|Collaboration|Events|Mobile|Real Time|Social Media,68777.0,LVA,1,2,0,16056,16056,0
Advertising|Mobile,3000000.0,KOR,1,1,0,16074,16074,0
Entertainment|Games|Social Media|Social Network Media|Utilities,200000.0,USA,1,1,0,14610,14610,0
Mobile,12000000.0,USA,2,5,153,13695,13848,0
Hardware + Software,5980000.0,HUN,1,1,0,13132,13132,0
Finance|FinTech,10000000.0,USA,2,2,944,13917,14861,1
Analytics|Social Media|Social Media Marketing,40000.0,CHL,1,1,0,16222,16222,0
FinTech|Online Rental|Subscription Businesses,1100000.0,GBR,1,5,0,16742,16742,0
Travel,30000000.0,CHN,2,3,2203,13939,16142,0
Apps|Hospitality|Hotels|Mobile|Online Travel|Tourism|Travel,4371960.0,ESP,2,4,276,15912,16188,0
News,850000.0,GBR,1,2,0,16637,16637,0
Content|Media|Publishing,1000000.0,USA,2,12,366,15156,15522,1
Information Technology|Mobile Payments|Parking|Software|Ticketing,1450000.0,USA,2,2,881,15309,16190,0
Customer Service|Customer Support Tools|Software,265064.0,ESP,1,1,0,15867,15867,0
Mobile,11350000.0,USA,4,6,1642,14822,16464,0
Enterprise Software,244000.0,SWE,1,1,0,14215,14215,0
Security,100000000.0,USA,1,1,0,15859,15859,0
Mobile,4250000.0,USA,2,6,374,15629,16003,1
Mobile|Mobile Video,29000000.0,USA,1,1,0,11715,11715,1
Curated Web|Local Businesses|Reviews and Recommendations|Social Media,3000000.0,USA,2,2,24,16040,16064,0
Advertising|App Marketing|Mobile,8100000.0,GBR,3,2,666,14559,15225,0
Advertising|Social Media|Social Media Marketing,14500000.0,USA,2,2,731,12418,13149,1
Productivity Software,6000000.0,ISR,1,1,0,16355,16355,0
Fashion|Media|Video,4000000.0,JPN,1,8,0,16535,16535,0
Biotechnology,726000.0,DEU,2,3,809,13168,13977,0
Software,5000000.0,ISR,1,2,0,13521,13521,1
Event Management|Publishing,491181.652073114,GBR,1,1,0,13598,13598,0
Energy|Energy Storage|Oil & Gas,4500000.0,USA,1,1,0,14123,14123,0
Advertising|Internet|Software,5100000.0,USA,1,4,0,16655,16655,0
Hardware + Software,10000000.0,USA,1,3,0,14529,14529,0
Semiconductors,982000.0,CAN,2,2,470,14144,14614,0
Messaging|Mobile|VoIP,2725875.0,DEU,3,4,947,13879,14826,0
Biotechnology|Health Diagnostics,105000000.0,USA,3,1,1532,14614,16146,0
Advertising|Analytics|Business Analytics|Optimization|Predictive Analytics|Test and Measurement,1104000.0,USA,1,1,0,15190,15190,0
Advertising,1290000.0,CAN,1,1,0,13224,13224,0
Games,3000000.0,USA,1,1,0,13907,13907,0
Manufacturing,21900000.0,USA,3,6,1361,15018,16379,0
Collaboration|Event Management|Innovation Management|Non Profit,1750000.0,USA,1,5,0,16504,16504,0
Web Hosting,41500000.0,USA,3,5,1347,14837,16184,0
Biotechnology,64016800.0,USA,6,1,1113,14390,15503,0
Education,320000.0,USA,1,1,0,15503,15503,0
Games,445000.0,AUS,2,4,464,15826,16290,0
Analytics|Big Data|Business Development|Predictive Analytics|Sales and Marketing|Software,35600000.0,USA,6,14,3371,12600,15971,1
Marketplaces|Recruiting|Social Recruiting,50000.0,IDN,1,1,0,16225,16225,0
Android|Apps|Automotive|iPhone|Mobile|Public Transportation|Travel,96299.0,ITA,3,2,43,15918,15961,0
Automotive|Distribution|E-Commerce|Travel,1678603.0,FIN,1,1,0,16462,16462,1
Internet|Mobile|Taxis,23000000.0,ESP,3,15,1110,15599,16709,0
Advertising Platforms|Media|Real Time,153553.0,CAN,1,1,0,16679,16679,0
Web Hosting,1281302.0,GBR,1,2,0,15675,15675,0
Software,5000000.0,USA,2,5,791,12682,13473,0
Mobile|SaaS|Service Providers|Transportation,95000.0,USA,1,1,0,16344,16344,0
Entertainment|Internet|Software|Television,886210.0,FRA,1,1,0,14158,14158,0
Mobile,4000000.0,USA,1,1,0,14336,14336,0
Biotechnology,3050000.0,USA,3,12,1252,15359,16611,0
Health and Wellness|Optimization,55000.0,USA,2,1,335,15811,16146,0
Software,44307221.0,USA,2,10,1620,12850,14470,1
Software,2780609.0,FIN,6,17,1642,14944,16586,0
Software,6800000.0,USA,3,9,501,13195,13696,0
Analytics|Location Based Services|Software|Transportation,1178000.0,USA,5,6,706,14822,15528,1
Investment Management|Real Estate|Technology,18300000.0,USA,1,6,0,16518,16518,0
3D|CAD|Marketplaces|Software,40000.0,USA,1,1,0,15871,15871,0
Consumer Goods|Fashion|Lifestyle Products|Wearables,1600000.0,USA,1,5,0,16553,16553,0
Hardware + Software,100000000.0,ISR,1,1,0,16048,16048,0
Coffee|Specialty Foods,71000000.0,IND,2,1,3279,13443,16722,0
Hospitality,13000000.0,USA,1,1,0,16162,16162,0
Curated Web|Parenting|Social Network Media,17000000.0,USA,2,4,210,13747,13957,0
E-Commerce,15500000.0,USA,3,7,1798,11017,12815,1
Software,31540450.0,USA,2,4,315,16209,16524,0
Biotechnology,4592178.0,USA,6,4,1252,14697,15949,0
Lasers|Optical Communications|Telecommunications,135734.0,FRA,1,1,0,16090,16090,0
Software,4000000.0,USA,3,2,956,15023,15979,0
News,8888247.0,CHN,1,1,0,15522,15522,0
Health and Insurance|Health and Wellness|Health Care,150000.0,USA,2,2,92,15095,15187,0
Curated Web|Fashion|Lifestyle|Retail,1000000.0,USA,1,1,0,15565,15565,0
Health and Wellness,200000.0,USA,1,2,0,16120,16120,0
Manufacturing,4756612.0,USA,1,1,0,15436,15436,0
Software,8000000.0,USA,1,2,0,13844,13844,0
Biotechnology,1000000.0,USA,1,1,0,14992,14992,0
Finance,22822343.0,GBR,3,4,1776,14183,15959,0
Health Care,59463635.0,USA,10,9,2459,13725,16184,0
Health Care,10414530.0,GBR,6,6,954,15656,16610,0
Biotechnology,14672950.0,USA,4,2,1330,15113,16443,0
Clean Technology|Energy|Recycling,45500000.0,USA,3,2,632,14690,15322,0
Health Care,95375917.0,USA,5,8,1742,14848,16590,0
Biotechnology,54800000.0,USA,5,10,987,14092,15079,1
Real Estate,50000.0,USA,1,1,0,16358,16358,0
Software,6014820.0,USA,3,1,525,15069,15594,0
Data Centers|Networking,92885563.0,USA,6,6,4091,12429,16520,0
Organic Food,50000000.0,USA,1,1,0,16709,16709,0
Document Management,10000.0,USA,2,1,3726,12171,15897,1
Design,10500000.0,USA,1,3,0,11562,11562,1
Optical Communications|Semiconductors,25000000.0,USA,1,8,0,11404,11404,0
Health and Wellness|Health Care|Medical|Therapeutics,15000000.0,USA,1,3,0,16582,16582,0
Web Hosting,2682400.0,BEL,1,3,0,14876,14876,0
Retail,2391086.98415785,SWE,1,2,0,16710,16710,0
Biotechnology|Medical|Pharmaceuticals,97200000.0,USA,5,18,1213,13577,14790,1
Biotechnology,104999998.0,USA,6,16,1484,14798,16282,1
Semiconductors|Telecommunications|Television|VoIP|Web Hosting,150000000.0,USA,3,11,2397,12090,14487,1
Consulting,2835160.43672589,GBR,1,3,0,14558,14558,0
Big Data Analytics|Finance|FinTech|Mobile,500000.0,SGP,1,5,0,16740,16740,0
Messaging|Mobile|Small and Medium Businesses,180000.0,USA,2,3,26,15216,15242,0
Mobile,5000000.0,ISR,2,5,792,15615,16407,0
Mobile|Public Relations|Social Media,20000.0,RUS,1,1,0,15394,15394,0
Mobile,6000000.0,USA,1,3,0,14914,14914,0
Advertising|Sales and Marketing|Software,25000.0,USA,1,1,0,15584,15584,0
Energy Management|Internet of Things|Machine Learning|Predictive Analytics|SaaS|Smart Building,122000.0,USA,5,3,851,15432,16283,0
Software|Technology,11350000.0,USA,2,5,2555,12062,14617,1
CRM|Customer Service|Mobile|Sales and Marketing|Telecommunications,2110000.0,USA,2,2,108,16601,16709,0
Security,1250000.0,CAN,1,3,0,12816,12816,0
Cloud Data Services|Communications Hardware|Customer Service|Software|Tech Field Support|Virtual Workforces,250000.0,USA,2,2,388,15048,15436,0
Enterprise Software,72110889.0,USA,11,22,4058,12635,16693,0
Messaging,6000000.0,CYP,1,1,0,15278,15278,0
Android|iPhone|Online Scheduling,137870.0,FRA,2,2,0,15034,15034,0
Mobile,2004300.0,USA,3,2,593,15431,16024,0
iPhone|Mobile,4000000.0,USA,1,1,0,14830,14830,0
Education|Games|MMO Games|Mobile Games|Virtual Worlds,36000.0,IND,1,1,0,15765,15765,0
Curated Web,1043000.0,USA,2,18,477,15762,16239,0
Analytics|Big Data,2150000.0,USA,3,4,682,14862,15544,1
Hardware + Software,3030502.0,GBR,1,1,0,15919,15919,0
Health Care|Medical|Therapeutics,10000000.0,USA,1,2,0,16601,16601,0
Software,8000000.0,USA,1,4,0,13165,13165,1
Clean Technology,33040000.0,USA,3,8,2314,14186,16500,0
Productivity Software|Software,250000.0,USA,1,1,0,15645,15645,0
Application Platforms|Data Centers|Software,131750000.0,USA,5,11,785,14837,15622,0
Health Care,102569484.0,USA,4,12,1516,13521,15037,1
EDA Tools|Software,18813485.0,USA,3,3,2335,12674,15009,1
Biotechnology,18000000.0,USA,3,3,1340,15117,16457,0
Health Care|Medical|Medical Devices,50000.0,USA,1,1,0,16007,16007,0
Games|Hardware,200000.0,ISR,3,2,312,13910,14222,0
Artists Globally|E-Commerce|Personalization|Printing|Technology,1136420.0,ESP,2,3,1043,15359,16402,0
Biotechnology,10000000.0,USA,3,8,872,15522,16394,0
Telecommunications|Web Hosting,62500000.0,GBR,5,17,2233,13164,15397,0
Hardware + Software,8842094.0,GBR,2,11,441,15347,15788,0
Innovation Engineering|Innovation Management|Product Development Services,9276114.0,USA,1,1,0,16506,16506,0
Biotechnology|Health Diagnostics,5500000.0,GBR,1,3,0,16372,16372,0
Cloud Data Services|Data Security|Information Technology|Media|Technology|Video|Web Development,5588898.0,GBR,2,2,365,16218,16583,0
Finance,75762572.0,GBR,1,4,0,15989,15989,0
Software,339000.0,GBR,1,2,0,13423,13423,1
Technology,50000000.0,GBR,1,1,0,16674,16674,0
Hardware + Software,4380000.0,GBR,2,1,2286,14001,16287,0
Web Hosting,54300000.0,USA,3,4,1133,13432,14565,1
Nanotechnology,62620022.0,USA,8,28,3589,12635,16224,0
Agriculture|Animal Feed|Distribution,32407045.0,BRA,1,1,0,14965,14965,0
Photography,23000000.0,CHN,2,5,476,15468,15944,0
Hardware + Software,23000000.0,ISR,6,11,2526,12600,15126,1
Health Care,158500000.0,USA,2,8,1065,14047,15112,1
Web Hosting,16100000.0,USA,2,5,653,12871,13524,1
Software,5424403.0,CAN,1,2,0,12117,12117,0
E-Commerce|Software,161835.0,GBR,2,2,30,15140,15170,0
Brand Marketing|Events|Startups,20385.0,EST,1,1,0,16040,16040,0
Sales and Marketing|Travel,1200000.0,USA,4,3,312,16440,16752,0
Software,250000000.0,USA,1,1,0,16176,16176,0
Analytics|Business Intelligence|Project Management,470000.0,GBR,2,1,164,16118,16282,0
CRM|Software,9666667.0,USA,2,2,292,14636,14928,0
Online Rental|Travel & Tourism,8503365.0,DEU,3,13,429,16153,16582,0
Advertising|Semantic Search,5000000.0,SWE,2,7,622,15492,16114,1
EdTech|Education|K-12 Education|Online Education,1039000.0,USA,3,10,151,16071,16222,0
Internet|Travel,1982885.0,FRA,2,3,1816,13879,15695,0
Parking,2024082.0,FRA,1,1,0,15735,15735,0
Health and Wellness|Health Care|Medical,4298066.0,USA,2,1,483,16170,16653,0
Agriculture,40000000.0,BRA,1,2,0,16715,16715,0
Marketplaces|Online Travel,83935.0,BEL,1,1,0,16495,16495,0
Colleges|EdTech|Education|Online Rental|Point of Sale|Textbooks|Universities,24086489.0,USA,3,3,1702,14868,16570,0
College Campuses|Colleges|Education|High Schools|Search|Universities,8900000.0,USA,3,9,1263,13738,15001,0
Education|Mobile,6900000.0,USA,3,3,460,16008,16468,0
Colleges|Education,55000.0,USA,2,1,40,15421,15461,0
EdTech,3000000.0,USA,2,3,0,16546,16546,0
Curated Web,93000.0,USA,2,1,454,15657,16111,0
Advertising,10510000.0,USA,4,8,1198,14669,15867,0
Colleges|EdTech|Education|Enterprise Software|SaaS,500000.0,USA,1,3,0,16440,16440,0
Medical Devices,175000.0,USA,1,1,0,16567,16567,0
Software,1560000.0,GBR,2,5,1070,13214,14284,0
Clean Technology,54619508.5957915,GBR,5,11,3103,12067,15170,0
Software,525068.0,USA,1,2,0,14811,14811,0
Finance|FinTech,743000000.0,USA,4,8,1515,15012,16527,0
Advertising|Online Travel|Travel,4740285.0,CAN,1,2,0,16526,16526,0
Semiconductors,155111530.0,USA,3,2,478,16127,16605,1
Games,5360000.0,FRA,1,2,0,13685,13685,0
Software,4250000.0,USA,1,1,0,16280,16280,0
Crowdfunding|Hardware + Software|Home Automation|Security|Startups,41200000.0,USA,3,13,669,15918,16587,0
Carbon|Nanotechnology|Organic|Semiconductors,18414560.0,FIN,2,7,895,14882,15777,0
Biotechnology,20000000.0,CHN,2,2,329,16406,16735,0
Furniture,13010774.0,GBR,1,1,0,16328,16328,0
Analytics|Marketing Automation|Sales and Marketing,692594.0,GBR,3,2,922,14669,15591,0
Enterprise Software,1900000.0,USA,1,1,0,15340,15340,0
B2B|Brand Marketing|Crowdsourcing|Digital Rights Management|E-Commerce|Marketing Automation|Sales and Marketing|Social Commerce|Social Media,210000.0,CAN,1,1,0,15979,15979,0
Advertising|Augmented Reality|Brand Marketing,175000.0,USA,3,3,791,15706,16497,0
Hardware + Software,34000000.0,USA,3,15,1513,13025,14538,1
Clean Technology,1666000.0,FRA,1,2,0,14414,14414,0
Human Resources|Software,550000.0,USA,2,4,651,15420,16071,0
E-Commerce,163934.0,CHN,1,1,0,16040,16040,0
Cannabis|Healthcare Services|Startups,225000.0,USA,1,1,0,16233,16233,0
Software,1500000.0,USA,1,3,0,16687,16687,0
Finance|FinTech,89500000.0,USA,4,5,639,13879,14518,0
Analytics|Big Data|Lead Generation|Marketing Automation,2064000.0,CAN,2,3,463,15687,16150,0
Advertising|Local Search|Search,110000000.0,CAN,1,1,0,12784,12784,1
Biotechnology,8100000.0,GBR,1,1,0,14634,14634,0
Enterprise Software,16400000.0,USA,2,3,1732,14726,16458,0
Music,5000000.0,USA,1,3,0,11264,11264,1
Biotechnology,1000000.0,SWE,1,2,0,15891,15891,0
Health Care,2000000.0,USA,1,1,0,13952,13952,0
Design,27955000.0,AUS,6,27,942,15772,16714,0
Game|Games|Mobile Games|Software|Web Development,38817.0,ITA,1,1,0,15340,15340,0
Android|Audio|Automotive|Green|iPhone|Location Based Services|Mobile|Mobility|Point of Sale|Surveys|Video|Wireless,20077736.0,USA,8,10,2322,14092,16414,0
Software,1200000.0,IND,1,1,0,16692,16692,0
Software,12153000.0,IND,6,5,1492,14873,16365,0
Advertising|Apps|Enterprise Software|Project Management|Public Relations|SaaS|Software,1035000.0,USA,2,3,527,15979,16506,0
E-Commerce,2300000.0,USA,1,2,0,15664,15664,0
Energy|Energy Management|Environmental Innovation,25107.0,NLD,1,1,0,16375,16375,0
Software,10650403.3139571,CAN,1,1,0,16708,16708,0
Software,19950000.0,USA,2,8,387,13256,13643,1
Consumer Goods|Lifestyle|Wine And Spirits,50000.0,USA,1,1,0,16008,16008,0
Drones|Services|Video,10000000.0,USA,1,5,0,16721,16721,0
Software,4220000.0,IRL,4,3,3642,11031,14673,0
Clean Technology|Energy|Environmental Innovation|Renewable Energies|Wind,1200000000.0,USA,3,5,281,15874,16155,0
Software,918000.0,SWE,2,5,521,13759,14280,0
Web Hosting,101505616.0,USA,10,12,2072,13047,15119,0
Curated Web,1000000.0,DNK,1,1,0,14670,14670,0
Analytics|Enterprise Software|Loyalty Programs|Retail,79100000.0,SGP,5,9,2157,14523,16680,0
Ticketing|Travel,11903553.0,FRA,3,9,809,15597,16406,0
Financial Services|Small and Medium Businesses,16000000.0,IND,3,5,230,16246,16476,0
Human Resources,25000000.0,USA,1,1,0,12349,12349,0
Consumer Lending|Financial Services|FinTech|Peer-to-Peer,710868.0,SGP,1,3,0,16664,16664,0
Hospitality,5000000.0,USA,1,1,0,16156,16156,0
Finance|Financial Services|Venture Capital,350000.0,CHL,1,2,0,16405,16405,0
Enterprise Software,5899400.0,USA,8,47,1268,14761,16029,0
Biotechnology|Gas|Health and Wellness|Health Care|Medical,22219087.0,USA,4,3,3025,12541,15566,0
Health Care,46889878.0,IRL,4,6,1444,13579,15023,0
Analytics|Information Services|Information Technology|Mobile,1500000.0,RUS,1,2,0,15400,15400,1
Apps|Communities|Photography,20228.0,MEX,1,1,0,16314,16314,0
Furniture,1250000.0,IND,1,1,0,16538,16538,0
Biotechnology,53792001.0,USA,8,3,2036,14433,16469,0
Hospitality,10000000.0,IND,1,1,0,15908,15908,0
Enterprise Software|Mobile,50500000.0,USA,3,9,1217,15156,16373,0
Software,3030000.0,FRA,1,2,0,13815,13815,0
Analytics|Information Technology|Services,170000.0,USA,1,1,0,16524,16524,0
Finance|Finance Technology|FinTech|Software,1000000.0,USA,1,4,0,16366,16366,0
News,820000.0,USA,2,1,107,15995,16102,0
Health and Wellness|Health Care Information Technology|Medical Devices,2492084.0,IRL,1,1,0,16464,16464,0
Construction|Information Services|Professional Services|Project Management,100000000.0,USA,1,1,0,16408,16408,0
Curated Web,100000.0,USA,1,1,0,15534,15534,0
Hotels|Location Based Services|Online Travel|Price Comparison|Ticketing,123356.0,GRC,1,2,0,16000,16000,0
Financial Services|Lead Generation|Price Comparison,150104.0,BRA,3,3,1066,14579,15645,0
Advertising,14415734.0,GBR,2,2,712,15901,16613,0
Analytics|Apps|B2B|Brand Marketing|Facebook Applications|Finance|Mobile|Mobile Video|Social Media|Weddings,1200000.0,USA,2,2,176,14822,14998,0
Mobile|Storage,3153403.0,ESP,3,4,649,15789,16438,0
Manufacturing,152000.0,GBR,1,2,0,16087,16087,0
Advertising|Digital Media|Digital Signage|Human Computer Interaction|Outdoor Advertising|Video Games,2178812.0,GBR,3,6,812,15657,16469,0
Hospitality,5000000.0,USA,1,1,0,13368,13368,0
Cloud Computing|Marketing Automation|Software|Technology,27250000.0,USA,2,3,445,15765,16210,0
Data Integration|Enterprise Software|SaaS,16900000.0,USA,5,8,1018,15248,16266,0
Manufacturing,3318000.0,IND,1,1,0,15428,15428,0
Charter Schools|Colleges|Education|Online Scheduling|Software|Universities,1945000.0,USA,3,5,228,16160,16388,0
Apps|Legal|Mobile|Software,681818.0,CAN,1,7,0,16164,16164,0
Apps|Mobile,750000.0,CAN,1,7,0,16164,16164,0
Health Care|Health Care Information Technology|Technology,1200000.0,USA,2,1,126,15853,15979,0
Analytics|Direct Sales|Sales and Marketing|Search|Software,4700000.0,USA,1,1,0,15532,15532,0
Design|Mobile|Security|Spam Filtering,1055000.0,JPN,3,3,858,15645,16503,0
Automotive,6500000.0,USA,1,2,0,13955,13955,0
E-Commerce,1100000.0,USA,2,1,624,15082,15706,0
Finance|FinTech,13051777.0,GBR,1,1,0,16106,16106,0
Cars,1300000.0,AUS,1,2,0,16734,16734,0
Automotive|Cars|Media|News,2970611.0,GBR,2,11,536,15918,16454,0
Biotechnology|Health Care,56100003.0,USA,5,19,3276,13138,16414,1
Manufacturing|Technology,250000.0,USA,1,1,0,15103,15103,0
Advertising|Video,5000000.0,ISR,2,7,150,15893,16043,0
E-Commerce|Jewelry,52000000.0,IND,3,1,1310,15147,16457,0
Home Decor|Product Search|Retail,1994633.0,IND,3,5,842,15918,16760,0
Information Technology|Online Travel,1089811.0,ESP,2,1,1298,15340,16638,0
Automotive|Cars|Internet,200000.0,RUS,1,1,0,15930,15930,0
Clean Technology,10000000.0,USA,1,1,0,14195,14195,0
Analytics|Big Data|Carbon|Clean Energy|Supply Chain Management,51842.0,GBR,1,1,0,16035,16035,0
Software,38850000.0,USA,7,16,3164,12431,15595,0
Enterprise Software,1434300.0,GBR,1,1,0,14595,14595,0
E-Commerce|Health and Wellness|Retail,1000000.0,USA,1,1,0,16161,16161,0
3D Technology,141000000.0,USA,3,12,597,16070,16667,0
Clean Technology|Construction|Manufacturing,8068411.0,CAN,3,8,1174,15400,16574,0
Clean Technology,5000000.0,USA,1,1,0,14061,14061,0
Software,3415048.0,KOR,1,1,0,16281,16281,0
Carbon|Green|Software,8467282.0,USA,4,6,827,14083,14910,0
SaaS|Software,67192715.0,USA,6,14,1408,13208,14616,1
Clean Technology,156188.0,GBR,1,1,0,15868,15868,0
Energy Management|Information Technology,2000000.0,AUS,1,2,0,16672,16672,0
Health Care,34999999.0,USA,4,6,2657,13843,16500,1
Banking|Credit|Curated Web|Mobile|P2P Money Transfer|Payments,12000000.0,USA,4,8,1302,15455,16757,0
Mobile,1000000.0,USA,1,5,0,15015,15015,1
Gift Card|Hardware + Software,980000.0,USA,3,1,525,16184,16709,0
Android|Apps|Credit Cards|Discounts|iPhone|Location Based Services|Loyalty Programs|Mobile,170000.0,IND,1,1,0,16248,16248,0
E-Commerce|Gift Card,12000000.0,USA,2,2,404,16016,16420,0
Finance|Hardware + Software,50000000.0,USA,1,1,0,14868,14868,0
Biotechnology|Health Care|Pharmaceuticals,45035988.0,USA,2,3,1120,15415,16535,0
Software,2094840.0,USA,5,2,1236,15267,16503,0
Automotive|Cars|Online Shopping,65000000.0,IND,3,5,547,16036,16583,0
Mobile|Mobile Payments|Payments,6550000.0,USA,4,19,827,15889,16716,0
Finance,48205485.0,USA,2,6,1768,14169,15937,0
Biotechnology|Health Care|Medical Devices,110596923.0,USA,10,22,4011,12494,16505,0
Biotechnology,10500249.0,USA,6,2,1291,14981,16272,0
Biotechnology,6905380.0,USA,5,9,2047,14473,16520,0
Biotechnology,45434000.0,USA,4,3,1297,14376,15673,1
Apps|Health and Wellness|Health Care,20000.0,USA,1,1,0,15340,15340,0
Curated Web|Ediscovery|Mobile|Music|Social Network Media,63925.0,CAN,1,1,0,14914,14914,0
Curated Web|Facebook Applications|Mobile|Social Games,2300000.0,USA,2,7,736,15202,15938,0
Clean Technology,200000000.0,USA,1,1,0,15839,15839,0
E-Commerce,7552438.0,USA,3,1,2435,12691,15126,0
Biotechnology,68589111.0,BEL,4,1,888,15349,16237,1
Medical,540000.0,USA,1,1,0,16762,16762,0
Biotechnology|Health Diagnostics,268990356.0,USA,9,55,3269,13350,16619,0
Biotechnology,86872388.0,USA,6,20,2032,14410,16442,0
Biotechnology|Genetic Testing|Medical,526000.0,USA,1,1,0,16380,16380,1
Health Care,36050344.0,USA,7,8,2085,13935,16020,1
Biotechnology,37000000.0,USA,1,4,0,12521,12521,1
Health and Wellness|Health Care|Medical Devices,135500000.0,USA,5,19,2337,14075,16412,0
Health Care,300000.0,FRA,2,1,128,16132,16260,0
Health Care|Medical Devices,232601872.0,USA,10,23,3364,11504,14868,1
Biotechnology,55000000.0,USA,2,6,272,13697,13969,0
Bio-Pharm,11269243.0,DEU,1,6,0,11953,11953,0
Enterprise Software|Health Care,123000000.0,USA,2,4,1533,12065,13598,1
Health Care|Medical Devices|Services,22000000.0,USA,2,8,1168,11963,13131,0
Health Care,27205437.0,USA,5,3,608,14502,15110,0
Health Care,18300000.0,USA,3,2,1749,13782,15531,0
Health Care|Pets,6100000.0,ESP,1,1,0,15681,15681,0
Medical Devices,11220000.0,USA,1,2,0,13887,13887,1
Biotechnology,14511774.0,USA,8,3,1977,14190,16167,0
Biotechnology,66500000.0,USA,4,6,2169,13488,15657,1
Health Care,32930335.0,USA,3,1,511,15783,16294,0
Contact Management|Mobile,1200000.0,USA,1,1,0,15768,15768,0
Automotive|Cars|Marketplaces,800000.0,KOR,2,4,59,16102,16161,0
Auto|Automotive|Cars|Social Network Media,3000000.0,USA,1,1,0,13693,13693,1
Biotechnology,17592449.0,SWE,1,4,0,14868,14868,0
E-Commerce,10000000.0,USA,2,10,272,15098,15370,1
Android|App Marketing|CRM|iPhone|Mobile Commerce|Software,2030882.0,USA,4,7,1016,14214,15230,1
Software,1900000.0,USA,1,1,0,16770,16770,0
Business Services|Finance,75000000.0,USA,1,1,0,12850,12850,1
Enterprise Software|Franchises|Health Care,324656.0,GBR,1,1,0,15114,15114,0
Health and Wellness|Health Care Information Technology|Mobile Enterprise|Mobile Health,1910000.0,USA,3,4,1169,15492,16661,0
Curated Web|Customer Service|Tutoring,110800000.0,USA,6,16,2075,13453,15528,1
Curated Web,8832393.0,USA,3,1,624,15233,15857,1
Health Care|Messaging,525000.0,USA,1,1,0,15796,15796,0
Health Care|Healthcare Services,8453342.0,GBR,1,1,0,14743,14743,0
Software,12600000.0,USA,3,1,913,15468,16381,0
Electronic Health Records|Health and Wellness|Software,98772385.0,USA,7,10,2019,14628,16647,0
Health and Wellness|Parenting,6139494.0,USA,4,5,1569,15089,16658,0
Public Transportation|Transportation,71700000.0,ARE,3,5,792,15957,16749,0
All Students|Career Management|Professional Networking|Universities,1200000.0,USA,1,3,0,16566,16566,0
Human Resources|Recruiting|SaaS|Software|Staffing Firms,100000.0,USA,1,2,0,15706,15706,0
Career Management|EdTech|Education|Teachers,1339211.0,DEU,2,2,509,16101,16610,0
Employment|Semantic Web|Technology,25000.0,USA,1,1,0,14904,14904,0
Consulting,2085000.0,USA,2,6,237,14861,15098,0
Analytics|Recruiting|Search|Social Media,500000.0,USA,1,2,0,15949,15949,0
Health and Wellness,25053750.0,USA,4,14,2435,12251,14686,1
Software,6800000.0,USA,1,5,0,12579,12579,1
Child Care|Elder Care|Home Owners|Pets,5571919.0,CAN,4,44,910,15706,16616,0
Software,2600000.0,USA,3,3,427,15497,15924,1
Health Care,7000000.0,USA,3,4,1067,14893,15960,0
Public Transportation|Transportation,42000000.0,CHN,3,4,2869,13483,16352,0
Child Care|Curated Web|Education,1700000.0,USA,1,4,0,16375,16375,0
Enterprise Software|Health and Wellness|Hospitals|Senior Citizens,6100000.0,USA,2,6,544,15897,16441,0
Electronic Health Records|Health and Wellness,697428.634273789,AUS,1,1,0,16752,16752,0
Health Care,33129450.0,USA,5,5,1812,14778,16590,0
Health and Wellness,6000000.0,USA,1,2,0,13725,13725,0
Finance|Health Care|Hospitals,60000000.0,USA,1,1,0,16203,16203,1
Biotechnology|Networking|Software|Therapeutics,27000000.0,USA,1,1,0,14993,14993,1
Finance|Health and Wellness,3130000.0,USA,4,13,1012,15575,16587,0
Fitness|Health and Wellness,1000000.0,USA,1,1,0,16566,16566,0
Curated Web|Health and Wellness|Health Care Information Technology|Healthcare Services|mHealth,23000000.0,USA,3,11,351,16364,16715,0
Clean Energy|Consumer Electronics|Education|Gamification|Hardware + Software|Kids,27000.0,NLD,1,1,0,16085,16085,0
Health and Wellness|Health Care|Medical|Medical Devices,30000.0,USA,1,1,0,16310,16310,0
Biotechnology,32000000.0,FRA,1,6,0,12485,12485,0
Banking|Cars|Credit|Finance,250000.0,RUS,2,1,204,15624,15828,0
Public Transportation,8000000.0,ISR,1,1,0,14836,14836,0
Hardware + Software,1500000.0,GBR,1,8,0,16345,16345,0
Logistics,450000.0,SGP,2,4,503,15825,16328,0
E-Commerce,260000.0,BRA,2,2,68,15911,15979,0
Manufacturing,4167020.0,DEU,2,6,1083,14230,15313,0
Logistics|Public Transportation|Shipping|Transportation,10600000.0,USA,2,25,219,16245,16464,0
Analytics|Big Data|Cloud Computing|Internet of Things|Logistics|SaaS|Sensors,3500000.0,USA,3,5,379,16294,16673,0
Big Data|Big Data Analytics|Search|Shipping,264094.0,NOR,1,1,0,15706,15706,0
Biotechnology,14464846.0,USA,2,3,173,16346,16519,0
Software,100000.0,GBR,1,1,0,16204,16204,0
Biotechnology,2000000.0,USA,1,1,0,13858,13858,0
Biotechnology|Health Care|Health Care Information Technology|Healthcare Services,605000.0,USA,3,2,716,15961,16677,0
Baby Boomers|Elder Care|Local Based Services|Media|Senior Health,23519998.0,USA,4,6,2092,13757,15849,0
Software,6932079.0,USA,3,2,2361,13913,16274,0
Consumers,5300000.0,USA,1,3,0,12101,12101,0
Mobile|Mobility,1667171.0,DEU,2,1,466,16170,16636,0
Apps,125000.0,USA,2,3,242,16191,16433,0
Automotive,1320000.0,USA,2,2,288,15979,16267,0
Collaborative Consumption|Information Technology|Public Transportation|Transportation|Web Development,10100000.0,IRL,13,4,2989,13573,16562,0
Games,3500000.0,GBR,1,1,0,15784,15784,0
Biotechnology,4381848.0,USA,7,13,2752,13909,16661,0
Biotechnology,2050158.0,USA,2,1,816,14722,15538,0
Consumer Internet,35000000.0,PHL,2,4,301,16182,16483,0
Education,17100000.0,USA,3,2,329,15986,16315,0
Collaboration|Software,16461305.0,USA,8,7,2241,13551,15792,0
Curated Web|E-Commerce|Fashion|Marketplaces|Startups,1625900.0,FRA,2,3,304,15522,15826,0
Apps|Internet|Mobile,2400000.0,USA,1,8,0,15944,15944,0
Aerospace|Online Rental|Peer-to-Peer|Tourism|Travel,16390.0,FRA,1,1,0,16529,16529,0
Hospitality,5000000.0,USA,1,1,0,15959,15959,0
Biotechnology,150000.0,USA,1,3,0,15957,15957,0
Biotechnology,2250000.0,USA,1,1,0,15769,15769,0
Curated Web,6800000.0,SGP,2,10,378,16022,16400,0
Internet|Transportation|Travel,350000.0,ARE,1,2,0,16708,16708,0
Environmental Innovation|Mobility|Peer-to-Peer|Public Transportation,10000000.0,DEU,4,4,1090,14457,15547,1
Big Data Analytics|Cars|Direct Sales|E-Commerce,48000000.0,RUS,3,13,268,16371,16639,0
Enterprise Software,14500000.0,USA,2,4,291,16415,16706,0
Clean Technology,300000000.0,USA,1,1,0,15989,15989,0
Mobile|Wireless,42000000.0,USA,3,12,1407,13368,14775,0
E-Commerce,1593610.0,ESP,3,2,463,15522,15985,0
Technology,12300000.0,USA,2,7,245,12090,12335,0
Oil & Gas,6000000.0,USA,1,1,0,11740,11740,1
Public Transportation|Shared Services,2000000.0,MEX,1,4,0,16166,16166,0
Apps|Entertainment|Internet,450000.0,GBR,1,1,0,16468,16468,0
Cars|Portals|Shopping,350000.0,MYS,1,2,0,16671,16671,0
Consumer Goods|Fitness|Health and Wellness,1036284.0,USA,2,2,147,16472,16619,0
Internet,3290868.93565986,GBR,1,7,0,16647,16647,0
Finance|Finance Technology|FinTech|Mobile|Mobile Payments|NFC|Payments|Technology|Transaction Processing,8318183.0,CAN,2,1,350,15978,16328,0
Software,8698151.0,BEL,2,4,967,15253,16220,0
Clean Energy|Gas|Geospatial|Gps|Maps|Mobile|Oil|Real Time|Search|Security|Tracking|Web Development,7430899.0,USA,4,2,3276,12418,15694,0
Document Management|Enterprises|Enterprise Software|File Sharing|Realtors|Storage|Transaction Processing,1230000.0,USA,1,2,0,15657,15657,1
Finance|Mobile,1313000.0,USA,4,10,762,15309,16071,0
Fashion,40000.0,USA,1,1,0,15940,15940,0
Biotechnology,2670000.0,SWE,1,2,0,13264,13264,1
3D Printing|Electronics|Printing,110000.0,USA,3,5,669,16040,16709,0
Health Care,30000000.0,USA,2,6,679,14678,15357,0
Health Care,600000.0,ISR,1,1,0,13248,13248,0
Health Care,20000000.0,ISR,3,6,636,15371,16007,0
Biotechnology,6350000.0,USA,1,1,0,13208,13208,0
Biotechnology,15800000.0,USA,4,4,665,15901,16566,0
E-Commerce|Electronics|Furniture|Online Shopping,25000.0,SGP,1,1,0,12418,12418,0
Business Intelligence|Data Visualization|Enterprise Software|Location Based Services|Maps|Open Source,31000000.0,USA,2,7,365,16323,16688,0
B2B|Indoor Positioning|Location Based Services|Maps|Mobile Analytics,646000.0,USA,3,5,348,16323,16671,0
Automotive|Cars|Motors,30200000.0,IND,1,3,0,16356,16356,0
Apps|Shopping|Travel,30000.0,CAN,1,1,0,16495,16495,0
Cars|Search,50000.0,SRB,1,1,0,16149,16149,0
Automotive|Cars|Search,123005.0,FRA,1,1,0,14791,14791,0
Auto|Automotive|Cars,10850000.0,USA,4,26,913,14396,15309,0
Automotive|Consumer Internet|Curated Web,9391205.12245463,GBR,3,5,712,15706,16418,0
Health Care,16925000.0,USA,2,1,344,14790,15134,1
Online Shopping|Shoes|Women,50000.0,USA,1,1,0,14903,14903,0
Real Estate,9500000.0,IND,1,1,0,15873,15873,0
Web Hosting,99614399.0,USA,2,1,306,14433,14739,0
Mobile,18799999.0,USA,3,5,1199,13136,14335,1
E-Commerce,1339050.0,GBR,1,1,0,15775,15775,0
Hospitality,1200000.0,USA,1,9,0,15517,15517,0
Personalization|Reviews and Recommendations|Social Media,2800000.0,ITA,3,3,1765,14184,15949,0
Apps|Mobile|Software,2000000.0,CAN,1,1,0,13149,13149,0
Environmental Innovation|Gas|Semiconductors,7720000.0,GBR,3,8,1380,13345,14725,0
Information Technology,50000.0,USA,1,1,0,13373,13373,0
Software,39064207.0,USA,7,7,1521,13830,15351,0
Chat|Cloud Computing|Customer Service|Email|Enterprises|Software,2000000.0,NLD,1,3,0,16168,16168,0
Software,350000.0,USA,2,2,329,15742,16071,0
Document Management|Legal,570000.0,USA,2,1,19,15949,15968,0
Enterprise Software,4000000.0,USA,1,2,0,13363,13363,0
Curated Web|Internet,13300000.0,CAN,2,5,1034,12768,13802,1
Legal,8800000.0,USA,2,21,490,15979,16469,0
CRM|Legal|Software,504603.0,BGR,5,9,640,15796,16436,0
Bitcoin|Cryptocurrency|Software|Virtual Currency,3750000.0,USA,2,5,84,16604,16688,0
Finance,35000000.0,USA,2,3,151,14214,14365,0
Application Platforms|Gambling|Games|Mobile|Software,2445000.0,USA,2,2,764,15340,16104,0
Finance|Financial Services|Investment Management|Personal Finance|Social Investing|Wealth Management,2000000.0,DEU,2,7,352,16314,16666,0
E-Commerce|Flash Sales,3900000.0,PHL,3,1,1282,15095,16377,0
Finance,30320000.0,USA,4,4,1437,12086,13523,1
E-Commerce,4550000.0,IND,2,1,866,15889,16755,0
Analytics|Business Intelligence|Business Services|Loyalty Programs,452836.0,NLD,3,1,258,15954,16212,0
Personal Finance,150000.0,USA,1,1,0,16146,16146,0
Cars|Direct Sales|Payments,650780.0,CHE,4,2,920,15675,16595,0
Apps|Casual Games|Games|iPhone|Location Based Services|Mobile|Mobile Games|Social Games,1070000.0,RUS,4,7,595,15354,15949,0
E-Commerce|Incentives|Loyalty Programs|Payments,43000000.0,USA,6,18,2773,13879,16652,0
Services,5000000.0,USA,1,1,0,12090,12090,0
Apps|QR Codes,12500.0,HKG,1,1,0,16252,16252,0
Coupons|Games|Social Media,120000.0,USA,1,1,0,15975,15975,0
Analytics|Application Platforms|Big Data|Developer APIs|Development Platforms|Open Source,32500000.0,USA,3,12,1380,15364,16744,0
E-Commerce|Lifestyle|Retail,69950000.0,USA,3,34,523,16085,16608,0
Software,4450000.0,GBR,2,4,1176,12877,14053,0
Computers|Internet|Networking,120000000.0,USA,1,5,0,11745,11745,0
E-Commerce,4848804.0,GBR,1,1,0,16055,16055,0
Software,15000000.0,USA,2,4,883,12325,13208,1
Advertising|Billing|Content|Content Syndication|Enterprises|Publishing|Video,1810380.0,DEU,2,2,676,14914,15590,0
Augmented Reality,15000000.0,USA,1,1,0,16666,16666,0
Enterprise Software,10000000.0,CAN,1,3,0,11501,11501,1
Analytics|Big Data Analytics|Media|Music|Software|Television|Video Streaming,631720.0,BEL,1,6,0,14532,14532,1
Digital Media|Entertainment Industry|Performing Arts|Professional Networking,94557.0,SGP,4,3,290,16205,16495,0
Software,53299997.0,USA,6,18,2220,12241,14461,1
Biotechnology,36412587.0,USA,9,6,2320,14323,16643,0
Biotechnology|Medical|Medical Devices,1408763.0,USA,4,2,553,14944,15497,0
Health and Wellness|Technology,180999999.0,USA,5,18,1491,13970,15461,1
Games,3100000.0,USA,2,5,479,13149,13628,1
E-Commerce|Mobile Commerce|Payments|Retail,1429894.0,KOR,2,4,568,15812,16380,0
Hardware + Software,4920000.0,FRA,1,3,0,14666,14666,0
Biotechnology,119523736.0,USA,9,17,1901,14624,16525,1
Clean Technology,250000.0,USA,1,1,0,14706,14706,0
Fitness|Health and Wellness|Health Care,1250000.0,USA,1,5,0,16598,16598,0
Real Estate,4500000.0,USA,1,3,0,13636,13636,0
E-Commerce|Mobile|Retail,7800000.0,USA,2,3,257,15038,15295,0
Data Privacy|Enterprise Software|IT Management,8000000.0,USA,1,1,0,16666,16666,0
Biotechnology,105114496.0,USA,9,24,3409,13188,16597,0
Consulting,1096194.0,USA,5,2,1084,15349,16433,0
Games,10000000.0,USA,1,2,0,13795,13795,0
Application Platforms|Development Platforms,6000000.0,USA,1,2,0,12465,12465,0
Automotive,72400000.0,USA,3,13,1028,11697,12725,0
Cloud Infrastructure|Health and Wellness|Health Care Information Technology|mHealth|Mobile|Software,6044998.0,USA,3,9,678,15856,16534,0
Biotechnology,2000000.0,AUS,1,1,0,12858,12858,1
Enterprise Software,2000000.0,USA,1,1,0,14965,14965,1
Curated Web|Services|Transportation,20000.0,USA,1,1,0,14761,14761,0
Travel,2000000.0,JPN,1,2,0,16162,16162,0
Enterprise Software,6500000.0,USA,2,3,312,15611,15923,0
Internet,94825226.0,NLD,2,9,308,16337,16645,0
Data Security|Network Security|Virtualization,12000000.0,USA,2,2,218,15693,15911,0
Android|iPad|iPhone|Mobile|Productivity Software|Synchronization,9300000.0,USA,2,2,258,14762,15020,0
Curated Web,3500000.0,USA,1,1,0,15029,15029,0
Curated Web|Internet|Nonprofits,2599984.0,USA,2,1,1509,14749,16258,0
Curated Web|File Sharing|Software,5500000.0,USA,1,6,0,14980,14980,0
Apps|Augmented Reality|Mobile,12500.0,HKG,1,1,0,16252,16252,0
Advertising|Apps|Augmented Reality|Cloud Computing|Developer Tools|Enterprise Software|Image Recognition|Publishing|Retail|SaaS|Sales and Marketing|Visual Search,1520580.0,ESP,2,2,0,15475,15475,0
Analytics|Application Performance Monitoring|Big Data|Internet Infrastructure,27265055.0,USA,6,5,2058,14587,16645,0
E-Commerce,1550000.0,MYS,3,5,1125,15553,16678,0
Advertising|News|Social Media,2600000.0,NOR,2,3,5,13941,13946,0
Databases|Internet Service Providers|Services|Video,75000000.0,USA,1,10,0,11710,11710,1
Curated Web|Hospitality|Marketplaces|Specialty Foods,25000.0,USA,1,1,0,15495,15495,0
Biotechnology,867685.0,DEU,1,2,0,14988,14988,0
Social Media,2743500.0,USA,3,4,952,14593,15545,0
Internet,1100000.0,USA,1,4,0,16730,16730,0
Software,1830000.0,DNK,1,1,0,13627,13627,0
Nonprofits,163387.0,USA,1,1,0,16113,16113,0
Biotechnology,6361722.0,USA,2,1,385,15194,15579,0
Charity|Non Profit|Services,100000.0,USA,1,1,0,16007,16007,0
Social Media,40000.0,MYS,1,1,0,15379,15379,0
Apps,100000.0,USA,1,1,0,16375,16375,0
Network Security,20000000.0,ISR,1,2,0,16735,16735,0
Big Data|Predictive Analytics|Software,15500000.0,USA,2,2,757,14522,15279,1
Brand Marketing|Games|Mobile|Sales and Marketing,50000.0,USA,2,1,545,15645,16190,0
Big Data|E-Commerce|Internet|Mobile|Social Media,4000000.0,USA,1,7,0,16672,16672,0
Facebook Applications|Nonprofits|Politics,16350000.0,USA,3,8,1386,13514,14900,1
Hospitality,64100000.0,USA,3,3,741,15961,16702,0
Semiconductors,68500000.0,USA,4,11,3402,13269,16671,0
E-Commerce,637850.0,DEU,1,1,0,14184,14184,0
Curated Web|Delivery|Hospitality,15000000.0,USA,2,9,482,15706,16188,1
Health and Wellness,5000000.0,USA,2,1,3610,13139,16749,0
Bio-Pharm|Biotechnology|Nanotechnology,5000000.0,DEU,1,2,0,12817,12817,0
Nanotechnology,1400000.0,USA,1,1,0,16268,16268,1
Semiconductors,92989194.0,USA,4,9,2782,12265,15047,1
Analytics,6289540.0,GBR,1,1,0,14956,14956,0
Design,10000000.0,CHN,1,1,0,13848,13848,0
Health Care,40468738.0,USA,7,8,2558,13557,16115,0
Web Hosting,38000000.0,USA,2,5,743,12326,13069,0
EdTech|Education,40000.0,USA,2,2,26,15652,15678,0
Analytics|Big Data|Enterprise Software,28000000.0,USA,2,5,275,16363,16638,0
Cloud Data Services|Data Integration|Enterprise Software|Software,250000.0,USA,1,1,0,14488,14488,0
Analytics,11150000.0,USA,2,2,77,16671,16748,0
E-Commerce|Wholesale,3500000.0,IND,1,2,0,15461,15461,0
Employer Benefits Programs|Health and Insurance|Health and Wellness,30000000.0,USA,1,6,0,11809,11809,0
Messaging,2000000.0,USA,2,3,196,14404,14600,1
Games|Video,23000000.0,CHN,3,3,1309,13879,15188,0
CRM|Enterprise Software,3500000.0,USA,1,5,0,15022,15022,0
Curated Web,36749700.0,FRA,1,2,0,14881,14881,0
Games|Virtual Worlds,66300000.0,ISL,3,2,2135,14616,16751,0
Environmental Innovation|Remediation,2000000.0,USA,1,1,0,15544,15544,0
Mobile,66220000.0,USA,1,3,0,13626,13626,0
Biotechnology|Health Diagnostics,1610000.0,USA,2,1,45,15310,15355,0
Enterprise Software|Networking|Software,50000000.0,USA,3,3,705,14726,15431,1
Biotechnology,3000000.0,USA,1,2,0,13857,13857,0
Information Technology|Logistics|Mobile Software Tools,45000.0,USA,3,3,524,16071,16595,0
Cloud Computing|Content Delivery|Internet|Security|Web Hosting,96500000.0,USA,1,3,0,13848,13848,0
Content|Content Delivery|Video Streaming|Web Hosting,160000.0,CZE,1,1,0,15792,15792,0
Consulting,6340000.0,CHN,2,4,2009,13422,15431,0
E-Commerce,6500000.0,CHN,1,1,0,14184,14184,0
Software,199000.0,GBR,1,2,0,13942,13942,0
Technology,50000.0,USA,1,1,0,13348,13348,0
Software,34000000.0,IND,2,7,556,13734,14290,0
Software,2398464.0,USA,4,7,1970,12784,14754,0
Hardware + Software,8500000.0,USA,2,5,451,12899,13350,0
Biotechnology,96287638.0,USA,5,6,1840,14547,16387,0
Knowledge Management|Online Shopping|Writers,1000000.0,IND,1,1,0,15675,15675,0
Financial Services,75000000.0,USA,1,3,0,15812,15812,0
Enterprise Software,81000000.0,USA,5,29,2836,11743,14579,1
Biotechnology,7000000.0,USA,1,1,0,12481,12481,1
Cloud Computing|Content Delivery|Enterprise Software|Software,14700000.0,USA,2,2,1251,15197,16448,0
Manufacturing,13660000.0,FRA,1,1,0,13300,13300,0
Education,2500000.0,CHN,2,2,2342,11231,13573,0
Software|Virtualization,4500000.0,ISR,1,1,0,13605,13605,0
Manufacturing,4000000.0,USA,1,1,0,13868,13868,0
Biotechnology,4400000.0,USA,1,7,0,14476,14476,1
Software,3954556.0,GBR,1,1,0,15729,15729,0
Biotechnology,96876867.0,USA,6,21,2097,13728,15825,1
Biotechnology,4000000.0,USA,1,1,0,16153,16153,0
Android|Apps|Celebrity|Chat|Entertainment|iPhone|Messaging|Mobile|Professional Services|Sports,3135780.0,USA,2,1,761,14610,15371,0
Big Data|Big Data Analytics|Predictive Analytics|Retail|Retail Technology,5050000.0,USA,2,2,566,16045,16611,0
Simulation|Skill Assessment,3733834.0,SWE,1,1,0,11495,11495,0
Semiconductors,68200000.0,ISR,6,17,3950,12784,16734,0
Business Intelligence|Services,9100000.0,USA,1,2,0,12444,12444,1
Enterprise Software,15000000.0,USA,1,1,0,15049,15049,0
Services|Telecommunications|Wireless,18000000.0,USA,1,5,0,11737,11737,0
E-Commerce,2000000.0,USA,1,3,0,16106,16106,0
Semiconductors,2000000.0,USA,1,3,0,13937,13937,1
Accounting|Android|Chat|CRM|Enterprise Software|Home & Garden|iPhone|Mobile|Sales and Marketing|Security|Software|Tablets,173000000.0,MYS,2,2,1595,11238,12833,0
Software,560000.0,USA,1,1,0,13432,13432,0
Clean Technology|Recycling|Retail|Retail Technology|Technology|Wireless,2500000.0,USA,2,1,731,14975,15706,1
Biotechnology,85249999.0,USA,6,24,1747,13149,14896,1
Biotechnology,4840000.0,ISR,3,1,727,15841,16568,0
Biotechnology,390397.0,GBR,1,1,0,16008,16008,0
Biotechnology,118001649.0,GBR,5,9,2797,13602,16399,0
Hardware + Software|Health Care Information Technology|Mobile Health|Telecommunications,5620000.0,USA,3,4,915,15095,16010,0
Biotechnology|Health Care|Therapeutics,85060000.0,USA,5,1,1582,14475,16057,1
Health and Wellness,1089789.0,CHL,2,1,704,15771,16475,0
Biotechnology,172013496.0,USA,12,22,3633,13124,16757,1
Advertising|App Marketing|Auto|Automotive|Cars|Marketplaces|Mobile|SMS,540000.0,USA,5,1,1636,14883,16519,0
Biotechnology,9540000.0,SWE,1,4,0,13130,13130,0
Biotechnology,11051860.0,DEU,1,1,0,13292,13292,0
Biotechnology,115819.0,GBR,1,1,0,15533,15533,0
Software,3150000.0,GBR,1,1,0,13537,13537,0
Biotechnology|Pharmaceuticals,19638485.0,USA,5,3,2824,13886,16710,1
Biotechnology|Life Sciences|Pharmaceuticals,17367286.0,FRA,3,8,1673,11262,12935,1
Clean Technology|Medical|Services,7012307.0,SWE,1,2,0,12564,12564,0
Clean Technology,11200000.0,ISR,2,5,1426,13901,15327,0
Biotechnology,96244927.0,USA,9,10,3410,12914,16324,0
Health Care|Medical Devices,44424979.0,USA,3,11,1629,14080,15709,1
Biotechnology,115425741.13233799,ESP,3,17,880,13757,14637,0
Public Relations,5700000.0,ISR,1,6,0,12860,12860,1
Coupons|Digital Media|Mobile,26000000.0,USA,3,6,1135,12784,13919,1
Clean Technology,62125000.0,CAN,3,12,750,13081,13831,0
Biotechnology|Technology,1047627.77785053,IRL,1,3,0,13559,13559,0
Curated Web,2000000.0,USA,2,6,410,14777,15187,1
Health Care,5000000.0,USA,1,1,0,15857,15857,0
Diabetes|Health Care,48268413.0,GBR,1,8,0,15009,15009,0
Mobile|Web Tools,750000.0,ISR,3,4,2632,13879,16511,0
Health Diagnostics|Medical,1000000.0,USA,1,1,0,16190,16190,0
Biotechnology,2573200.0,ITA,1,2,0,16149,16149,0
Diagnostics,11200000.0,USA,1,2,0,13801,13801,1
Mobile,4700000.0,ISR,2,4,965,15727,16692,0
Biotechnology|Health Care|Health Diagnostics,12800000.0,USA,6,7,1470,14365,15835,0
Market Research,27486869.0,JPN,1,1,0,16133,16133,0
Advertising|Mobile,41000000.0,GBR,5,11,3927,11048,14975,0
Biotechnology,7273407.0,GBR,3,10,931,12815,13746,1
Health Care,3845100.0,SWE,1,2,0,13284,13284,0
Computers,10500000.0,USA,1,1,0,16415,16415,0
Manufacturing,3636603.0,GBR,1,3,0,16036,16036,0
Environmental Innovation,5000000.0,CAN,1,3,0,16316,16316,0
Games,8014076.0,USA,5,1,1857,13579,15436,0
Biotechnology,111641664.0,USA,4,4,1163,14726,15889,1
Biotechnology,10016030.0,USA,3,2,819,13704,14523,0
Biotechnology|Medical|Therapeutics,7000000.0,USA,1,4,0,13691,13691,0
Mobile,4000000.0,ISR,1,1,0,13331,13331,0
Biotechnology,387000.0,FRA,1,2,0,14046,14046,0
Telecommunications,24500000.0,SGP,2,3,0,16771,16771,0
Hardware + Software,17517561.0,USA,3,2,1335,14340,15675,0
Messaging|Mobile|Networking|Polling|SMS|Social Media,1400000.0,USA,1,2,0,15756,15756,0
Biotechnology,3400000.0,USA,1,4,0,11936,11936,1
Medical|Pharmaceuticals|Therapeutics,63172041.0,DEU,2,12,746,11382,12128,0
Biotechnology,13500000.0,USA,1,1,0,15757,15757,0
Biotechnology,15800000.0,IND,1,1,0,14890,14890,0
Software,18890000.0,GBR,3,9,1646,12996,14642,0
Biotechnology,20841869.0,USA,2,2,2908,12112,15020,0
Internet|Investment Management|Messaging,423942.0,COL,5,5,792,15218,16010,0
Hardware + Software,64395181.0,GBR,9,36,4717,11611,16328,0
Biotechnology,2858200.0,USA,7,1,2665,13657,16322,0
Biotechnology,87500000.0,GBR,2,7,720,15979,16699,1
Biotechnology,46271386.0,USA,3,5,2223,14371,16594,0
Advertising|App Marketing|Information Services|Information Technology|Mobile,10200000.0,USA,3,6,1332,14390,15722,0
Enterprise Software,1550000.0,IRL,1,2,0,12904,12904,1
Mobile,35230812.0,ISR,4,10,1812,13403,15215,0
Entertainment|Productivity|Systems,3300000.0,CAN,1,2,0,16469,16469,0
Technology,3000000.0,USA,1,6,0,11338,11338,0
Curated Web,19185000.0,USA,3,6,2142,12192,14334,1
Advertising,500000.0,ISR,1,1,0,15640,15640,0
Biotechnology|Health Care,108119996.0,USA,5,6,2404,13239,15643,1
Pharmaceuticals,10000000.0,USA,1,4,0,13860,13860,0
Biotechnology,36253675.0,USA,6,6,1099,14410,15509,0
Finance,4663524.0,GBR,1,1,0,15504,15504,0
Computer Vision,10000000.0,USA,1,3,0,16714,16714,0
Enterprise Software|Security,3378281.0,GBR,2,1,2742,13939,16681,0
Software,9500000.0,USA,1,2,0,16337,16337,0
Software,100000.0,CHN,2,3,304,14822,15126,0
Semiconductors,14000000.0,CHN,2,5,2252,12935,15187,0
Life Sciences|Nonprofits|Open Source,7031480.0,USA,1,1,0,15706,15706,0
Cloud Computing|Information Technology|Outsourcing|SaaS,1000000.0,USA,1,2,0,15796,15796,1
Curated Web|Events|Local|Local Search|Maps|Natural Language Processing|Neuroscience|Web Tools,10400000.0,USA,5,7,1552,13545,15097,0
Enterprise Software,16500000.0,USA,2,4,144,13085,13229,0
Computers|Software,9250000.0,USA,1,3,0,10925,10925,0
Software,2591800.0,AUT,1,4,0,12874,12874,0
Home Automation,27181.0,DEU,1,1,0,16040,16040,0
Information Technology|Services,15064175.0,USA,4,7,1630,12934,14564,0
Biotechnology,39475259.0,USA,10,10,2240,13836,16076,0
Software,28000000.0,USA,2,9,867,12079,12946,1
Software,796205.0,USA,1,1,0,14875,14875,0
Collaboration|Project Management|Software,7000000.0,USA,1,1,0,13985,13985,1
Software,10234678.0,USA,2,1,910,15600,16510,0
Business Services|Energy Management|Home Automation|Home & Garden|Home Owners|Industrial Energy Efficiency|Location Based Services|Network Security|Physical Security|Professional Services|Security|Video,10000000.0,USA,2,1,400,14502,14902,0
Certification Test|Online Education|Skill Assessment,941000.0,GBR,1,1,0,14306,14306,0
Semiconductors,20000000.0,USA,1,7,0,13136,13136,1
E-Commerce|Wholesale,115000.0,MEX,3,7,551,15730,16281,0
Biotechnology,5000000.0,IND,1,1,0,15889,15889,0
Software,139050000.0,USA,4,12,1896,11366,13262,1
Mobile|Networking|Technology,26835204.0,USA,6,3,1555,14756,16311,0
Software,95899999.0,USA,6,14,3507,12773,16280,0
Analytics|Big Data Analytics|Business Intelligence|Data Mining|Data Visualization|Ediscovery|Visualization,6500000.0,USA,2,2,1173,13909,15082,0
Identity Management|SaaS|Security,94000000.0,USA,5,19,3610,12600,16210,0
Mobile,500000.0,USA,1,1,0,14222,14222,0
Advertising|Media|Sales and Marketing|Software|Technology,52500000.0,USA,2,2,1602,14973,16575,0
Developer APIs|Distribution|Internet,150000.0,RUS,1,1,0,15788,15788,0
Shopping,250000.0,PRI,1,1,0,13348,13348,0
Software,27000000.0,USA,1,7,0,11344,11344,0
Health Care,20000000.0,USA,1,2,0,14896,14896,0
Web Hosting,22000000.0,USA,4,17,1142,15516,16658,0
Security,16000000.0,USA,2,4,2130,12975,15105,1
Software,5040000.0,USA,1,3,0,13027,13027,1
Education,688000.0,IND,1,1,0,13592,13592,0
Design|Hardware + Software|Manufacturing|Medical Devices,1438604.0,USA,3,2,1073,15522,16595,0
Analytics|Artificial Intelligence|Enterprise Search|Natural Language Processing,4979900.0,AUT,3,5,706,16031,16737,0
Biotechnology,25000000.0,USA,2,8,105,15391,15496,1
Biotechnology,77700000.0,USA,2,7,122,13542,13664,1
Biotechnology,12400000.0,USA,2,4,836,13682,14518,0
Mobile,13360000.0,USA,4,7,1566,13239,14805,1
Clean Technology|Energy Management|Wind,2000000.0,LUX,1,1,0,15159,15159,0
Manufacturing,16227.0,NLD,1,1,0,16525,16525,0
Clean Technology,5569650.0,NLD,1,1,0,15527,15527,0
Health Care,75790328.0,USA,8,8,2960,13572,16532,0
Android|Enterprise Security|Internet of Things|Mobile Security,20000.0,USA,1,2,0,16010,16010,0
Semiconductors,2500000.0,JPN,1,1,0,15891,15891,0
Health Care Information Technology|Healthcare Services|Medical Devices,2712000.0,USA,6,5,1349,15177,16526,0
Biotechnology,60943184.0,USA,3,3,837,15435,16272,1
Biotechnology,71500000.0,USA,3,10,2289,12635,14924,1
Health Care,5924066.0,USA,1,3,0,15625,15625,0
Clean Technology|Farming,98000000.0,USA,2,1,2356,13783,16139,1
Agriculture,75000000.0,USA,1,9,0,13783,13783,0
Biotechnology,746000.0,USA,1,1,0,16615,16615,0
Biotechnology,23438812.0,USA,6,1,1878,14622,16500,0
Hardware + Software|Mobile|Photo Sharing|Wireless,44525.0,JPN,2,4,764,14259,15023,0
Email Newsletters|Social Media,20000.0,USA,1,1,0,16436,16436,0
Analytics,20300000.0,USA,3,4,1588,12263,13851,0
Biotechnology,6530638.0,USA,6,6,2059,14535,16594,0
Public Relations,2600000.0,USA,1,1,0,13259,13259,0
Health and Wellness,50000.0,USA,2,1,410,15757,16167,0
Education,40000.0,CHL,1,1,0,15408,15408,0
Software,19000000.0,USA,2,7,1751,13710,15461,0
Hardware + Software,4940000.0,USA,2,4,800,13068,13868,1
Education,13932859.0,USA,3,1,2475,14004,16479,0
Information Technology,501668.0,IRL,1,2,0,16394,16394,0
Software,275000.0,USA,3,2,2133,14362,16495,0
Enterprise Software,7210210.0,USA,4,2,1269,14116,15385,1
Information Services|SaaS|Security|Services,12507186.0,GBR,5,9,1516,14675,16191,0
Personalization|Real Time|SaaS|Software,7000000.0,USA,1,2,0,14082,14082,0
Software,3750000.0,USA,1,1,0,15307,15307,0
Health Care,151700000.0,USA,11,23,3049,13483,16532,1
Health Care,30000000.0,USA,1,1,0,16252,16252,1
Biotechnology,2272877.0,GBR,1,2,0,15862,15862,0
Health Care,26899999.0,USA,5,2,1822,14580,16402,0
Biotechnology,23300002.0,USA,7,6,1596,14113,15709,0
Knowledge Management|Online Education|Virtual Worlds,6000000.0,USA,2,2,310,15805,16115,0
Embedded Hardware and Software|Internet of Things|M2M|Technology,697080.0,IRL,1,3,0,16566,16566,0
Bio-Pharm,20000000.0,USA,2,5,537,11607,12144,0
Biotechnology,53000000.0,USA,2,4,359,16203,16562,0
Biotechnology,14028000.0,DEU,2,6,538,14642,15180,0
Software,4500000.0,USA,1,3,0,12797,12797,0
Career Planning|Travel,13600000.0,USA,3,5,1048,13149,14197,0
Software,13000000.0,USA,2,1,1407,15068,16475,0
Market Research|Services,60000000.0,USA,1,1,0,12363,12363,0
Education,4000000.0,USA,1,1,0,15737,15737,0
Biotechnology,44300000.0,USA,2,7,1114,11324,12438,1
Electronics|Gas|Water,298796.0,GBR,1,1,0,16314,16314,0
3D|3D Technology|Augmented Reality|Marketplaces|Technology|Virtual Worlds,200000.0,LTU,2,3,355,15757,16112,0
Software,6117000.0,USA,4,4,2326,13787,16113,0
Construction|Infrastructure|Infrastructure Builders,300000000.0,USA,1,1,0,16582,16582,0
Advertising|Search,96031968.0,USA,9,13,2280,13453,15733,0
Biotechnology,1000000.0,USA,1,4,0,16556,16556,0
Energy|Energy Efficiency|Energy Management|Internet of Things,1300000.0,USA,3,2,262,16294,16556,0
Food Processing,10000000.0,IND,1,4,0,16694,16694,0
Software,1100000.0,USA,2,3,0,14523,14523,1
Bitcoin|Development Platforms|Finance Technology,73700000.0,USA,4,30,616,16071,16687,0
E-Commerce,3180000.0,USA,1,2,0,14823,14823,0
Consulting,10000000.0,USA,1,1,0,15504,15504,0
Curated Web|Internet|Marketplaces|Peer-to-Peer,7200000.0,USA,2,15,389,15904,16293,0
News,5000000.0,IND,1,2,0,14235,14235,0
Clean Technology|Environmental Innovation|Technology,2000000.0,ISR,1,1,0,16623,16623,0
Mobile|Software|Wireless,500000.0,USA,1,4,0,16457,16457,1
Advertising|Advertising Platforms|Mobile,749999.0,USA,2,9,57,16630,16687,0
Charter Schools|Education|High Schools|Software|Teachers,1300000.0,USA,1,3,0,15587,15587,1
E-Commerce|Education,750000.0,USA,3,7,394,15607,16001,0
Fantasy Sports|FreetoPlay Gaming|Game|Games|MMO Games|Online Gaming|Social Games|Social Network Media|Sports,14500000.0,USA,2,3,53,14070,14123,1
Curated Web|Developer APIs|Developer Tools|Development Platforms,4600000.0,USA,3,21,1048,14147,15195,0
Games|Internet|Moneymaking,703359.0,SWE,1,1,0,16667,16667,0
Health and Wellness,30500000.0,TWN,3,8,1066,13057,14123,0
Health Care,938000.0,GBR,1,5,0,13440,13440,0
Biotechnology,1561320.0,GBR,1,2,0,14837,14837,0
Information Services,50000.0,USA,1,1,0,16455,16455,0
Celebrity|Consumer Goods|Mobile,25000.0,USA,1,1,0,16071,16071,0
Social Media,15000000.0,CHN,1,4,0,15461,15461,0
Education|Mobile Health|Software,1400000.0,USA,1,4,0,16091,16091,0
Education|Health Care|Healthcare Services|Hospitals,48000000.0,USA,6,14,2496,13757,16253,1
Curated Web|Internet|Non Profit,42000000.0,USA,3,29,1063,15350,16413,0
Sales and Marketing|User Experience Design,20000.0,BLR,1,1,0,16283,16283,0
Manufacturing,10000000.0,CHN,1,1,0,13879,13879,0
Clean Technology|E-Commerce|Environmental Innovation|Game Mechanics|Gamification|Recycling|Sustainability,1500000.0,DEU,1,2,0,16124,16124,0
Payments,4250000.0,USA,3,8,242,16164,16406,0
Communities|Innovation Management,435924.541461873,IRL,1,8,0,16638,16638,0
Advertising|Digital Media|Technology,18628333.0,CAN,4,14,875,14790,15665,1
Apps|Navigation,1210005.0,KOR,2,2,186,16296,16482,0
Curated Web,6084516.0,USA,2,2,605,14534,15139,1
Software,12000000.0,USA,2,1,932,15084,16016,0
Biotechnology,37787000.0,USA,3,9,851,15827,16678,0
Engineering Firms|Real Time|Software,286509.0,IND,1,1,0,15796,15796,0
Banking|Financial Services,50000000.0,USA,1,1,0,16665,16665,0
Auctions|Building Products|E-Commerce|Marketplaces|Online Shopping|Optimization|Promotional|Retail Technology|SaaS|Search,75000000.0,USA,4,19,1688,12439,14127,1
E-Commerce,5152266.0,KOR,2,7,367,15886,16253,0
Enterprise Software|SaaS,13304657.0,USA,2,4,350,15084,15434,0
Analytics|Big Data|Big Data Analytics|Video,100000.0,USA,4,3,425,15857,16282,0
Games,1600000.0,USA,1,1,0,13592,13592,0
Advertising|Big Data Analytics|Brand Marketing|E-Commerce|Lead Generation,3763106.7296892,IRL,1,2,0,16723,16723,0
Software,31500000.0,CHN,1,1,0,13112,13112,0
Software,26500000.0,USA,1,4,0,11540,11540,1
Distribution,300000.0,IND,1,1,0,16252,16252,0
Pharmaceuticals,35625606.0,USA,4,5,1830,14816,16646,0
Travel,158730.0,CHN,1,1,0,15340,15340,0
Crowdsourcing|Software,1500000.0,CAN,1,1,0,15545,15545,0
Games|Teenagers|Virtual Worlds,530000.0,FRA,1,3,0,13942,13942,0
Clean Technology,700000.0,USA,1,1,0,13970,13970,0
Biotechnology,100000.0,USA,1,1,0,13213,13213,0
Hardware + Software,600000.0,USA,1,1,0,13963,13963,0
Billing|Enterprise Software,6170000.0,USA,3,3,883,15614,16497,0
Automotive|Electric Vehicles|Infrastructure,5133089.0,GBR,2,3,351,15914,16265,0
Biotechnology,2462283.0,GBR,1,2,0,16008,16008,0
Energy Management|Mobile Infrastructure|Wireless,3400000.0,GBR,3,8,578,16164,16742,0
Public Transportation|Transportation,3000000.0,USA,1,15,0,16547,16547,0
Nonprofits,503176.0,ITA,2,3,180,16042,16222,0
Specialty Foods,1500000.0,USA,1,1,0,13525,13525,0
Consulting|Health Care|Information Technology,41250.0,USA,1,1,0,16071,16071,0
Biotechnology,34000000.0,USA,1,1,0,15246,15246,1
Brokers|Finance,6178766.0,USA,1,2,0,14613,14613,1
Health Diagnostics|Medical|Therapeutics,1600000.0,USA,1,2,0,15734,15734,0
Business Intelligence|Productivity|Sales Automation|Software,1750000.0,USA,2,7,687,15679,16366,0
Retail,80399977.0,USA,1,1,0,16084,16084,0
Analytics|Business Intelligence|Business Services|Enterprises,6770000.0,USA,4,14,1333,14761,16094,0
Analytics|Real Time,32100000.0,USA,5,26,1708,14853,16561,0
Advertising|Apps|App Stores|Games|iPhone|Marketplaces|Monetization,21000000.0,USA,3,7,1247,15248,16495,0
Analytics|Collaboration|Curated Web|Data Visualization|Freemium|Mobile,4550000.0,USA,3,1,533,15847,16380,0
Venture Capital,30000000.0,USA,1,1,0,12478,12478,0
iPad|Software|Stock Exchanges|Web Development,850000.0,USA,1,2,0,16392,16392,0
Software,1500000.0,DEU,2,9,222,16450,16672,0
Doctors|Health Care|Mobile Health|Software,2950000.0,USA,3,5,540,15953,16493,0
Biotechnology,5100000.0,USA,2,2,1116,14487,15603,0
Biotechnology,25200000.0,USA,3,3,1709,14958,16667,0
Education|Internet,400000.0,CHN,2,3,325,16185,16510,0
Accounting|Finance,741084.0,GBR,1,2,0,16526,16526,0
Advertising|Social Media|Social Media Marketing|Startups,500000.0,USA,2,4,364,15462,15826,0
Leisure|Travel|Travel & Tourism,50000.0,PER,1,1,0,15675,15675,0
Messaging|News|Social Network Media|Sports|Twitter Applications,3000000.0,USA,5,10,763,15644,16407,0
E-Commerce|Retail|Social Bookmarking|Social Commerce|Social Media,125000.0,USA,1,4,0,15603,15603,0
Apps|Photography|Social Media,2050000.0,USA,2,4,237,16339,16576,0
Mobile,19218000.0,USA,4,23,1504,15156,16660,0
Social Media,2100000.0,USA,1,4,0,16421,16421,0
Collaboration|Enterprise Software|Task Management|Unifed Communications,2500000.0,USA,1,1,0,16552,16552,0
Games,40000.0,POL,1,1,0,15380,15380,0
Coffee|Services|Technology,400000.0,USA,1,1,0,15510,15510,0
Construction|SaaS|Software,300000.0,NOR,2,1,277,16190,16467,0
Big Data|Data Integration|Sponsorship,1770000.0,USA,4,3,896,15230,16126,0
Cloud Computing|Curated Web|Hospitality|Internet|Mobile|Online Reservations|SaaS|Travel|Travel & Tourism,1000000.0,CAN,1,4,0,16505,16505,0
Health and Wellness,70000.0,USA,2,2,16,15431,15447,0
Coupons|Finance|Hotels|Internet|Mobile|News|Social Media|Social Network Media|Technology,100000.0,USA,1,1,0,14975,14975,0
Artificial Intelligence|Communities|EdTech|Education|Online Gaming,750000.0,USA,1,11,0,16080,16080,0
Security,92000000.0,USA,3,5,1354,15257,16611,0
Biotechnology,20000000.0,USA,1,2,0,16659,16659,0
Enterprise Software,40000.0,CHL,1,1,0,15327,15327,0
Brand Marketing|Consumers|Curated Web|Finance|Groceries|Incentives|Mobile,2396606.0,GBR,1,4,0,16378,16378,0
Security,10200000.0,FRA,1,2,0,13514,13514,0
Enterprise Software,10100000.0,USA,2,2,493,14096,14589,0
Health Care,8816166.0,USA,3,2,1721,14558,16279,0
Advertising|Apps|Hardware|Internet of Things|Location Based Services|Mobile|Mobile Shopping|Proximity Internet|Retail|Shopping,2000000.0,USA,2,4,92,14730,14822,0
Developer APIs|Legal|Software|Startups,39120000.0,USA,3,19,454,16267,16721,0
E-Commerce|Online Reservations|Reviews and Recommendations,40000.0,CZE,2,2,700,15126,15826,0
Consumer Internet|Parenting|Payments,725000.0,USA,2,4,136,16398,16534,0
Apps|iPhone|Mobile|Psychology|Social Media,2500000.0,USA,1,4,0,15769,15769,0
China Internet|Craft Beer|Food Processing,150000.0,CHN,1,1,0,15706,15706,0
Photo Sharing,6790377.28090659,FRA,1,1,0,16604,16604,0
Biotechnology|Medical Devices,53849535.0,USA,3,9,1522,14705,16227,0
Cloud Computing|Infrastructure|Software,105000000.0,USA,5,20,2329,14358,16687,0
Hospitality,1543920.0,ITA,1,1,0,15999,15999,0
Restaurants,6000000.0,IND,1,2,0,16749,16749,0
Food Processing,2000000.0,CAN,2,3,317,16405,16722,0
E-Commerce,40000.0,USA,1,1,0,15441,15441,0
E-Commerce,5000000.0,RUS,2,3,704,16054,16758,0
Media|Mobile|Restaurants|Technology,8510000.0,USA,4,4,847,15645,16492,0
Discounts|Internet|Restaurants,1000000.0,BRA,1,1,0,16518,16518,0
Consumers|Education|Online Rental|Textbooks,252303692.0,USA,10,26,1917,13514,15431,1
E-Commerce,1623640.0,CHN,1,1,0,15796,15796,0
Leisure|Travel|Travel & Tourism,94936.0,BRA,2,2,61,15857,15918,0
E-Commerce,1250000.0,ISR,2,6,718,15908,16626,0
Apps|Tracking|Travel,20000000.0,CHN,2,3,266,16323,16589,0
Biotechnology,39420000.0,USA,4,2,3835,12795,16630,1
Online Shopping,1200000.0,USA,1,1,0,13509,13509,0
Web Hosting,79000000.0,USA,4,27,1763,12801,14564,0
Curated Web,22000000.0,CHN,2,3,547,16000,16547,0
Biotechnology,21500000.0,CHN,2,5,513,13640,14153,0
Manufacturing,120000.0,USA,1,1,0,13658,13658,0
Hardware + Software,665000.0,USA,2,1,353,16083,16436,0
E-Commerce,10000000.0,GBR,1,3,0,15889,15889,0
Biotechnology|Health Care,80540000.0,USA,3,16,1008,12586,13594,1
Software,1583949.0,CHN,2,1,578,15371,15949,0
EdTech|Education,158730.0,CHN,2,2,518,15431,15949,0
Biotechnology,7174231.0,CHN,1,2,0,14488,14488,0
Intellectual Asset Management|Software,262634.0,BEL,1,2,0,16315,16315,0
Human Resources|Software,2950030.0,USA,3,3,2008,14245,16253,0
Automotive,5250000.0,USA,2,9,161,15286,15447,0
Real Estate,140354.701816654,GBR,3,2,518,15461,15979,0
Customer Service|SaaS|Software,28170695.0,USA,2,1,861,15671,16532,0
Educational Games|Games|Mobile,500000.0,ISR,1,1,0,16071,16071,0
Games,1250000.0,ZAF,1,1,0,14467,14467,0
Games,1000000.0,USA,1,3,0,13695,13695,1
Health Care,7800000.0,USA,1,3,0,13953,13953,0
Hospitality,7600000.0,USA,5,19,1098,15552,16650,0
E-Commerce|Hardware + Software,185000000.0,CHN,4,11,1521,14975,16496,0
Manufacturing|Medical Devices,22900000.0,USA,1,4,0,12803,12803,1
Health Care,360000.0,USA,1,1,0,14518,14518,0
Biotechnology,658000.0,ISR,1,1,0,14867,14867,0
Biotechnology,176000000.0,ISR,7,18,3455,13038,16493,1
Analytics,33390.0,GBR,1,1,0,16139,16139,0
Designers|E-Commerce|Fashion|Jewelry,2265965.48957756,GBR,2,6,532,16237,16769,0
E-Commerce|Internet|Sales and Marketing,798357.0,ESP,2,2,0,16197,16197,0
E-Commerce|Fashion|File Sharing|Lifestyle|Social Commerce|Women,800000.0,ESP,1,3,0,15532,15532,0
Restaurants,21250000.0,USA,1,4,0,11974,11974,0
Health and Wellness,560000.0,USA,3,4,154,15338,15492,0
Advertising|Big Data Analytics|Delivery|Groceries|Recipes,1240000.0,USA,2,5,243,16223,16466,0
E-Commerce|Fashion|Internet|Shopping,929111.0,ESP,2,5,403,15584,15987,0
Fashion,4516456.0,FRA,1,1,0,16694,16694,0
Semiconductors,22487000.0,USA,3,7,857,13149,14006,1
Restaurants|Services,5435058.01344133,GBR,3,2,2807,13939,16746,0
Design,40000.0,HUN,1,1,0,16051,16051,0
E-Commerce|Games,1500000.0,USA,1,3,0,15223,15223,0
Game|Games|Social Media,1100000.0,PRT,2,2,798,13826,14624,0
Apps|Banking|Mobile Payments,6500000.0,IND,2,1,639,16071,16710,0
Android|iOS|Mobile|Outdoors|Travel|Travel & Tourism,750000.0,USA,1,4,0,16708,16708,0
E-Commerce|Mobile|Mobile Payments|Payments,11750000.0,USA,3,5,765,15614,16379,0
Biotechnology|Health Care,256400000.0,USA,7,22,4078,12303,16381,1
Cars|E-Commerce|Online Rental|Service Providers,203000000.0,CHN,3,3,2008,13514,15522,0
News,1000000.0,CHN,1,2,0,13180,13180,0
Enterprises|Enterprise Software,50000000.0,CHN,1,2,0,13496,13496,0
Clean Technology,472000000.0,HKG,1,1,0,16051,16051,0
Fashion,15007503.0,CHN,1,3,0,14944,14944,0
News,15000000.0,CHN,2,3,395,13392,13787,0
Public Transportation,84797290.0,CHN,4,3,1188,13453,14641,1
Health Care,43000000.0,CHN,1,1,0,13970,13970,0
Finance|Insurance|Property Management,400000000.0,CHN,1,2,0,12768,12768,0
Semiconductors,4062799.0,CHN,1,1,0,12631,12631,0
Finance Technology,56000000.0,CHN,2,5,2825,13818,16643,0
Finance|FinTech,1000000.0,CHN,1,1,0,16098,16098,0
Enterprise Software,195000000.0,CHN,1,1,0,16085,16085,0
Consulting,6000000.0,CHN,3,3,909,12784,13693,0
Curated Web|Internet|Technology,118500000.0,CHN,6,23,3113,13027,16140,1
Automotive,25000000.0,CHN,1,1,0,13389,13389,0
E-Commerce|Education|Language Learning,1048030.0,KOR,1,2,0,16423,16423,0
Enterprise Software,10970000.0,CHN,2,3,666,13514,14180,0
Cloud Computing|IaaS|Web Hosting,10725000.0,CHN,8,2,2404,14246,16650,0
Finance,6700000.0,CHN,1,2,0,15218,15218,0
Entertainment Industry|Film Production|Television,804000000.0,HKG,1,1,0,16130,16130,1
Semiconductors,3500000.0,USA,1,1,0,13425,13425,0
Semiconductors,4902818.0,USA,1,2,0,15987,15987,0
Software,7095000.0,CAN,2,6,533,15964,16497,0
Semiconductors,27500000.0,PRT,3,5,600,12916,13516,1
Curated Web,6158540.0,ARE,3,3,1487,13149,14636,0
Algorithms|Blogging Platforms|Coupons|E-Commerce|Finance|Incentives|SEO|Shopping|Technology,750000.0,USA,1,5,0,16050,16050,0
Semiconductors,4140000.0,IRL,2,5,993,13726,14719,1
Software,10900000.0,DEU,2,4,583,13432,14015,0
Video,31800000.0,USA,2,17,456,12159,12615,1
Semiconductors,16000000.0,USA,2,14,1583,12499,14082,1
Manufacturing,13000000.0,USA,1,4,0,14260,14260,0
Artists Globally|Events|Gift Card|Social Media,1100000.0,USA,2,18,234,14837,15071,0
E-Commerce|Fashion|Jewelry|Social Commerce,32450000.0,USA,4,18,1274,14975,16249,0
Biotechnology,21000000.0,USA,2,9,761,13007,13768,0
Content|File Sharing|Social Media,2727384.0,USA,2,1,943,15136,16079,0
Food Processing|Manufacturing|Specialty Foods,750000000.0,USA,1,1,0,16184,16184,0
Mobile Games,8592310.0,USA,3,14,833,15659,16492,0
Comics|Curated Web|File Sharing,25000.0,USA,1,1,0,14031,14031,0
Advertising,99800000.0,USA,8,2,5738,10957,16695,0
Mobile,2565000.0,USA,2,7,130,14549,14679,1
Energy Management|Renewable Energies,8185805.0,GBR,2,2,100,16293,16393,0
Automotive,4502251.0,CHN,1,1,0,14944,14944,0
Technology|Test and Measurement,2196193.0,CHN,1,1,0,14518,14518,0
Clean Technology,3001500.0,CHN,1,1,0,14944,14944,0
Technology,20000000.0,CHN,1,2,0,14914,14914,0
Advertising|Electronics|Hardware + Software|Mobile,15000.0,USA,1,1,0,15038,15038,0
E-Commerce|E-Commerce Platforms|Facebook Applications|Social Commerce,350000.0,UKR,1,1,0,15981,15981,0
Clean Technology|Energy|Marketplaces|Services|Utilities,25500000.0,USA,3,7,750,15790,16540,0
K-12 Education|Online Education|Search|Semantic Search|Teaching STEM Concepts,100000.0,USA,1,2,0,16486,16486,0
Shoes|Sports,28753.0,AUS,1,2,0,15870,15870,0
Advertising|Digital Media|Media|SaaS|Sales and Marketing|Services|Software,5727499.0,USA,3,1,818,15638,16456,0
Discounts|Email Marketing|Games|Local|Mobile|Search|Shopping,4473279.0,USA,2,2,181,15188,15369,0
Apps|Artificial Intelligence|Cooking,192644.997468094,GBR,1,1,0,16658,16658,0
Consumers|Hospitality|Restaurants|Technology,11386668.0,SGP,3,8,970,15645,16615,0
Diagnostics|Health Care|Physicians,567287.0,USA,1,1,0,16491,16491,0
Apps|Curated Web|Internet|Kids|Mobile|Parenting,3960035.0,USA,6,9,1325,15187,16512,0
Apps|Games|Mobile|Mobile Games,10000000.0,USA,2,11,277,16102,16379,0
Sales Automation,100000.0,USA,1,1,0,16375,16375,0
Nonprofits,213094.0,USA,1,1,0,16107,16107,0
Software,19700000.0,USA,1,1,0,13054,13054,0
Biotechnology,77500000.0,GBR,2,11,1177,13241,14418,0
Biotechnology,16124996.0,USA,5,2,1651,14756,16407,1
Education,9700000.0,USA,2,20,174,15659,15833,0
Biotechnology,72100000.0,USA,5,14,3209,13239,16448,0
SaaS|Software,120000000.0,USA,3,3,1155,15461,16616,0
Biotechnology,510000.0,DEU,1,2,0,14804,14804,0
Collectibles|Curated Web|E-Commerce|Fashion|Lifestyle|Online Shopping|Retail|Trading,5300000.0,CHE,2,13,359,16384,16743,0
Consulting,21639640.0,USA,6,2,1689,13431,15120,0
Web Hosting,5520000.0,USA,1,3,0,13312,13312,1
E-Commerce|Internet|Technology,1400000.0,USA,1,5,0,16674,16674,0
Biotechnology,13183707.0,USA,6,3,2072,14096,16168,0
Biotechnology,34900000.0,USA,4,8,534,16139,16673,0
E-Commerce|Fashion|Lifestyle|Marketplaces,22860294.0,DEU,3,2,1968,14665,16633,0
Biotechnology,12960313.0,CAN,1,4,0,12382,12382,0
Sports,1200000.0,USA,2,2,268,16130,16398,0
Application Platforms,28000.0,USA,1,1,0,15584,15584,0
Biotechnology,12122011.0,GBR,1,4,0,16048,16048,0
Biotechnology|Health Care,10000.0,USA,1,1,0,14330,14330,0
Enterprise Software|Risk Management,6000000.0,USA,1,1,0,14610,14610,0
Fashion|Manufacturing|Shoes,40000.0,USA,1,1,0,15440,15440,0
E-Commerce|Fashion,4000000.0,USA,2,8,560,15614,16174,0
Curated Web,225000.0,USA,1,1,0,15522,15522,0
Fashion|Local|Public Relations|Shopping|Social Media,64540.0,DEU,1,1,0,15616,15616,0
Android|Development Platforms|Games|iOS|Mobile Games|Mobile Software Tools,83200000.0,CHN,4,11,1021,14975,15996,0
E-Commerce,2000000.0,IND,2,2,457,15753,16210,0
Computers|Hardware + Software|Web Tools,17500000.0,USA,2,7,486,13483,13969,0
Mobile,10000000.0,CHN,1,2,0,16102,16102,0
Mobile,54000000.0,CHN,3,6,1022,15279,16301,0
Android|App Stores|E-Commerce|iOS|Marketplaces|Mobile|Open Source,1765000.0,GBR,3,2,944,15371,16315,0
Systems,3250000.0,DNK,3,2,1327,15340,16667,0
Analytics|Internet|iOS|Marketing Automation|Mobile|Photography|SaaS|Social Media Marketing,12719997.0,USA,5,12,1220,15187,16407,0
Software,4500000.0,USA,1,3,0,12375,12375,0
Curated Web,245000.0,IND,1,3,0,16182,16182,0
Health Care,49250003.0,USA,6,5,2697,13935,16632,0
Health Care,10000000.0,USA,1,2,0,15630,15630,0
Semiconductors,17400000.0,USA,1,2,0,11919,11919,0
Software,1031236.0,GBR,1,1,0,13718,13718,0
Apps|Mobile|VoIP|Web Development,1936760.0,IRL,1,3,0,14157,14157,0
Semiconductors,24150000.0,USA,3,6,582,12997,13579,1
Biotechnology|Health Care|Therapeutics,104332199.0,USA,3,14,239,16238,16477,1
Games,3000000.0,USA,1,1,0,14761,14761,1
Biotechnology,1057557.0,USA,2,1,455,16126,16581,0
Enterprise Software|Media|Search,8500000.0,USA,3,7,957,15764,16721,0
Software,6000000.0,USA,2,2,878,14831,15709,0
Consulting,50000000.0,USA,1,1,0,15979,15979,0
Finance|FinTech,7704120.0,USA,4,3,1006,15659,16665,0
Games,13000000.0,USA,1,1,0,15317,15317,0
Nanotechnology,25000000.0,USA,2,1,1118,15042,16160,0
Software,1301000.0,IRL,2,6,329,13170,13499,1
Advertising Exchanges|Advertising Platforms|Mobile|Mobile Advertising,24500000.0,USA,2,5,644,15988,16632,0
Enterprise Software|SaaS|Semantic Web|Video Streaming,7250000.0,USA,2,1,1027,15203,16230,0
Education,2750000.0,USA,1,1,0,15986,15986,0
Big Data Analytics|Content|Games|Software,240000.0,USA,2,1,652,15826,16478,0
Photography,350000.0,CAN,3,2,399,15482,15881,0
Film|Games,18442000.0,USA,4,1,1189,14819,16008,1
Internet Marketing,521000.0,USA,2,3,253,15967,16220,0
Content Creators,6775000.0,USA,5,13,981,15494,16475,0
Online Video Advertising|Video|Video Streaming,201730.0,ARG,3,3,303,15949,16252,0
Photography,8500000.0,USA,1,4,0,15674,15674,0
Games,22000000.0,USA,2,5,26,12600,12626,0
Video,5400000.0,USA,2,5,575,16183,16758,0
Advertising|Games|Media|Video on Demand,1500000.0,LBN,1,1,0,16411,16411,0
E-Commerce|Ticketing,3084851.0,PER,7,12,1022,15341,16363,0
Software,1500000.0,GBR,1,1,0,13711,13711,0
Games,182324.0,HRV,2,1,193,15689,15882,0
Curated Web,1470000.0,SGP,1,4,0,16110,16110,0
Software,120000.0,USA,2,3,304,15857,16161,0
Software,15440950.0,SWE,2,1,1042,13826,14868,0
B2B|Marketing Automation|Sales and Marketing,800000.0,USA,1,1,0,16554,16554,0
Big Data Analytics|Developer Tools|Location Based Services|SaaS,1257567.0,USA,4,2,408,16265,16673,0
Hardware + Software,1300000.0,BEL,1,3,0,13557,13557,0
Logistics Company,80069.0,DEU,1,1,0,15720,15720,0
Health Care,4475451.26288144,GBR,5,7,1440,15086,16526,0
Cloud Data Services|Enterprise Software|Startups,557181.0,IRL,3,1,853,15187,16040,0
Cloud Security|Data Security|Enterprise Software,80000000.0,USA,3,8,1182,15211,16393,0
Cloud Computing|Enterprise Software|Meeting Software|Network Security|Security|Trusted Networks,340000.0,USA,3,1,698,15616,16314,0
Security,141535713.0,USA,8,29,2119,11450,13569,0
Security,34850000.0,USA,3,5,2292,12689,14981,0
Web Hosting,42000000.0,USA,1,5,0,12485,12485,1
Enterprise Software,1798555.0,GBR,2,5,678,14335,15013,0
Hardware + Software,26797546.0,USA,4,14,2645,12194,14839,1
Analytics,38225000.0,USA,4,6,3222,13180,16402,0
Media|Mobile|News,5722750.0,USA,9,46,673,15457,16130,0
Biotechnology,144630999.118737,GBR,3,7,1176,13907,15083,0
Education,1300000.0,USA,1,1,0,13431,13431,0
Banking|Bitcoin|Finance|Finance Technology|Financial Services|FinTech|Personal Finance|Security,76000000.0,IRL,3,14,547,16008,16555,0
Software,3900000.0,CAN,1,2,0,15162,15162,0
PaaS|Software|Testing|Web Development,7500000.0,USA,3,12,677,15431,16108,0
Apps|Location Based Services|Private Social Networking|Social Media,6000000.0,USA,2,19,180,14975,15155,0
Health Care,2900000.0,USA,1,7,0,16759,16759,0
Android|Apps|Artificial Intelligence|Business Services|Contact Management|iOS|iPad|Mobile|Synchronization,12000000.0,USA,1,4,0,16631,16631,0
Finance|Financial Services,22150000.0,USA,4,1,1271,15366,16637,0
Social Media,3075000.0,USA,2,1,822,13695,14517,0
Crowdfunding|Finance|Marketplaces|Venture Capital,53000000.0,USA,4,29,1302,15448,16750,0
Semiconductors,198000.0,IND,1,1,0,14623,14623,0
Clean Technology,2700000.0,USA,1,1,0,15869,15869,0
Health Care,89200000.0,USA,5,13,1779,13529,15308,1
Chemicals|Clean Technology|Energy,48900000.0,USA,3,8,1276,14636,15912,0
Design|E-Commerce|Marketplaces|Social Network Media,12000.0,EGY,1,1,0,15584,15584,0
Software,9000000.0,USA,3,6,208,15987,16195,0
Software,3028000.0,USA,3,4,356,15896,16252,0
CRM|Email|Software,550000.0,USA,1,1,0,15936,15936,0
IT Management,5280404.0,USA,5,7,1373,15309,16682,0
Enterprises|Enterprise Software,32500000.0,USA,2,7,127,14872,14999,0
Enterprise Software,640458.0,GBR,4,4,1085,15478,16563,0
Semiconductors,1550000.0,BEL,1,3,0,13971,13971,0
Business Development|Business Services|Information Technology,7000000.0,GBR,1,4,0,12677,12677,0
Education,4450000.0,USA,5,16,736,15706,16442,0
Brand Marketing|Content Delivery|Content Syndication|Mobile|SaaS,2800000.0,USA,2,3,408,15706,16114,0
Curated Web|Events|Local|Online Shopping|Reviews and Recommendations|Travel,70000.0,ARG,2,3,0,15765,15765,0
Health Care,23100000.0,CHN,3,4,1096,13483,14579,0
Hardware + Software,2260000.0,FRA,1,2,0,13347,13347,0
Big Data|Market Research|Social Media,60000.0,CHL,2,2,319,15356,15675,0
Advertising|Internet|Local|Local Advertising|Local Businesses|Local Search,3564155.0,ESP,3,7,1005,14304,15309,0
Consumers|CRM|Mobile|SMS,180000.0,MEX,1,1,0,15554,15554,0
Sports,10000000.0,USA,1,1,0,13514,13514,1
Software,9703020.0,USA,6,12,909,15584,16493,0
Domains|Public Relations,3000000.0,USA,1,1,0,14011,14011,1
Advertising|Social Media,799996.0,USA,3,1,215,14433,14648,0
Curated Web,1000000.0,USA,2,1,460,16122,16582,0
News|Photo Sharing|Video,1529666.0,FRA,2,2,355,13483,13838,1
Design|E-Commerce,1500000.0,ARE,1,4,0,15949,15949,0
E-Commerce|Mobile Payments|Payments,32300000.0,IND,3,6,1387,15340,16727,0
E-Commerce|Kids|Subscription Businesses,6600000.0,USA,2,4,277,15177,15454,1
Software,11500000.0,USA,2,3,392,12844,13236,0
Analytics|Databases|Real Time,13150000.0,USA,3,15,1210,15518,16728,0
Advertising,250000.0,USA,1,1,0,14700,14700,0
Advertising,3000000.0,USA,2,1,300,16395,16695,0
News,5000000.0,RUS,1,1,0,16135,16135,0
Mobile,750000.0,USA,1,5,0,15613,15613,0
Crowdsourcing|Non Profit|Services,55000.0,RUS,2,1,487,15553,16040,0
Coupons|Curated Web,5628800.0,DEU,1,3,0,14636,14636,1
Analytics|Financial Services|Investment Management,299225.0,GBR,1,1,0,16517,16517,0
Transportation,750000.0,IND,1,1,0,16741,16741,0
Clean Technology|Mobile|Navigation|Real Time,593661.0,FRA,2,3,631,16031,16662,0
Mobile|Navigation|Security,75000.0,CHL,2,1,304,15779,16083,0
Aerospace|Apps|Curated Web|Travel,443846.161880549,IRL,3,5,546,15737,16283,0
Travel,10000000.0,GBR,1,4,0,16177,16177,0
Local|Maps|Social Search|Social Travel,12000000.0,USA,4,6,1229,15418,16647,0
Business Intelligence|Government Innovation|Marketplaces|Procurement|Services|Startups|Training,1000000.0,ESP,1,1,0,16015,16015,0
Local|News,4813870.0,ITA,2,6,399,14629,15028,0
Coupons|Curated Web|Group Buying|Marketplaces,770000.0,USA,2,3,293,14852,15145,0
E-Commerce,2757221.0,USA,3,3,421,15805,16226,0
Networking|Social Media|Social Search,1940000.0,GBR,3,5,1697,14313,16010,0
Mobile,1395000.0,USA,2,1,962,14365,15327,0
Real Estate|Reviews and Recommendations|Search,200000.0,USA,1,1,0,16071,16071,0
Big Data|Events|Local Search|Social Search,650000.0,USA,2,5,193,15463,15656,0
Curated Web,422500.0,USA,3,3,559,14153,14712,1
Analytics,450000.0,USA,1,1,0,16141,16141,0
Curated Web|Events|Guides|Local|Social Media,4180000.0,USA,2,2,1177,14145,15322,0
Consumer Goods|E-Commerce|Social Media,40000.0,CHL,1,1,0,15408,15408,0
E-Commerce|Pets,300000.0,COL,1,1,0,16157,16157,0
Information Services|Information Technology|Social Media|Technology,300000.0,USA,1,1,0,16350,16350,0
Politics,236000.0,GBR,1,1,0,14882,14882,0
Consulting,12000000.0,KEN,1,1,0,15842,15842,0
Analytics|Apps|Polling,5773126.0,USA,6,8,2346,14172,16518,0
Clean Energy|Clean Technology|Green|Renewable Energies|Solar,455000.0,USA,1,6,0,14610,14610,0
Finance,159455.0,GBR,1,1,0,15292,15292,0
Internet|Software,27193.0,IRL,1,1,0,15737,15737,0
Big Data|Colleges|EdTech|Education,88949999.0,USA,4,20,1536,15170,16706,0
Biotechnology,122000000.0,USA,5,21,1323,14984,16307,1
Curated Web,1000000.0,USA,1,1,0,15492,15492,0
Politics|Polling|Social Media,72066.807269164,DEU,2,1,88,16529,16617,0
Digital Rights Management|Monetization|Security|Television,20000000.0,NLD,1,1,0,14446,14446,0
B2B|E-Commerce|Fashion|SaaS|Technology,800000.0,USA,2,1,610,15706,16316,0
Software,694281.0,USA,1,1,0,15544,15544,0
Electronic Health Records|Health Care,119615.0,GHA,2,2,473,15289,15762,0
Banking|Finance|FinTech|Mobile|Mobile Commerce|Mobile Payments,34100000.0,USA,3,9,1867,13019,14886,1
Games|Mobile|Mobile Games,50000.0,SGP,1,2,0,14975,14975,0
Entertainment,150000.0,IND,1,1,0,16684,16684,0
Consumer Goods|Nutrition|Sustainability,1750000.0,USA,3,8,147,16478,16625,0
Enterprise Software|Text Analytics,109455816.0,USA,5,9,2647,13536,16183,0
E-Commerce|Enterprise Software|SaaS|Software,165000.0,USA,1,3,0,15979,15979,0
E-Commerce,65000.0,CHL,2,2,374,15940,16314,0
Hardware + Software,23090607.0,USA,5,3,1537,14763,16300,0
Big Data|Cloud Data Services|CRM|Direct Sales|Enterprise Software|Mobile|Mobile Software Tools|Predictive Analytics|Productivity Software|Sales and Marketing|Sales Automation|Social CRM,26000000.0,USA,2,4,75,16163,16238,0
Biotechnology,50912000.0,USA,2,1,226,14383,14609,1
Image Recognition|Software,10000000.0,USA,1,6,0,16553,16553,0
Software,3500000.0,USA,1,1,0,13165,13165,0
Big Data Analytics|Content Delivery|Developer APIs|Enterprise Software|Financial Services|Software|Technology|Telecommunications,1315000.0,USA,2,3,76,16296,16372,0
Semiconductors,92910870.0,USA,9,19,3564,12731,16295,0
Software,5500000.0,GBR,1,1,0,16763,16763,0
Biotechnology,15000000.0,USA,2,5,417,16044,16461,0
Analytics|Enterprises|Enterprise Software,1500000.0,USA,1,2,0,15106,15106,1
Advertising,1050000.0,USA,2,4,245,15967,16212,0
Curated Web,2700000.0,USA,2,8,512,15679,16191,1
Air Pollution Control|Technology,25000.0,USA,1,2,0,16290,16290,0
Collaboration|E-Commerce|SaaS,14219390.0,USA,3,3,777,15266,16043,0
Payments,19000000.0,USA,2,1,0,10957,10957,1
Information Technology|Services|Technology,11300000.0,USA,1,1,0,12304,12304,0
Advertising|Fraud Detection|Security,500000.0,ISR,1,1,0,15478,15478,1
Software,1235096.0,USA,1,1,0,16409,16409,0
Advertising,800000.0,USA,1,1,0,16302,16302,0
Cloud Computing|Collaboration|Online Scheduling|Project Management|SaaS|Software,91000000.0,ISR,7,22,2725,13486,16211,0
Design|Industrial|Manufacturing,1000000.0,USA,1,1,0,16252,16252,0
Clean Technology,2000000.0,IND,2,2,475,16000,16475,0
Health Care|Health Diagnostics,11800000.0,USA,2,8,794,13532,14326,1
Software,8330000.0,USA,2,4,548,12904,13452,1
Biotechnology,39500000.0,USA,2,3,2389,13844,16233,0
Medical,14000000.0,USA,1,3,0,16575,16575,0
All Students|Collaboration|Education|High Schools|Teachers|Video,350000.0,SLV,2,2,122,14102,14224,0
Advertising|Publishing|Teachers|Tutoring,30000.0,MEX,1,1,0,15262,15262,0
Advertising,8684459.0,GBR,3,3,775,13665,14440,0
Education,1000000.0,CAN,1,1,0,15958,15958,0
Hotels|Mobile|Online Reservations,70000.0,USA,1,2,0,16222,16222,0
Journalism|News|Personalization|Video,25000.0,USA,1,1,0,16230,16230,0
Big Data|EdTech|Education|Kids,10100000.0,USA,4,22,557,15240,15797,0
Hospitality,54495.912806539505,KEN,1,1,0,16745,16745,0
Software,1530000.0,ISR,2,3,722,13318,14040,0
Classifieds|E-Commerce,15000.0,USA,1,1,0,14975,14975,0
Software,3000000.0,USA,1,1,0,12996,12996,0
All Students|Apps|Education|Teachers,900000.0,USA,2,3,416,15857,16273,0
Bridging Online and Offline|Fitness|Health and Wellness|Marketplaces,84000000.0,USA,5,28,1349,15400,16749,0
EdTech|Education,15000000.0,IND,1,1,0,15152,15152,0
EdTech|Education|K-12 Education|Social Media Platforms,4500000.0,KOR,3,2,492,15861,16353,0
EdTech|Education|Finance|Software,3735000.0,USA,4,8,527,16102,16629,0
Education|Peer-to-Peer|Teachers,1700000.0,USA,2,6,421,16084,16505,0
Consumer Goods|Enterprise Software|SaaS,25157217.0,IRL,4,9,2880,13848,16728,0
3D Printing|Art|Beauty|Fashion,27000.0,CHN,2,2,118,16283,16401,0
Games|Messaging|Mobile|Web Development,550000.0,USA,1,2,0,16339,16339,0
Computer Vision|Health Diagnostics|Image Recognition|Machine Learning|Software,2098109.0,KOR,2,4,512,16230,16742,0
Clean Technology,14942854.0,USA,3,3,638,15615,16253,0
Environmental Innovation|Oil and Gas|Specialty Chemicals|Water Purification,2200000.0,USA,1,1,0,16372,16372,0
Clean Technology,43000000.0,USA,2,2,1301,13559,14860,0
Clean Technology,5550000.0,USA,2,1,138,14629,14767,0
Angels|Clean Technology|Entrepreneur|Finance|Venture Capital,1400000.0,USA,1,2,0,14922,14922,0
Clean Technology,16193969.0,DEU,2,3,1101,13969,15070,1
Clean Technology|Environmental Innovation|Green,1000000.0,RUS,1,1,0,15653,15653,0
Email|Email Newsletters|Health and Wellness|iPhone|Mobile|News|Organic|Restaurants|Sustainability,700000.0,USA,1,3,0,15156,15156,0
Clean Technology,65600000.0,USA,4,10,1699,14615,16314,0
Babies|Consumers|Environmental Innovation|Green|Retail|Services,100000.0,USA,1,1,0,14914,14914,0
Healthcare Services|Internet|Life Sciences|Online Dating,750000.0,USA,1,1,0,16338,16338,0
Clean Technology|Curated Web|EdTech|Education|Employment|Environmental Innovation|Green|High Schools|Internet|Sustainability,600000.0,USA,1,2,0,15248,15248,1
Consumer Goods|Services|Specialty Foods,6300000.0,USA,2,2,285,13672,13957,0
Collaborative Consumption|Consumers|Local Services|Logistics|Marketplaces|Mobile,1800000.0,CAN,2,6,380,16375,16755,0
Hardware + Software,6000000.0,CAN,2,2,198,14993,15191,0
Location Based Services|Logistics|Mobile Commerce,2300000.0,USA,1,11,0,16568,16568,0
Clean Technology|Customer Service|Waste Management,1600000.0,USA,1,1,0,14168,14168,0
Hardware,500000.0,CAN,1,2,0,16238,16238,0
Analytics|Business Intelligence|Consulting|Predictive Analytics,100000.0,IND,1,1,0,15840,15840,0
Drones|Robotics|Testing,1682988.0,NLD,1,1,0,16510,16510,0
Agriculture|Environmental Innovation|Waste Management,750000.0,NLD,1,1,0,16486,16486,0
Medical Devices,1500000.0,USA,1,1,0,16541,16541,0
Big Data|Nutrition|Software,6500000.0,USA,1,4,0,16693,16693,0
Analytics|Enterprises,134263.0,GBR,2,2,398,15829,16227,0
Software,5000000.0,USA,1,5,0,12943,12943,1
Software,1230000.0,USA,2,2,7,16653,16660,0
Enterprise Software,4000000.0,USA,1,1,0,14207,14207,1
Software,1100000.0,USA,1,1,0,12811,12811,1
Biotechnology,310063.0,GBR,1,1,0,16130,16130,0
Finance|FinTech|Payments|Software,127620230.0,BEL,7,13,3262,11323,14585,1
Web Hosting,6000000.0,USA,1,3,0,14474,14474,1
Enterprise Software,19200000.0,USA,2,4,271,13313,13584,1
Business Analytics|Business Intelligence|Developer APIs,2000000.0,USA,1,9,0,16497,16497,0
Accounting|SaaS|Software,1756087.0,GBR,2,1,355,15617,15972,0
Biotechnology|Health Diagnostics,7200000.0,SGP,1,2,0,15777,15777,0
Health Care Information Technology|SaaS|Software,15500000.0,USA,3,12,1142,15614,16756,0
Health and Wellness|Medical Professionals,60829111.0,USA,3,1,1640,14359,15999,0
Electronics|Health Care,19560275.0,USA,9,3,2431,14153,16584,0
Hardware + Software|IT Management|Virtual Desktop,20000000.0,USA,1,6,0,12059,12059,0
Big Data|Cloud Computing|Cloud Data Services|Cloud Infrastructure|Data Integration|Data Security|Data Visualization|Information Security,42200000.0,USA,4,13,1170,15413,16583,0
Clean Technology|Energy|Renewable Energies,150770000.0,USA,8,7,2392,13756,16148,0
Software,450000.0,USA,1,2,0,15085,15085,0
Financial Services,25000000.0,USA,1,1,0,16556,16556,0
Predictive Analytics|Recruiting|SaaS,8665000.0,CAN,2,5,464,15321,15785,0
Health Care,23470587.0,USA,8,5,2091,14566,16657,0
Natural Language Processing|Neuroscience|Semantic Web|Software|Text Analytics,10000000.0,ISR,2,13,202,12326,12528,1
Health Care|Restaurants|SaaS,64758.0,FRA,1,1,0,15645,15645,0
Software|Television,45550000.0,USA,8,15,2504,13939,16443,0
Finance|Local Businesses,1283027.0,GBR,1,1,0,16360,16360,0
Travel,20000000.0,USA,1,1,0,16722,16722,0
Software,1000000.0,USA,1,1,0,14558,14558,1
Email|Messaging|Security|Spam Filtering,150000.0,GBR,2,2,668,13180,13848,0
Android|Google Apps|Internet|iOS|Maps,1000000.0,USA,1,1,0,16375,16375,0
Governments|Legal,4097107.0,USA,12,11,1544,14613,16157,0
Robotics|Software,11458104.0,CAN,3,2,1902,14610,16512,0
Software,6900000.0,USA,2,1,931,14592,15523,0
Software,3800000.0,USA,2,2,1463,13145,14608,1
Curated Web|Risk Management,1000000.0,CAN,1,1,0,14992,14992,0
Advertising,1776763.0,USA,2,2,1281,13318,14599,1
Biotechnology,53899987.0,USA,5,10,1428,15344,16772,0
Information Technology|SaaS|Services,9750000.0,USA,1,3,0,11960,11960,0
Services,39000000.0,USA,2,6,655,16085,16740,0
Mobile,12000000.0,USA,1,2,0,16085,16085,0
Business Services|Enterprise Software|SaaS|Sales and Marketing,89000000.0,USA,4,14,1337,14791,16128,0
Analytics,30000000.0,USA,3,11,742,15418,16160,0
Advertising,420000.0,USA,2,1,767,15316,16083,0
Accounting|Finance|Financial Services|FinTech,120000.0,IND,2,5,45,16222,16267,0
Travel,56400000.0,IND,4,5,3053,13149,16202,0
Cloud Computing|Data Centers|Software,4049000.0,USA,2,1,311,14466,14777,0
Health Care,2000000.0,CAN,1,3,0,16378,16378,0
Ediscovery|Enterprise Software,29000000.0,USA,2,5,505,13242,13747,1
Internet|Mobile,5820000000.0,USA,6,21,4096,11667,15763,1
Biotechnology,54000000.0,USA,2,7,546,15258,15804,0
E-Commerce,1742558.0,NLD,2,2,901,15665,16566,0
Mobile|Security|User Experience Design,3120673.0,USA,2,4,5,16387,16392,0
Biotechnology,92500000.0,CAN,3,11,531,16079,16610,0
File Sharing|Software,3500000.0,USA,1,1,0,15476,15476,0
Biotechnology|Lasers|Medical,3725000.0,USA,1,6,0,16448,16448,0
CRM|Hotels|Small and Medium Businesses|Software|Tourism|Travel,200000.0,CHL,2,3,214,14669,14883,0
Biotechnology,35851203.0,USA,3,3,1052,15208,16260,0
Big Data|Data Integration|EdTech|Education,43320000.0,USA,4,26,928,15492,16420,0
Architecture|Content|Information Technology|Infrastructure|Portals|Web CMS,2500000.0,FRA,1,1,0,16456,16456,0
Education,300000.0,USA,1,1,0,15742,15742,0
Software,4815000.0,USA,2,2,71,14987,15058,0
Advertising Platforms|Search Marketing|Semantic Search|Software,513689.0,ESP,4,2,703,15581,16284,0
Gift Card|Social Media|Software,8500000.0,IRL,2,2,815,15285,16100,0
Apps|Cloud Computing|Education,133975.0,DEU,2,2,334,15706,16040,0
Enterprise Software|Simulation|Software,20118.0,IRL,1,1,0,15396,15396,0
Animal Feed|Pets|Services,120000.0,USA,1,2,0,16591,16591,0
Enterprise Software,100410283.0,USA,4,11,2109,13828,15937,1
E-Commerce|Reviews and Recommendations|Shopping,5600000.0,USA,5,3,821,13027,13848,1
Health and Wellness,2250002.0,USA,3,3,1156,13535,14691,0
Market Research,4843428.0,FRA,2,3,738,15887,16625,0
Education|Educational Games|K-12 Education|Language Learning,493887.0,CZE,2,2,292,16175,16467,0
Analytics,44882859.0,USA,6,12,3257,12437,15694,0
Hardware + Software,2076178.0,USA,2,2,731,14669,15400,0
Analytics|Networking|Security,17700000.0,USA,1,3,0,15761,15761,0
Marketing Automation,40300000.0,USA,2,5,1291,12482,13773,0
Health Care Information Technology|Therapeutics,3732500.0,USA,3,4,1208,15445,16653,0
Collaboration|Curated Web|Customer Support Tools|SaaS|Social Buying,3800000.0,USA,4,1,865,15340,16205,0
Analytics|Computer Vision|Internet of Things|Machine Learning|Security,329600.0,USA,4,6,1093,15162,16255,0
Software,12000000.0,USA,2,1,874,13614,14488,0
Content|Enterprise Software|SaaS,11500000.0,USA,2,3,161,13913,14074,1
Advertising|Big Data Analytics|Search|Semantic Search|Software,32500000.0,USA,6,18,3286,13149,16435,1
Curated Web|Payments,29972500.0,GBR,3,3,365,13149,13514,1
Apps|Cloud Computing|Developer APIs|Messaging|Mobile|Sales and Marketing|SMS|Social Media,12000000.0,USA,1,2,0,15033,15033,0
Travel & Tourism,10000000.0,BRA,2,4,200,16102,16302,0
Fitness|Health and Wellness|Healthcare Services,6000000.0,USA,1,1,0,15675,15675,0
Advertising|Search Marketing,3000000.0,USA,1,4,0,14484,14484,1
Entertainment|Games|Guides|Jewelry|Television|Video,19000000.0,USA,2,7,156,14502,14658,1
Software,847708.0,USA,3,1,1848,12996,14844,0
Advertising|Internet Marketing,6500000.0,USA,2,2,1250,14428,15678,0
Advertising,320000.0,UKR,2,3,91,16173,16264,0
Real Estate,20000.0,USA,1,1,0,16287,16287,0
3D Technology|Design|Internet|Real Time,50000.0,SGP,1,1,0,14245,14245,0
Advertising|Mobile|Mobile Advertising|Publishing,2000000.0,DEU,1,1,0,16554,16554,0
Advertising|Auctions|Performance Marketing,3000000.0,CHL,2,1,457,14426,14883,0
Auto|Automotive|Marketplaces,477280.0,GBR,2,11,872,15675,16547,0
Health and Wellness,240000.0,USA,3,1,621,15589,16210,0
Identity|Security,20000.0,USA,1,1,0,13665,13665,1
Advertising,3700000.0,ZAF,1,1,0,13528,13528,0
Software,6000000.0,USA,1,2,0,13318,13318,1
Software,56710000.0,USA,3,7,1587,13761,15348,1
Advertising Networks|Analytics|Direct Marketing|E-Commerce|SaaS,500000.0,USA,1,1,0,13879,13879,0
Analytics|Business Analytics|E-Commerce|SaaS,60000000.0,ISR,5,11,2615,13848,16463,0
Advertising|Mobile Commerce|Social Media Marketing|Technology,700000.0,USA,2,2,42,16029,16071,0
E-Commerce|Religion,2000000.0,USA,1,1,0,15645,15645,0
Enterprise Software,25000.0,USA,1,1,0,16099,16099,0
Crowdsourcing|E-Commerce|SEO,14194460.0,DEU,6,29,1663,14245,15908,0
Cloud Computing|Online Reservations|SaaS|Sports,120000.0,CHL,1,2,0,16222,16222,0
Health and Wellness,100000.0,CAN,2,1,547,14699,15246,0
Enterprise Software|SaaS,3000000.0,USA,3,17,617,16119,16736,0
Semiconductors,2000000.0,EST,2,2,2654,13234,15888,0
Analytics|Media|Music|Software|Video,2000000.0,USA,2,4,927,13514,14441,0
Agriculture|Mobile|Wireless,763000.0,USA,4,1,1149,14488,15637,0
Machine Learning,3416466.0,CHE,1,1,0,16188,16188,0
Software,7019940.14472607,FRA,2,3,655,13769,14424,0
Health and Wellness,24300000.0,USA,2,4,518,15994,16512,0
Big Data Analytics|Health Care|Software,100000.0,USA,1,1,0,15614,15614,0
Software,36185166.0,USA,8,5,2617,13845,16462,0
Dental|Fitness|Medical,50000.0,RUS,1,2,0,15737,15737,0
Health Diagnostics|Internet of Things|Medical Devices|Mobile Health,5000000.0,USA,1,2,0,16701,16701,0
Biotechnology|Clinical Trials|Medical Devices,91754589.0,USA,8,14,2558,13892,16450,0
Software,1165000.0,GBR,2,1,350,15705,16055,0
Finance|Payments,30515000.0,USA,4,22,1014,14975,15989,0
Biotechnology,12514532.0,GBR,1,1,0,14840,14840,0
Investment Management,110000000.0,USA,1,1,0,11702,11702,0
Software,15600000.0,USA,4,3,1783,14518,16301,0
Curated Web|Legal,26000000.0,CAN,2,7,785,15369,16154,0
Biometrics|Defense|Security,1200000.0,ISR,1,1,0,16331,16331,0
Curated Web|SEO|Social Media|Video,750000.0,RUS,3,3,302,15349,15651,0
Internet|Search|Video,2600000.0,USA,2,3,396,16113,16509,0
Brand Marketing|Curated Web|Fashion|Marketplaces|Social Buying,85000.0,ARG,4,2,324,15625,15949,0
Bitcoin|Cryptocurrency|Data Privacy|Data Security|Privacy|Security,110179.887028889,ITA,1,1,0,16734,16734,0
Digital Media|Internet Marketing|Media|News,627535.0,SWE,1,1,0,15204,15204,0
Games|Product Development Services|Stock Exchanges|Television|Video,179786.0,ESP,3,3,305,15309,15614,0
Cloud Computing|IaaS|PaaS|SaaS|Software|Storage,38400000.0,USA,3,9,1010,15522,16532,0
Messaging|Social Media,2000000.0,USA,2,2,260,14136,14396,0
Advertising|Beauty|Brand Marketing|Content|Digital Media|Fashion|Lifestyle,12600000.0,USA,2,16,616,16039,16655,0
Software,78000.0,POL,1,1,0,12957,12957,0
Software,5610000.0,USA,2,2,1735,12784,14519,0
Console Gaming|Enterprise Software|Fashion|Film Production|Online Gaming|Online Shopping,5400000.0,KOR,2,4,1098,15156,16254,0
E-Commerce|Fashion|Mens Specific|Personalization,3760492.0,NLD,3,5,352,15854,16206,0
Software,14200000.0,USA,2,5,633,12230,12863,1
Apps|Cloud Infrastructure|Social Media,956745.0,SWE,3,2,263,16327,16590,0
Assisitive Technology|Curated Web|Local Search|Mobile Commerce|Mobile Search,100000.0,USA,1,1,0,16467,16467,0
Enterprises,246517.0,IND,1,2,0,16332,16332,0
Digital Entertainment|Digital Media|Digital Signage,20000.0,USA,1,1,0,15989,15989,0
Messaging,4000000.0,CHN,1,1,0,16010,16010,0
Social Media,250000.0,CAN,2,4,141,15939,16080,0
Business Intelligence|Facebook Applications|Local Search|Location Based Services|Mobile|Sales and Marketing|Small and Medium Businesses|Social Media|Software|Technology|Twitter Applications,6998845.0,USA,3,3,1589,14579,16168,0
E-Commerce|Finance|Marketplaces,40000.0,USA,1,1,0,15859,15859,0
Augmented Reality|Curated Web|Fashion|Social Media,440000.0,USA,1,4,0,15201,15201,0
Health Care,250000.0,USA,1,3,0,16074,16074,0
Consulting,304899.0,GBR,1,1,0,15156,15156,0
Web Hosting,515000.0,USA,2,4,236,16127,16363,0
Cloud Computing|Cloud Management|Enterprise Software|IaaS,11000000.0,USA,1,3,0,14610,14610,1
Software,20687423.0,USA,5,2,1371,14851,16222,0
Big Data|Cloud Computing|Cloud Data Services|E-Commerce|Software,5599999.0,USA,2,4,420,16238,16658,0
Enterprise Software|Internet,37253180.0,USA,9,6,1876,14377,16253,0
Apps|E-Commerce|SMS,378812.0,GBR,2,1,539,15371,15910,0
Software,8000000.0,USA,2,5,425,16283,16708,0
Alternative Medicine|Bio-Pharm|Pharmaceuticals,1147000.0,USA,2,1,28,16252,16280,0
Security,2180000.0,USA,2,1,511,15961,16472,1
Cloud Computing|CRM|Development Platforms|Enterprise Software|Google Apps|Information Technology|Search|Social Media Marketing,63300000.0,USA,5,10,963,14731,15694,1
Software,1300000.0,USA,2,1,433,15955,16388,0
Cloud Computing|Consulting|Enterprise Software|IaaS|PaaS|SaaS,21000000.0,USA,6,5,1481,15135,16616,0
Automotive|Consumer Electronics|Enterprise Software|Fleet Management|Gps|Insurance|Internet of Things|Tracking,300000.0,POL,1,1,0,15748,15748,0
Billing|Cloud Computing|Enterprise Software|Finance,15818000.0,USA,4,16,1327,15330,16657,0
EdTech|Education|Recruiting,220000.0,USA,2,3,92,16283,16375,0
Photography,2000000.0,CHN,1,1,0,15461,15461,0
Enterprise Software|Software,60000.0,MEX,2,1,91,15857,15948,0
Analytics|Cloud Computing|Optimization|Web Hosting,1200000.0,USA,2,3,280,15679,15959,0
Big Data|Cloud Computing|Databases|Enterprise Software,18250000.0,USA,8,12,1839,14000,15839,1
Social Media|Software|Technology,15000.0,USA,1,2,0,15368,15368,0
Education,110000000.0,CHN,1,2,0,15894,15894,1
Cloud Computing|Enterprise Software|Software,51200000.0,USA,5,15,1520,14942,16462,0
Software,1000000.0,USA,1,1,0,16195,16195,0
IaaS|PaaS|SaaS|Software,1262064.0,GBR,7,18,790,15553,16343,0
Cloud Computing|Cloud Management|Consumer Internet|Messaging|Mobile,1220000.0,USA,2,5,217,15034,15251,0
Enterprise Software|Storage,6100000.0,USA,2,5,357,15517,15874,0
Mobile Games|Video Games,1550000.0,USA,1,1,0,16351,16351,0
Mobile,40000.0,CAN,1,1,0,15940,15940,0
Cloud Computing|Enterprise Software,2400000.0,USA,2,3,673,15806,16479,0
Analytics|Apps|Cloud Computing|Mobility|Technology,1000000.0,SGP,1,2,0,16617,16617,0
Enterprise Software,5100000.0,USA,1,2,0,14834,14834,0
Machine Learning,500000.0,DNK,1,1,0,16657,16657,0
Mobile Commerce,418000.0,SGP,1,2,0,16665,16665,0
Cloud Data Services|Collaboration|Email|SaaS|Software,120107.0,IRL,3,2,426,15949,16375,0
Business Services|Cloud Computing|Enterprise Software|Homeland Security|SaaS,5200000.0,ISR,1,1,0,15431,15431,0
Software,1115000.0,USA,2,3,498,15949,16447,0
Analytics|Big Data|Enterprise Software|Search|Software,1041000000.0,USA,8,29,1995,14319,16314,0
Crowdsourcing|Enterprise Software|Outsourcing|Web Development,5700000.0,USA,3,3,1139,15340,16479,0
Enterprise Software|Security,182050000.0,USA,4,21,2127,14573,16700,0
Networking,34000000.0,USA,2,5,370,16190,16560,0
Finance,3500000.0,GBR,1,2,0,16025,16025,0
Software,19700000.0,USA,3,7,680,15776,16456,0
Application Performance Monitoring|Big Data|Cloud Data Services|Networking,15200000.0,USA,2,12,275,16341,16616,0
Cloud Infrastructure|Software|Storage,40700000.0,USA,3,6,828,15431,16259,0
Cloud Computing|Mobile|SaaS,1000000.0,USA,1,3,0,16258,16258,0
Cloud Computing|Enterprise Software,7000000.0,ISR,1,3,0,15964,15964,0
Construction|Logistics|Mobile,11700.0,SGP,1,1,0,15946,15946,0
Cloud Computing|Enterprise Software|Networking|Venture Capital,2750000.0,USA,2,5,226,14501,14727,1
Enterprise Software,6000000.0,CAN,1,1,0,15881,15881,0
Cloud Security|Enterprise Software|Google Apps|IT Management|SaaS,34900000.0,USA,4,8,2444,13954,16398,0
Entertainment|Facebook Applications|Games,2000000.0,USA,1,1,0,15553,15553,0
Automotive|iPhone|Location Based Services|Machine Learning|Maps|Mobile|Navigation,16227940.5681406,USA,4,5,2013,13514,15527,0
Mobile Security|Security,38500000.0,USA,3,6,2403,12254,14657,0
Big Data Analytics|Health Care|Health Care Information Technology|mHealth|Mobile Health|Personal Health,6300000.0,USA,1,8,0,16556,16556,0
Analytics|Big Data|Enterprise Software|Real Time|Software,5300000.0,USA,2,1,1122,14335,15457,1
Analytics|Energy|Real Time,40000.0,CHL,1,1,0,16222,16222,0
Android|Enterprise Software|iOS|Mobile|Windows Phone 7,9863378.0,USA,7,15,1279,15218,16497,0
Software,21625000.0,USA,1,4,0,16627,16627,0
Software,7423227.0,USA,3,4,418,16017,16435,0
Apps|Internet,203078.52854648602,SVK,2,2,162,16565,16727,0
Cloud Computing|Enterprises|Enterprise Software|Mobile|Social Media,26140000.0,USA,4,9,705,14909,15614,1
E-Commerce,2000000.0,DEU,1,1,0,16097,16097,0
Cloud Security|Enterprise Software|Network Security|Security,88900000.0,USA,5,18,1575,15091,16666,0
Cloud Computing|Human Resources|Payments|SaaS|Software,52450000.0,USA,3,4,1449,14230,15679,0
Analytics|Virtualization,27500000.0,USA,4,13,948,15296,16244,0
Enterprise Software,6000000.0,SGP,1,1,0,14979,14979,0
Cloud Computing|Cloud Data Services|Curated Web|Databases|Data Security|Developer APIs|Internet of Things|Privacy|Software|Synchronization,638380.0,DEU,1,2,0,16448,16448,0
Cloud Computing|Cloud Management|Infrastructure|Software,135753.0,BGR,2,1,215,15949,16164,0
Cloud Computing|Enterprises|Enterprise Software|IaaS|Infrastructure|PaaS|SaaS,14000000.0,USA,2,4,609,15238,15847,1
Enterprise Software|Web Development,20000000.0,USA,2,7,571,14589,15160,0
Web Hosting,25000000.0,USA,2,9,689,13084,13773,1
Data Integration|Enterprise Software|Finance,318000.0,USA,3,4,213,15340,15553,0
Cloud Computing|Enterprise Software|Web Development,149180.0,IRL,1,1,0,14575,14575,0
Accounting|Customer Service|Outsourcing|Tech Field Support,500000.0,AUS,1,4,0,16030,16030,0
Web Development,800000.0,USA,1,1,0,16679,16679,0
Discounts|E-Commerce|Productivity Software|Software|Web Tools,500000.0,CAN,1,2,0,15853,15853,0
Finance,1400000.0,USA,2,1,414,15747,16161,0
Software,15400000.0,USA,2,5,154,14270,14424,1
Advertising|E-Commerce|Mobile|Retail Technology|Social Commerce,4004505.0,USA,4,4,929,15645,16574,0
Publishing|Social Network Media,1800000.0,SWE,1,11,0,15874,15874,0
Cloud Data Services|Data Integration|Enterprise Software,33000000.0,USA,3,7,791,15687,16478,0
Enterprise Software,4415653.0,USA,2,7,236,15651,15887,1
Big Data|Mobile|Networking|Security,101337.0,USA,2,2,365,16344,16709,0
Cloud Computing|Security,16000000.0,CHN,3,2,448,15979,16427,0
Content|Enterprise Software|SaaS|Translation,14400000.0,USA,3,7,1134,14897,16031,0
CRM|Data Integration|Enterprise Software|SaaS,1200000.0,ESP,1,3,0,15228,15228,0
Cloud Computing|IaaS|Software,5500000.0,ISR,2,2,1110,15218,16328,0
Software,600000.0,EST,1,5,0,16086,16086,0
Mobile|Open Source|Payments|SaaS,8800000.0,USA,2,5,624,15077,15701,1
Apps|iOS|Location Based Services|Match-Making|Mobile|Online Dating,4050000.0,CAN,3,2,325,16314,16639,0
FinTech,1000000.0,AUS,1,1,0,16706,16706,0
Health Care,100000000.0,USA,1,2,0,16696,16696,0
Public Relations,21000000.0,USA,2,6,636,12326,12962,1
B2B|Collaboration|Enterprise Software|Predictive Analytics|Productivity|SaaS,1800000.0,USA,1,4,0,16714,16714,0
Fashion,4687545.0,IND,1,1,0,16595,16595,0
Biotechnology|Health Care,356962756.0,USA,3,7,1646,14390,16036,1
Social Media,1200000.0,USA,1,3,0,15432,15432,0
Curated Web|E-Commerce|Fashion|Networking|Portals|Shopping|Social Media,6400000.0,SGP,4,3,968,15065,16033,0
Advertising|Mobile|Tablets|Web Development,20000.0,USA,1,1,0,15218,15218,0
Social Commerce|Social Media,200000.0,USA,1,1,0,16435,16435,0
Social Media,40000.0,ESP,1,1,0,15187,15187,0
E-Commerce|Flash Sales|Retail,540000.0,ARG,3,2,1701,14704,16405,0
E-Commerce|Online Travel,692850.0,ESP,1,1,0,14911,14911,0
E-Commerce,40000.0,CHL,1,1,0,16029,16029,0
E-Commerce,1738324.0,KOR,1,2,0,15343,15343,0
Information Technology|Services|Software,2000000.0,USA,1,7,0,16637,16637,0
Hospitality|Location Based Services,120000.0,USA,1,1,0,13910,13910,0
Hospitality|Online Reservations|Restaurants,3081412.0,ESP,4,8,552,15584,16136,0
Curated Web|Local|Professional Services,10700000.0,USA,1,1,0,16122,16122,0
Consumer Goods|E-Commerce|Hospitality|Subscription Businesses|Wine And Spirits,13100000.0,USA,4,9,1117,15218,16335,0
Software,430000.0,USA,1,1,0,13514,13514,0
Hospitality|Point of Sale|Retail|Software,1000000.0,IRL,1,3,0,15779,15779,0
Curated Web|Opinions|Social Network Media,1300000.0,USA,2,2,10,13655,13665,0
Apps|Mobile|Photography|Photo Sharing,1600000.0,USA,1,5,0,15939,15939,0
All Students|Colleges|Communities|Education|Universities,1100000.0,USA,2,2,371,15888,16259,0
Apps|Events|Mobile Commerce,119888.0,BGR,2,2,304,16191,16495,0
Software,266907.0,LVA,1,1,0,15253,15253,0
Databases|Software,2637628.0,GBR,2,3,1130,15379,16509,0
Enterprise Software,7290000.0,GBR,2,3,340,13174,13514,0
Staffing Firms,3665213.0,FRA,2,2,359,16363,16722,0
Big Data|Cloud Computing|Databases|E-Commerce|Enterprise Software,57250000.0,USA,8,13,3347,13149,16496,0
Analytics|Consumer Behavior|Coupons|Gift Card|Loyalty Programs|Mobile Commerce|Mobile Payments|Retail Technology,10300000.0,USA,2,3,659,15922,16581,0
Mobile|Self Storage,12300000.0,USA,4,15,608,16122,16730,0
Biotechnology,2929258.0,GBR,1,3,0,16538,16538,0
Semiconductors,35000.0,USA,1,1,0,14644,14644,0
Advertising|Social Television,30799999.0,USA,3,25,765,15769,16534,0
Graphics|Information Technology|Services,696000.0,ITA,1,1,0,13564,13564,0
Health Care,5000000.0,GBR,1,1,0,14207,14207,0
Games,15010000.0,HKG,1,1,0,16010,16010,1
Services|Telecommunications,5000000.0,CAN,1,2,0,15204,15204,0
Semiconductors,7484035.0,BEL,3,4,573,13893,14466,1
Social Media,3150000.0,USA,2,6,436,15056,15492,0
Biotechnology,7660569.14175812,GBR,2,2,1371,13448,14819,0
Software,1030000.0,GBR,3,3,1147,13165,14312,0
Android|Games|iOS|Mobile Games,1400000.0,USA,3,3,1117,15483,16600,0
Biotechnology,3137231.0,GBR,1,1,0,15365,15365,1
Nanotechnology,21000000.0,USA,3,10,2850,13695,16545,0
Big Data|Cloud Infrastructure|Data Centers|Data Security,40699993.0,USA,3,1,320,15927,16247,0
Health Care|Medical Devices,12500000.0,ISR,1,2,0,16372,16372,0
Collaboration|Developer Tools|SaaS|Visualization,270000.0,USA,4,2,207,16318,16525,0
Enterprise Software,15000000.0,CHN,1,1,0,15095,15095,0
Enterprise Software,2000000.0,USA,1,1,0,14641,14641,0
Mobile,40000.0,CHL,1,1,0,15138,15138,0
Consumers|Mobile|Sports|Teachers,760000.0,HKG,2,1,596,15765,16361,0
Fitness|Health and Wellness|Sports,6000000.0,FRA,2,3,803,14272,15075,0
Health and Wellness,1600000.0,USA,2,1,669,16047,16716,0
Sports|Training,9400000.0,USA,2,22,372,15658,16030,0
Software,42000000.0,USA,1,1,0,13731,13731,1
Hardware + Software|Video,2630000.0,USA,1,2,0,13558,13558,0
Security,9350003.0,USA,4,4,1680,15014,16694,1
Clean Technology,13350000.0,USA,2,3,336,14012,14348,1
Clean Technology,33750000.0,USA,2,5,2349,13570,15919,0
Biotechnology,38520000.0,USA,3,21,2517,12090,14607,1
Environmental Innovation|Information Technology,515000.0,USA,1,1,0,16540,16540,0
Health Care,32500000.0,USA,2,10,1000,13419,14419,0
Software,316000000.0,USA,4,4,1540,14642,16182,0
Crowdsourcing|Marketplaces|SaaS|Security,1470000.0,USA,2,3,80,16196,16276,0
Biotechnology|Clean Technology,55893000.0,USA,5,21,2135,13479,15614,0
Curated Web|Online Shopping|Personalization,4005000.0,USA,4,3,670,15805,16475,0
Internet|Search,14000000.0,VNM,1,1,0,16486,16486,0
Blogging Platforms|Communities|Recipes|Subscription Businesses,325000.0,COL,1,1,0,16157,16157,0
Software,6250000.0,USA,1,4,0,16590,16590,0
Curated Web,6659995.0,USA,3,2,936,14259,15195,0
Social Media,25000.0,USA,1,1,0,15568,15568,0
Blogging Platforms|Curated Web,1500000.0,CHE,1,3,0,13508,13508,0
Manufacturing,4860000.0,USA,1,1,0,13780,13780,0
Internet,5900000.0,JPN,2,8,816,15952,16768,0
Games,4701310.0,JPN,1,1,0,16091,16091,0
Biotechnology,15177581.0,USA,2,1,706,14526,15232,0
Clean Technology,229000000.0,USA,5,8,784,14453,15237,0
Banking|Mobile|Payments,3200000.0,SGP,3,9,701,15340,16041,0
Software,7623300.0,FRA,3,6,1339,12784,14123,0
Biotechnology,68713546.0,USA,6,9,3054,13431,16485,0
B2B|Developer Tools|SaaS|Software,1600000.0,GBR,2,8,695,16029,16724,0
Biotechnology,3800000.0,USA,3,1,1076,15522,16598,0
Apps|Mobile|Mobile Commerce|Mobile Payments|Mobile Shopping|Mobile Software Tools|Payments|Point of Sale|Technology|Transaction Processing,16000000.0,ARG,3,2,3086,13501,16587,0
Education|Educational Games|Mobile Games,120000.0,SWE,1,2,0,16357,16357,0
Software,2800000.0,USA,1,1,0,16183,16183,0
Data Privacy|Data Security|Security|Storage,137500000.0,USA,2,6,1358,15356,16714,0
Customer Support Tools|Developer Tools|SaaS,2000000.0,USA,1,5,0,16331,16331,0
Enterprise Software,34000418.0,USA,3,5,1935,12784,14719,1
Education|Educational Games|Kids|Mobile|Mobile Games,1800000.0,GBR,2,8,527,16221,16748,0
Analytics|Collaboration,100037.0,ARG,2,2,61,15279,15340,0
Developer Tools|Enterprise Software|File Sharing|Software|Web Development,848000.0,USA,3,6,1342,15045,16387,0
Software,532173.0,GRC,2,1,487,15949,16436,0
Cloud Computing|Enterprise Software,150000.0,USA,2,3,673,15714,16387,0
Curated Web|Education,12500000.0,USA,2,15,235,15274,15509,0
Education|Games,100000.0,USA,2,3,74,15997,16071,0
Software,6500000.0,USA,1,2,0,12857,12857,1
Apps|Home Automation|Mobile,1500000.0,USA,1,1,0,16065,16065,0
Education|Educational Games|Edutainment,2400000.0,USA,1,16,0,16527,16527,0
Collaboration|CRM|Data Integration|Enterprise Software|Open Source|Software,500000.0,ARG,1,1,0,13634,13634,0
Software,2000000.0,USA,3,2,581,14908,15489,0
Education,1750000.0,USA,2,7,816,15642,16458,0
E-Commerce,150000.0,IND,1,1,0,15675,15675,0
E-Commerce,750000.0,USA,1,1,0,16689,16689,0
Mobile|QR Codes|SMS|Ticketing,60000.0,BRA,1,1,0,14627,14627,0
Developer Tools|Education|Marketplaces|Web Development,1800000.0,USA,4,9,751,15922,16673,0
EdTech|Education|Software,730000.0,ISR,4,7,484,16010,16494,0
Security,3600000.0,USA,1,2,0,12821,12821,1
Developer Tools|Development Platforms|Enterprise Software,9000000.0,USA,1,2,0,15762,15762,0
Apps|Consulting|Internet,2139150.0,ESP,1,1,0,15153,15153,0
Communications Infrastructure|Real Time,50000.0,PER,1,1,0,16467,16467,0
College Recruiting|Education|Financial Services|Web Development,25000.0,USA,1,1,0,16405,16405,0
Open Source|Outsourcing|Software,840000.0,USA,3,14,602,15958,16560,0
Health and Wellness,23020000.0,USA,3,8,2766,12418,15184,1
Security,2856920.0,DNK,1,2,0,15675,15675,0
B2B|Cloud Computing|Developer Tools|IaaS|SaaS|Software|Testing|Web Development,4400000.0,USA,3,14,1011,15761,16772,0
Cloud Computing|Collaboration|Mobile|Software,50000.0,AUS,1,1,0,16024,16024,0
Educational Games|Game|Software,1650000.0,USA,3,7,426,16191,16617,0
Advertising|Mobile|Offline Businesses|Social Media,20000.0,USA,1,1,0,15584,15584,0
Career Management|Education|Skill Assessment|Software,50000.0,COL,1,1,0,15594,15594,0
Analytics|Performance Marketing|SaaS|Tracking,1000000.0,POL,1,1,0,15340,15340,0
Genetic Testing|Life Sciences|Medical,41250.0,HKG,1,1,0,16071,16071,0
Biotechnology,37000000.0,USA,1,5,0,13374,13374,1
Consumer Electronics|Hardware + Software|Robotics|Software|Toys,125000.0,USA,1,1,0,16102,16102,0
Apps|Crowdsourcing|Internet|Marketplaces|Mobile|Project Management|Software,133211.0,BRA,2,2,117,16044,16161,0
Mobile,262507.0,ESP,1,2,0,15862,15862,0
Recruiting|SaaS|Skill Assessment|Software|Startups,73350.0,GBR,1,1,0,14512,14512,0
Online Gaming,2200000.0,USA,2,1,985,15765,16750,0
Biotechnology,33000000.0,USA,2,8,567,12933,13500,0
Health and Wellness,41308548.0,CHN,3,4,1315,15065,16380,0
Mobile,800000.0,USA,3,2,791,15614,16405,0
Analytics|Market Research,1525000.0,USA,4,1,821,15553,16374,0
Biotechnology|Clinical Trials|Genetic Testing|Life Sciences,320000.0,USA,2,1,2768,13879,16647,0
Biotechnology,28326700.0,USA,7,3,1678,14980,16658,0
Curated Web|Mobile|Online Dating,11200000.0,USA,3,9,875,15609,16484,0
Software,2600000.0,FRA,1,3,0,13563,13563,1
Curated Web|Internet|Networking,1130000.0,USA,7,4,792,15354,16146,1
E-Commerce|Education,2800000.0,GBR,1,3,0,16344,16344,0
Finance,2500000.0,USA,1,4,0,13124,13124,0
Biotechnology,4500000.0,USA,1,1,0,12894,12894,0
Web Hosting,41510000.0,USA,2,7,1699,12222,13921,1
Analytics|App Marketing|Mobile Shopping,1340000.0,GBR,2,3,2787,11778,14565,1
Biotechnology,77500000.0,USA,2,5,262,13606,13868,0
Apps|Curated Web|Databases|Internet|PaaS|Software|Web Development,11200000.0,USA,2,3,392,13208,13600,1
Analytics,11700000.0,USA,1,5,0,12838,12838,0
CRM|Health Care|Software|Technology,6500000.0,USA,2,2,321,16427,16748,0
E-Commerce,25000.0,USA,1,1,0,15065,15065,0
Analytics|Mobile|Service Providers|Telecommunications,4574643.0,GBR,4,9,1496,15147,16643,0
Big Data|E-Commerce|Finance,40000.0,USA,1,1,0,15712,15712,0
Big Data|Big Data Analytics|Finance,10000000.0,USA,1,2,0,16395,16395,0
Artificial Intelligence|Banking|Big Data Analytics|Call Center Automation|Telecommunications,1030394.0,ESP,4,5,982,15218,16200,0
EdTech|Education,118000.0,USA,2,1,452,15857,16309,0
Crowdsourcing|Health Care|Psychology|Universities,212381.0,CAN,2,2,33,15949,15982,0
Hardware + Software,15500000.0,USA,2,5,1485,12116,13601,1
Software,500000.0,USA,1,1,0,13663,13663,0
Software,7000000.0,ISR,1,7,0,12907,12907,1
Geospatial|Image Recognition|Software,7500.0,USA,1,1,0,16233,16233,0
Natural Language Processing|Neuroscience|Search|Semantic Web|Software,2900000.0,USA,2,4,930,14075,15005,0
Biotechnology,36705863.0,USA,10,28,2842,13844,16686,0
Advertising|Personalization,10150000.0,USA,3,5,686,14426,15112,1
Image Recognition,20500000.0,USA,4,7,733,15673,16406,0
Security,1400000.0,CZE,1,4,0,15089,15089,1
Artificial Intelligence|Software,500000.0,USA,2,1,686,15695,16381,0
Biotechnology,19990000.0,USA,3,3,1362,14981,16343,0
Educational Games,2020000.0,USA,4,4,429,16102,16531,0
Health Care|Health Diagnostics|Medical Devices|Rehabilitation,117000.0,USA,3,1,216,16080,16296,0
Hardware + Software,1800000.0,AUS,1,3,0,13179,13179,0
Health and Wellness|Health Care|Software,18600000.0,USA,7,6,579,15765,16344,0
Health Care,128310709.0,USA,7,4,2561,14169,16730,0
Databases|Network Security|Telecommunications|VoIP,6900000.0,USA,1,1,0,16364,16364,0
Communications Infrastructure|Startups|Wireless,35000000.0,USA,1,5,0,16518,16518,0
Analytics,7045000.0,USA,2,8,349,15896,16245,0
Health Care,41525000.0,USA,3,6,1790,13622,15412,1
Industrial Automation,12000000.0,USA,1,1,0,16689,16689,0
Biotechnology,249271980.0,USA,4,10,807,15719,16526,1
Storage,70000000.0,USA,2,12,579,16024,16603,0
Bio-Pharm,23100000.0,USA,2,3,1065,11170,12235,1
Cloud Computing|Networking|Security|Software|Virtualization,1204650.0,USA,1,1,0,13677,13677,0
Software,65000000.0,TUR,3,8,1000,15575,16575,0
Collaboration|Enterprise Software|Project Management|Social Media,1400000.0,USA,2,6,479,14496,14975,1
Medical|Medical Devices|Service Providers,779595.0,PRT,1,1,0,15903,15903,0
Hardware + Software|Mobile,15500000.0,USA,1,7,0,16195,16195,0
Finance,40000.0,CHL,1,1,0,16034,16034,0
Big Data|Bitcoin,1300000.0,USA,3,3,513,16175,16688,0
Software,775000.0,PAN,1,3,0,16191,16191,0
Bitcoin|E-Commerce|Personal Finance,106709590.0,USA,4,27,860,15595,16455,0
Bitcoin|Social Games|Sports|Video Games,100000.0,USA,1,1,0,16375,16375,0
Manufacturing,20000.0,USA,1,1,0,16087,16087,0
Mobile,5000000.0,JPN,2,2,279,15666,15945,0
Bitcoin|Data Security|Finance,491944.0,GBR,2,5,271,15956,16227,0
Bitcoin|Crowdfunding|Financial Services|Internet,1450000.0,USA,2,7,83,16071,16154,0
Bitcoin|Finance Technology|FinTech,474545.0,GBR,2,3,214,15826,16040,0
Bitcoin|Mobile Payments|P2P Money Transfer|Payments,2800000.0,JPN,2,4,559,16149,16708,0
Business Services,100000.0,SGP,1,1,0,16375,16375,0
Bitcoin|Finance|Finance Technology,8300000.0,KOR,4,9,676,16034,16710,0
Finance|Trading,3052975.0,USA,4,5,555,15804,16359,0
Bitcoin,606409.0,NLD,1,1,0,16436,16436,0
Bitcoin|Mobile Payments|Payments,1373909.0,GBR,1,2,0,16126,16126,1
Apps,1300000.0,USA,1,4,0,16751,16751,0
B2B|Big Data|Enterprises|Enterprise Software|Sales Automation,10500000.0,USA,3,9,1618,14975,16593,0
Biotechnology,23570000.0,USA,2,5,372,16280,16652,0
Business Intelligence|Cloud Computing|Predictive Analytics|SaaS|Software,11000000.0,USA,3,3,1558,14610,16168,1
Enterprise Software,6500000.0,USA,1,1,0,13149,13149,1
Manufacturing,31500000.0,USA,2,7,308,12852,13160,0
Big Data Analytics|Software,250000.0,USA,2,2,1644,13421,15065,0
Energy,500000.0,USA,2,1,3367,12872,16239,0
Services,5300000.0,DNK,2,3,69,16518,16587,0
Hospitality,9000000.0,USA,1,1,0,12284,12284,0
Advertising|E-Commerce|Software,20000.0,BRA,1,1,0,16148,16148,0
Bio-Pharm|Biotechnology|Health Care,40000000.0,USA,2,5,565,12293,12858,1
Analytics,40000.0,USA,1,1,0,15771,15771,0
SEO|Social Media,235000.0,USA,1,1,0,15765,15765,0
Messaging|Networking,12971851.0831496,NOR,1,3,0,13549,13549,1
B2B|Innovation Management|Intellectual Property,25000.0,USA,1,1,0,16587,16587,0
E-Commerce|Education|English-Speaking|Language Learning,2400000.0,USA,1,8,0,16029,16029,0
Advertising|Internet Marketing|Local Search|Web Development,120000.0,USA,1,1,0,12509,12509,0
Education,378492.0,GBR,1,2,0,16454,16454,0
Social Media,531438.111746226,KOR,2,3,167,16583,16750,0
Consulting,30000000.0,USA,1,1,0,13272,13272,0
Enterprise Software,29600000.0,USA,5,12,4038,12072,16110,1
Android|Apps|Collaboration|File Sharing|Home & Garden|iOS|iPhone|Mobile|Project Management,2350000.0,USA,3,7,489,15034,15523,1
Software,8795510.0,USA,4,1,1941,13619,15560,0
B2B|Consumers|Enterprises|Software,143000.0,SGP,3,5,229,15757,15986,0
Curated Web,2000000.0,USA,1,1,0,13514,13514,0
Advertising|Ediscovery|Reviews and Recommendations|Search|Web Tools,12197674.0,USA,3,2,1354,13910,15264,0
Enterprise Software,8400000.0,DEU,1,3,0,13006,13006,0
Search|Video Streaming,6580000.0,USA,2,4,466,14304,14770,0
Fashion|Sports,18137504.0,IND,3,3,1099,15527,16626,0
Cloud Data Services|Enterprise Software|Productivity Software,125000.0,USA,2,3,277,15869,16146,0
Advertising|Shopping|Social Media|Social Media Marketing,11000000.0,USA,3,3,1552,14245,15797,0
Analytics|Business Intelligence|Enterprise Software,15324624.0,USA,6,5,2501,13180,15681,1
Analytics|Business Intelligence|Health and Wellness|Health Care|Health Care Information Technology|Healthcare Services|Insurance|Software,125000000.0,USA,3,22,627,16101,16728,0
Advertising,86400002.0,USA,5,8,2111,13787,15898,0
Networking|Social Media|Software,2000000.0,USA,1,1,0,14579,14579,0
Hardware + Software,287000.0,SWE,1,2,0,14678,14678,0
Payments|Property Management|Real Estate|Rental Housing|University Students,20000.0,USA,1,1,0,16223,16223,0
Advertising|Advertising Platforms|Colleges,548000.0,USA,2,5,450,16150,16600,0
All Students|Content Creators|Media,8500000.0,USA,1,3,0,11603,11603,0
Education|Internet,40000000.0,USA,1,2,0,10988,10988,0
Career Management|Education|Identity,1800000.0,USA,1,8,0,15937,15937,1
Colleges|Curated Web|Employment|Human Resources|Recruiting,20000.0,USA,1,1,0,14730,14730,0
Education,320000.0,USA,3,2,683,15499,16182,0
Colleges|Mobile|Networking|Universities,2244500.0,USA,2,1,366,13695,14061,0
Colleges|Education|Social Media,25000.0,USA,1,1,0,15638,15638,0
Biotechnology,103000002.0,USA,6,18,3049,13455,16504,1
Enterprise Software|Information Services|SaaS,24251285.0,BEL,2,5,2827,13879,16706,0
Consulting|Document Management|Enterprise Software,3500000.0,CAN,1,3,0,11725,11725,0
Health Care,17300000.0,ISR,5,8,2669,13395,16064,0
Communities|Crowdsourcing|Journalism|Mobile Video|News|Photo Sharing|Social + Mobile + Local|Social Network Media,112062.858132777,BGR,2,2,89,16467,16556,0
Biotechnology|Genetic Testing,15000000.0,USA,1,14,0,16546,16546,0
Lighting,13000000.0,USA,1,5,0,12464,12464,1
Local|Location Based Services|Mobile|Mobile Social|Networking|Photography|Photo Sharing|Proximity Internet,41000000.0,USA,1,3,0,15056,15056,0
Mobile Commerce|Online Travel|Transportation|Travel & Tourism,150.0,USA,1,1,0,16257,16257,0
Semiconductors,70200000.0,ISR,7,27,5388,11374,16762,0
E-Commerce,25000000.0,USA,2,3,462,15867,16329,0
Beauty|Fashion|Reviews and Recommendations|Search,1300000.0,USA,1,1,0,15518,15518,0
Curated Web,2970000.0,CHE,1,2,0,13514,13514,1
Art|Creative|Curated Web|Design,1000000.0,USA,1,8,0,15097,15097,1
Accounting|Enterprise Software|SaaS|Small and Medium Businesses,251892.0,ARG,3,1,457,15765,16222,0
Games,13596.0,ITA,1,1,0,15737,15737,0
Bitcoin|Developer APIs|Finance Technology|FinTech|Network Security,2500000.0,ISR,1,4,0,16462,16462,0
Web Hosting,42000000.0,USA,3,14,959,12485,13444,1
Biotechnology,80799981.0,USA,5,18,2387,14061,16448,1
Telecommunications,1500000.0,SWE,2,2,429,12095,12524,0
Games,8000000.0,USA,1,1,0,13004,13004,1
Public Relations,6000000.0,ISR,1,2,0,13831,13831,0
Software,2860000.0,SWE,1,2,0,13648,13648,0
Governments|Health and Insurance,25000000.0,IND,3,4,571,13582,14153,0
Clean Technology|Consulting|Hardware|Hospitality|Software,1462224.0,CHE,1,1,0,16122,16122,0
Health Care|Medical|Medical Professionals,227975.0,GBR,2,2,244,15800,16044,0
College Recruiting|EdTech|Education,228000.0,USA,2,1,6,15313,15319,0
E-Commerce|Fashion,1840000.0,USA,1,8,0,15875,15875,0
Biotechnology|Health Diagnostics,56952124.0,USA,6,4,5317,11173,16490,1
Enterprise Software,5191392.0,USA,3,1,368,14401,14769,1
Biotechnology,6350000.0,USA,6,6,1974,13641,15615,0
Biotechnology,10567500.0,BRA,1,1,0,15063,15063,0
Entertainment,20500000.0,USA,1,2,0,11246,11246,0
Enterprise Software|Human Resources|Internet|Recruiting|SaaS|Software,730000.0,USA,1,6,0,15810,15810,0
Entertainment|Mobile|SMS|Tourism,1000000.0,FIN,1,1,0,13636,13636,0
Analytics|News|Social Television|Television,538062.0,ARG,4,6,731,15218,15949,0
Biotechnology,82000000.0,USA,3,6,616,13419,14035,0
Software,53700000.0,USA,1,7,0,11023,11023,0
Software,24790172.0,USA,10,11,3528,13187,16715,0
Communities|Graphic Design|Photography,50000.0,PER,1,1,0,15645,15645,0
Consumer Electronics|Home Automation|Internet of Things|Smart Building,158775.0,USA,2,1,301,16314,16615,0
Contact Centers|Outsourcing,1550000.0,HUN,2,1,526,14242,14768,0
Colleges|Mobile|Real Estate|Rental Housing|Search,1850000.0,USA,2,4,424,16255,16679,0
Curated Web|Events,86250.0,CAN,1,1,0,15320,15320,0
Games,25000.0,USA,1,1,0,15286,15286,0
Curated Web,750000.0,USA,1,3,0,13917,13917,0
Cyber Security,2600000.0,ISR,1,4,0,16030,16030,0
Comics|Games,3496222.0,USA,6,6,1461,14426,15887,1
Publishing,102500.0,USA,2,3,91,16631,16722,0
E-Commerce|Hotels|SaaS,1000000.0,SGP,1,1,0,16538,16538,0
Content|PaaS|Software,12300000.0,FRA,2,7,818,15405,16223,0
E-Commerce,10000000.0,USA,1,1,0,12244,12244,1
Advertising|E-Commerce|Personalization,5800000.0,USA,2,6,1151,15523,16674,0
Advertising|Analytics|Marketplaces|Mobile|Retail|Software,4000000.0,USA,1,1,0,16734,16734,0
Software,834000.0,DEU,2,8,1856,13392,15248,1
Corporate Training|Sales and Marketing|Software|Training,9200000.0,USA,2,7,583,16189,16772,0
Payments,2500000.0,USA,1,3,0,13131,13131,1
Networking|Semiconductors,11500000.0,ISR,2,3,800,13521,14321,0
Technology,7000000.0,ISR,1,3,0,11332,11332,0
Mobile|SaaS|Soccer|Sports,50000.0,USA,2,4,62,16252,16314,0
Nonprofits|Payments|Social CRM|Social Fundraising,1187000.0,USA,3,6,212,16188,16400,0
Real Estate,7350000.0,USA,1,5,0,16632,16632,0
Accounting,1000000.0,NZL,2,2,266,16273,16539,0
EdTech|Education|Kids|Media|Technology,7250000.0,USA,2,2,2568,13489,16057,0
Software,1980881.0,USA,3,1,748,15938,16686,0
Finance,45650000.0,USA,4,18,1013,15673,16686,0
Real Estate,62900000.0,IND,4,6,583,15860,16443,0
Security,40000.0,USA,1,1,0,16076,16076,0
E-Commerce,430139.0,GBR,2,4,408,15887,16295,0
Mobile|Software|Wireless,1000000.0,GBR,1,1,0,14060,14060,0
Business Services|Communications Infrastructure|Customer Service,26000000.0,USA,2,1,965,12830,13795,1
Software,18000000.0,IRL,2,3,765,14137,14902,0
Software,15600000.0,USA,2,5,433,13305,13738,0
Advertising|Blogging Platforms|Facebook Applications|Sales and Marketing|Social Media|Twitter Applications,170000.0,USA,2,1,104,16451,16555,0
Clean Technology|Renewable Energies|Solar,4000000.0,USA,1,2,0,14888,14888,0
Digital Signage|Internet|Local|Software,29222.0,GBR,1,1,0,14245,14245,0
Analytics|Big Data,125000.0,USA,1,1,0,15805,15805,0
Software,12600000.0,USA,1,2,0,15874,15874,0
Health Care,700000.0,USA,1,1,0,16017,16017,0
Finance Technology|FinTech,17000.0,USA,1,1,0,15584,15584,0
Credit|Public Transportation,2214710.0,GBR,3,4,293,16202,16495,0
Analytics|Bicycles|Electric Vehicles,566956.0,DEU,3,3,1049,15566,16615,0
Games,26696494.0,GBR,1,1,0,14904,14904,0
Fitness|Health and Wellness|Medical Devices,6500100.0,USA,1,1,0,15431,15431,0
Services,85000000.0,FRA,1,1,0,12727,12727,0
Medical,3000000.0,USA,1,1,0,16575,16575,0
Biotechnology|Medical,110000.0,USA,3,2,213,15340,15553,0
Lead Generation|Network Security|Social Media|Social Network Media,5665000.0,USA,2,4,516,14304,14820,0
Web Hosting,5000000.0,USA,1,1,0,13818,13818,0
Finance,40000.0,CHL,1,1,0,15777,15777,0
Financial Services,4000000.0,MEX,1,1,0,16476,16476,0
Automotive,7118500.0,ITA,1,3,0,15822,15822,0
Brokers|Insurance|Marketplaces|Personal Finance,19000000.0,CHL,3,5,584,15473,16057,0
Consumer Goods|Marketplaces|Travel,227287.0,GBR,2,1,70,15992,16062,0
Curated Web|Price Comparison,46000000.0,HKG,3,8,476,16071,16547,0
Enterprise Software,15500000.0,USA,3,14,890,15846,16736,0
Finance|Marketplaces|Price Comparison,3300000.0,ARE,2,5,530,16161,16691,0
Enterprise Software,40000.0,USA,1,1,0,15778,15778,0
Computers|Predictive Analytics|Software,4400000.0,USA,3,12,309,16061,16370,0
Web Hosting,170000000.0,USA,4,4,918,15587,16505,0
Networking|Public Relations,120000000.0,ISR,4,15,1577,14812,16389,0
Advertising|E-Commerce|Social Media,12000000.0,USA,3,7,872,14514,15386,0
Software,2000000.0,USA,1,2,0,15867,15867,0
Biotechnology,5075000.0,USA,2,1,17,16584,16601,0
Curated Web|Local|Mobile|Real Estate,123000000.0,USA,4,27,1003,15690,16693,0
Software,11000000.0,USA,2,4,1379,12269,13648,1
Families|Software|User Experience Design,500000.0,JPN,1,2,0,16191,16191,0
Data Security|Software,29310000.0,USA,2,8,1165,12251,13416,1
B2B|Finance|Finance Technology|Financial Services|FinTech|Marketplaces|Small and Medium Businesses,2730529.50428147,DEU,1,4,0,16744,16744,0
Advertising|Analytics|Business Intelligence|Market Research,33000000.0,USA,4,6,2464,11262,13726,1
Clean Technology,19460000.0,USA,1,1,0,14029,14029,0
E-Commerce|Price Comparison|Retail Technology,17088.823909163402,GBR,1,1,0,16722,16722,0
Health and Wellness,3660322.0,CHN,2,2,671,13970,14641,0
Enterprise Software,6000000.0,USA,1,1,0,13319,13319,0
Biotechnology|Life Sciences,104490061.0,USA,4,15,1605,13235,14840,1
Software,6505000.0,USA,2,2,469,15104,15573,0
Clean Technology,5000000.0,USA,2,3,959,15181,16140,0
Collectibles|Curated Web|Social Commerce|Social Media,684000.0,USA,5,5,974,15431,16405,0
Lifestyle|Media|Mens Specific|Publishing,60533695.0,USA,4,5,2119,14581,16700,0
Apps|Design,1700000.0,USA,1,4,0,16353,16353,0
Biotechnology,24183205.0,USA,7,5,1120,15483,16603,0
Health and Wellness,40000000.0,USA,1,1,0,16079,16079,0
Automotive|Finance|Software,12530000.0,USA,3,4,1553,13452,15005,1
Software,3317360.0,USA,2,1,666,13635,14301,0
Software,1250000.0,USA,1,4,0,15048,15048,1
Consulting,177435.0,GBR,1,1,0,15614,15614,0
Curated Web,8250000.0,USA,1,1,0,16078,16078,0
Software,1675661.0,USA,2,2,330,16146,16476,0
Biotechnology,24399800.0,BEL,3,12,1112,14770,15882,0
Software,1166969.0,GBR,2,4,1092,14326,15418,0
Document Management|Enterprise Software|Mobility|Software,14000000.0,USA,2,1,1132,15218,16350,0
Software,2500000.0,USA,1,2,0,16561,16561,0
Transportation,525000.0,USA,1,2,0,16173,16173,0
Education|Publishing,596396.0,AUS,2,2,518,15918,16436,0
Content|Software|Web CMS,31950003.0,USA,5,11,3949,11688,15637,1
Semiconductors,8589492.0,GBR,2,2,1424,14391,15815,0
Music,40000.0,USA,1,1,0,15440,15440,0
Music,30000.0,ISR,1,1,0,16147,16147,0
Big Data|Big Data Analytics|Enterprise Software|SaaS,30600000.0,USA,3,23,1014,15286,16300,0
Education,195000.0,USA,3,2,311,16168,16479,0
Health Care|Medical,50000.0,USA,1,2,0,16205,16205,0
Archiving|Defense|Digital Media|Video,1525545.0,CZE,2,4,342,16000,16342,0
Discounts|E-Commerce|Shopping,386670.0,ESP,1,2,0,15623,15623,0
Business Services|Credit Cards|Payments,10000.0,MEX,1,1,0,15949,15949,0
Big Data|Commercial Real Estate|Real Estate,14390000.0,USA,5,25,760,15631,16391,0
E-Commerce,1560000.0,FRA,1,2,0,14011,14011,0
Advertising|Curated Web|Finance Technology|FinTech|Information Technology|Productivity Software|Social Media|Virtual Currency,15400000.0,USA,2,1,450,15694,16144,0
Human Resources|Software,20000000.0,USA,1,1,0,14579,14579,1
Biotechnology|Enterprise Software|Health Care Information Technology,5355250.0,USA,5,5,1043,14967,16010,0
Nonprofits,5000000.0,USA,1,1,0,12817,12817,0
Consumers|Facebook Applications|Social Media|Social Media Management|Social Media Monitoring|Software|Twitter Applications,1000000.0,THA,1,1,0,15968,15968,0
Consulting,2000000.0,USA,1,1,0,14537,14537,0
Big Data Analytics|Brand Marketing|Developer APIs|E-Commerce|Messaging|Online Scheduling|Social Media|Software|Twitter Applications,3670260.0,USA,5,1,820,15817,16637,0
Biotechnology,25900501.0,USA,2,4,587,15287,15874,0
Business Services|Curated Web,68239769.0,USA,4,12,3590,11201,14791,1
Development Platforms|Manufacturing|Sensors,195607.0,USA,1,1,0,13119,13119,0
Service Providers|Social Media,2000000.0,CHN,1,1,0,13353,13353,1
Electronics|Energy|Smart Grid,5500000.0,SWE,1,1,0,12904,12904,0
Software,155000.0,POL,1,1,0,12884,12884,1
Computers|Mobile|Web Tools,40000.0,ITA,1,1,0,16029,16029,0
Credit|Finance|Peer-to-Peer|Social Media,4807100.0,ESP,3,3,1478,13879,15357,0
Curated Web,1540000.0,FRA,1,4,0,14783,14783,0
Marketplaces|Property Management,25000.0,USA,4,4,853,15273,16126,0
Mobile,13500000.0,USA,1,3,0,13121,13121,0
Biotechnology|Health Care,62101551.0,USA,6,11,2360,13508,15868,1
B2B|Design|Reviews and Recommendations|Software,92082.0,ESP,2,2,119,15830,15949,0
Content Discovery|Machine Learning|Mobile|Personalization,7200000.0,USA,2,7,564,15340,15904,1
Software,1250000.0,USA,1,1,0,16205,16205,0
Health Care,3922003.0,GBR,1,3,0,16275,16275,0
Business Services|Enterprise Software|Marketing Automation|Marketplaces|Presentations,275000.0,USA,4,1,972,15645,16617,0
Enterprise Software|Startups|Web Development,40000.0,USA,1,1,0,15176,15176,0
Biotechnology|Health Care,99500000.0,USA,4,26,1799,13346,15145,1
Big Data Analytics|Business Intelligence|Hospitality|Machine Learning|Natural Language Processing|Predictive Analytics,500000.0,USA,1,1,0,16344,16344,0
Internet|Mobile|Social Network Media,1273700.0,USA,1,2,0,13424,13424,0
Analytics,12000000.0,USA,5,3,2541,13469,16010,0
Cloud Computing|Contact Management,2700000.0,USA,1,6,0,16722,16722,0
Software,4053915.0,GBR,2,4,886,15302,16188,0
Manufacturing,6500000.0,USA,1,3,0,15376,15376,0
Software,18800000.0,USA,2,5,1344,11920,13264,1
Cloud Computing|SaaS|Travel,15000000.0,JPN,3,6,1052,15015,16067,0
Application Performance Monitoring|Big Data|Data Integration|Developer APIs|Developer Tools|Development Platforms|Enterprise Software|Software,14900000.0,USA,3,8,1149,15074,16223,0
Software,5902201.0,GBR,3,10,2722,13446,16168,0
Finance|FinTech|Games|Mobile|Tablets|Video,6671840.0,USA,4,4,1216,15340,16556,0
Social Media,128660.0,ITA,1,7,0,16161,16161,0
Human Resources|Recruiting|Services,50000.0,USA,1,1,0,16436,16436,0
Digital Media|SaaS|Search|Search Marketing|SEO|Web Presence Management,60648126.0,USA,5,12,2970,13508,16478,0
Ad Targeting|Analytics|Developer APIs|Finance|Machine Learning|Optimization|Sales and Marketing|Software,210000.0,USA,2,2,305,15340,15645,0
Cloud Computing|Internet|Software,109800000.0,USA,3,2,2112,13330,15442,0
Games|MMO Games|Music|Social Games|Software,8500000.0,USA,2,4,776,13726,14502,1
Consulting,6000.0,BRA,1,2,0,15006,15006,0
Developer APIs|Enterprises|Payments|Search,295000.0,MEX,3,2,607,15262,15869,0
Biotechnology,257320.0,LVA,1,1,0,15959,15959,0
Advertising,1100000.0,FRA,1,2,0,13227,13227,0
Cloud Computing|SaaS|Services|Virtualization,1000000.0,USA,1,1,0,16231,16231,0
Private Social Networking|Software,500000.0,USA,1,1,0,14975,14975,0
Enterprise Software,400000.0,USA,2,3,365,14396,14761,0
Security,25000000.0,USA,2,5,656,16085,16741,0
Analytics|Ediscovery|Events|Vertical Search,1900000.0,USA,5,19,912,15048,15960,0
Curated Web,1596992.0,DNK,2,2,794,15601,16395,0
Games,127225.0,BGR,2,2,426,15979,16405,0
Messaging,1900000.0,USA,1,12,0,16105,16105,0
Hardware + Software,10335255.9966335,FIN,2,4,1057,13584,14641,0
Identity|Identity Management|Online Identity,3500000.0,USA,1,1,0,16616,16616,0
Biotechnology,20500000.0,USA,2,7,1497,12390,13887,1
Finance,60000000.0,USA,1,1,0,13384,13384,0
Biotechnology,75000.0,USA,1,1,0,14975,14975,0
Biotechnology,8870000.0,USA,6,11,1579,15065,16644,0
Clean Technology,12700000.0,USA,1,3,0,14146,14146,1
Big Data|Enterprise Software|Technology,30900000.0,USA,2,5,244,16380,16624,0
Telecommunications,14000000.0,USA,2,7,975,11332,12307,0
Software,27250000.0,USA,3,10,661,13422,14083,1
Software,11149681.0,USA,3,2,2478,14099,16577,0
Biotechnology|Health Care,219100000.0,USA,3,3,1453,14466,15919,1
Cloud Computing|Enterprise Software|Identity Management|SaaS,3000000.0,USA,1,1,0,14272,14272,0
E-Commerce,2570000.0,FRA,1,1,0,14866,14866,0
Information Technology,70000000.0,USA,1,1,0,16611,16611,0
Biotechnology|Health Care|Medical,4800252.0,GBR,2,3,130,16409,16539,0
CRM|Hospitality|Loyalty Programs,7900000.0,DEU,1,2,0,16692,16692,0
Health Care,46500000.0,USA,1,1,0,15713,15713,0
Real Estate,7270999.85942734,DEU,1,2,0,14125,14125,0
Finance|Internet|SaaS|Startups,100000.0,USA,1,1,0,15034,15034,0
Biotechnology,8500000.0,USA,1,4,0,10804,10804,0
Biotechnology,5820000.0,USA,3,2,2550,13495,16045,0
Web Hosting,934850.0,GBR,2,5,582,14748,15330,0
Information Security|Software,2625001.0,USA,2,2,355,16050,16405,0
Analytics|Big Data|Enterprise Software|Games|Predictive Analytics,173426.0,IRL,3,3,212,15737,15949,0
Mobile,2000000.0,FIN,1,1,0,14635,14635,0
Messaging|Mobile|Software,16000000.0,USA,4,17,465,15949,16414,0
E-Commerce Platforms|Mobile Commerce,135000.0,USA,2,1,208,16084,16292,0
Software,217158.0,GBR,1,2,0,15595,15595,0
Consumers|Doctors|Medical,40000.0,GBR,1,1,0,16440,16440,0
Business Services|Customer Service|Internet,500000.0,RUS,2,2,427,15034,15461,0
Enterprise Software,12294999.0,USA,4,2,1554,15014,16568,0
Software,3500000.0,USA,1,1,0,13711,13711,0
Application Platforms|B2B|Service Providers,28000.0,USA,1,1,0,15522,15522,0
Networking|Software,500000.0,USA,1,6,0,15154,15154,1
Software,53500000.0,USA,2,14,553,10924,11477,1
Analytics,6745000.0,USA,3,4,818,15405,16223,1
Mobile|Mobile Health,400000.0,SGP,1,3,0,15050,15050,0
EdTech|Education,28703843.0,USA,5,4,1520,14438,15958,0
Mobile,400000.0,USA,1,1,0,15476,15476,0
Mobile|NFC,10600000.0,BRA,1,3,0,16688,16688,0
Artificial Intelligence|Career Management|Enterprise Software|Machine Learning|Recruiting|SaaS|Search|Social Search,11699999.0,USA,3,15,1163,15572,16735,0
Software,17000000.0,USA,1,4,0,14145,14145,0
Big Data|Business Intelligence|Enterprise Application|Internet|Marketing Automation|SaaS|Search|Small and Medium Businesses|Social Media Monitoring,6350000.0,USA,1,7,0,16184,16184,0
Intellectual Asset Management|M2M|Mobility|Security|Software|Telecommunications,10000000.0,IND,2,3,1131,13691,14822,0
Information Technology|Search,130000.0,NGA,1,1,0,14641,14641,0
Collaboration|Enterprise Software|SaaS|Services|Unifed Communications|Video|Video Conferencing|Video Streaming|VoIP,12000000.0,USA,2,1,1016,15715,16731,0
Media|News|Technology,20000.0,USA,1,1,0,15967,15967,0
Software,23500000.0,USA,2,5,2631,12937,15568,1
Colleges|EdTech|Education|Facebook Applications|Messaging|Mobile|Social Media|Twitter Applications,3450000.0,USA,4,2,1890,14791,16681,0
Apps|Communities|Q&A|Women,1250000.0,JPN,1,2,0,16498,16498,0
Software,394842.0,GBR,1,1,0,14881,14881,0
Advertising,5000000.0,USA,3,5,651,14903,15554,1
Analytics|Big Data|Business Intelligence|Data Mining|Enterprises,12250000.0,USA,2,4,674,14768,15442,0
Curated Web|Procurement|Small and Medium Businesses|Software|Supply Chain Management,4200000.0,USA,3,10,1392,15286,16678,0
Business Intelligence|Design|Outsourcing,24509.0,MEX,1,1,0,16130,16130,0
Startups,6000000.0,IND,1,2,0,11540,11540,0
E-Commerce|Green|Natural Resources|Organic|Subscription Businesses|Sustainability,1384000.0,USA,1,7,0,15822,15822,1
Biotechnology,12000000.0,USA,2,1,1358,14985,16343,0
Enterprise 2.0|Enterprise Software|Market Research,5938758.0,USA,6,8,941,15069,16010,0
Consulting,67400000.0,USA,4,18,1281,12982,14263,0
Software,8500000.0,USA,1,3,0,12128,12128,1
Accounting|Cloud Management|Financial Services,5000000.0,USA,1,1,0,16450,16450,0
Agriculture|Software,23649999.0,USA,3,3,1022,15680,16702,0
E-Commerce,40000.0,USA,1,1,0,15712,15712,0
Software,2000000.0,SGP,2,1,201,14610,14811,0
App Marketing|Baby Accessories|Curated Web|Mobile Shopping,565000.0,USA,1,3,0,15678,15678,1
Clean Technology,200000.0,USA,1,1,0,14097,14097,0
Hospitals,12600000.0,USA,1,1,0,16637,16637,0
Advertising,10200000.0,USA,2,4,376,13472,13848,1
Hospitals|Medical|Pharmaceuticals,1360010.0,USA,3,2,319,16324,16643,0
Analytics|Email|Professional Networking,3535026.0,USA,3,3,567,15719,16286,0
Advertising|Email|Email Marketing|Event Management|Internet Marketing|Messaging|Social Media Marketing,8159714.0,USA,2,4,2739,12024,14763,1
Advertising|Business Intelligence|Sales and Marketing,16666.0,USA,1,1,0,15708,15708,0
Advertising Platforms|Brand Marketing|E-Commerce Platforms|PaaS|Retail Technology,2029585.0,GBR,4,1,562,15520,16082,0
Health Care|Healthcare Services|Technology,61000000.0,USA,1,2,0,12804,12804,1
Biotechnology,154450000.0,USA,5,15,1819,14469,16288,0
Business Analytics|Consulting|Market Research|Technology,3000000.0,USA,1,3,0,15584,15584,0
Architecture|Commercial Real Estate|Construction|Software,13154038.0,USA,2,5,921,13483,14404,1
Event Management|Risk Management|Security,14816145.0,NLD,3,6,4710,10531,15241,1
Digital Media|E-Commerce|EdTech|Education|Social Media Marketing,25000.0,USA,2,1,61,16211,16272,0
Brand Marketing|Domains|Web Hosting,1600000.0,USA,2,2,199,15457,15656,0
Health and Wellness,2805480.0,USA,2,2,246,14487,14733,0
Hardware,15981216.0,ISR,6,7,970,15627,16597,0
Consumers,17000000.0,USA,1,4,0,13783,13783,0
Finance|Financial Services|FinTech|Insurance|Sales and Marketing,70200004.0,USA,3,7,1329,14846,16175,0
Curated Web|Social Media,300000.0,USA,1,5,0,15185,15185,0
Information Technology,10000000.0,USA,1,2,0,11196,11196,0
Chat|Software|Text Analytics,3000000.0,USA,1,1,0,15468,15468,1
Software,46000000.0,USA,1,1,0,14860,14860,0
Databases|Media|Public Relations,118000.0,GBR,1,1,0,16601,16601,0
Email Marketing|Software,4996533.0,ITA,1,1,0,16393,16393,0
Software,800000.0,CAN,1,1,0,15418,15418,0
Collaboration|Curated Web|Messaging|SaaS,1600000.0,BEL,1,1,0,11376,11376,0
Android|Apps|Contact Management|iPhone|Mobile|Productivity Software|Social Media|Social Network Media|Software|Utilities,1000000.0,USA,1,6,0,15618,15618,0
Hardware + Software,9000000.0,USA,1,1,0,13264,13264,1
CRM|Email|Productivity Software|SaaS|Sales and Marketing|Software,14828807.0,USA,5,18,1482,15273,16755,0
Advertising|Internet Marketing|Lead Generation,1000000.0,USA,3,9,329,15720,16049,1
Software,5349905.0,USA,3,2,582,15910,16492,0
Software,2932113.0,GBR,4,11,1142,15279,16421,0
Medical Devices,5600000.0,USA,1,4,0,16542,16542,0
Big Data Analytics|Brand Marketing|E-Commerce,5500000.0,USA,3,10,282,16055,16337,0
Advertising|Big Data|Business Intelligence|Content|Portals|Publishing|SaaS|Software,3500000.0,DEU,2,4,315,14931,15246,0
Enterprise Software,2000000.0,USA,1,8,0,15862,15862,0
Analytics|Internet of Things,992250.0,USA,3,3,348,15562,15910,1
Cloud Computing|Content|Enterprise Software|Internet|Marketplaces|Media|News|Publishing,1500000.0,ARE,2,1,66,14249,14315,0
Analytics|Brand Marketing|Digital Media,244721.827148951,BGR,3,3,396,16191,16587,0
Advertising|Enterprise Software|Social Media Marketing,40000.0,TUR,1,1,0,15430,15430,0
Software,40000.0,NZL,1,1,0,15670,15670,0
Brand Marketing|Content|Content Creators|Content Delivery|Digital Media|Enterprise Software|Marketplaces|SaaS,12325014.0,USA,5,16,912,15173,16085,0
Digital Media|Publishing,757591.0,GBR,1,2,0,15764,15764,0
Advertising,450000.0,USA,1,3,0,16750,16750,0
Mobile,66000000.0,USA,2,1,846,13776,14622,0
Health and Wellness,3500000.0,USA,1,3,0,16771,16771,0
Advertising|Apps|Contests|Facebook Applications|Gambling|Gamification|Internet|Mobile|Photography|Polling|Promotional|Weddings,336000.0,ESP,1,1,0,15584,15584,0
Analytics|Predictive Analytics,44300000.0,USA,5,17,819,15519,16338,0
Data Centers|Networking|Software|Virtualization,23817000.0,USA,3,13,2131,13665,15796,1
Advertising|Analytics|Auctions,63500000.0,USA,5,14,2668,12570,15238,0
Credit|Finance,15000.0,USA,1,2,0,15579,15579,1
Gps|Location Based Services,3000000.0,CAN,1,1,0,13671,13671,0
Consumer Electronics|Databases|Hardware + Software|Open Source|PaaS|SaaS|Software,5750000.0,USA,1,3,0,13087,13087,0
Health Diagnostics|Software,16492907.0,USA,5,8,1637,14671,16308,0
Software,9500000.0,USA,2,2,124,13027,13151,0
Data Integration|M2M|Mobile|Security,36000000.0,USA,2,10,1168,11409,12577,1
Analytics|Big Data|Consulting|Enterprise Software|Open Source|Training|Visualization,34000000.0,USA,5,4,1072,15566,16638,0
Biotechnology,25450000.0,USA,2,2,847,15909,16756,0
Manufacturing|Networking|Telecommunications,17500000.0,USA,1,6,0,12514,12514,0
Biotechnology,20500000.0,USA,2,5,1034,15603,16637,0
Biotechnology,2728659.0,USA,2,1,392,15847,16239,0
Data Center Automation|Data Integration|Design,8000000.0,USA,1,2,0,12079,12079,1
Big Data|Big Data Analytics|Finance Technology|FinTech|Mobile|Text Analytics,1585000.0,USA,1,1,0,15795,15795,0
Clean Technology,39200000.0,USA,3,10,769,14484,15253,0
Internet,1900000.0,USA,3,7,202,16206,16408,0
E-Commerce,40000.0,CHL,1,1,0,15380,15380,0
Curated Web|Legal,46177.0,CAN,1,1,0,14396,14396,0
Biotechnology,48793158.0,USA,4,2,1767,14844,16611,0
Software,10000000.0,USA,1,1,0,15548,15548,1
B2B|Enterprise Search|Marketplaces,47917.0,COL,1,1,0,15857,15857,0
Apps|Business Intelligence|FinTech|Payments|Real Time|Software,1500000.0,CAN,1,2,0,16595,16595,0
Health Care,39745.0,VEN,1,1,0,16040,16040,0
Health Care,3000000.0,USA,1,1,0,14391,14391,0
Hardware + Software|Home Automation,93000000.0,USA,7,23,2658,12648,15306,1
Data Centers|Web Hosting,9079060.0,GBR,1,1,0,14684,14684,1
Security,8247532.0,USA,5,2,1694,14400,16094,0
Software,302938.0,IND,1,1,0,16756,16756,0
Enterprise Software|Events|Information Technology|Meeting Software,25500000.0,USA,2,4,708,15895,16603,0
Mobile,5792000.0,SWE,3,4,612,13695,14307,1
Biotechnology,74328566.0,USA,5,10,984,15768,16752,0
Enterprise Software,30724998.0,USA,3,6,787,15734,16521,0
Enterprise Software,8000000.0,USA,1,1,0,13165,13165,0
Security|Service Providers|VoIP,15000000.0,USA,1,3,0,13842,13842,0
Biotechnology,35400000.0,GBR,1,3,0,14887,14887,1
Biotechnology,32035151.0,USA,5,3,1292,15233,16525,0
Architecture|Hardware|Networking|Storage,11406000.0,USA,1,1,0,15522,15522,0
Web Hosting,10000000.0,ISR,1,1,0,14194,14194,1
Fitness|Health and Wellness|Mobile Health|Speech Recognition,25000.0,USA,1,2,0,16254,16254,0
Analytics|SaaS|Software,5100000.0,USA,2,11,237,16296,16533,0
Call Center Automation|Customer Service|Customer Support Tools|Facebook Applications|Social Media|Social Media Management|Software|Twitter Applications,23961622.0,USA,6,11,1609,15118,16727,0
Enterprise Software,5775596.0,FRA,2,2,1713,14489,16202,0
Advertising|Optimization,5000000.0,USA,3,6,1474,14245,15719,1
Security,1500000.0,USA,3,4,607,15777,16384,0
Hardware + Software,58641287.0,USA,4,14,2122,13724,15846,0
Software,42750000.0,USA,4,20,2239,11410,13649,1
Analytics|Optimization|Software|Video|Video Streaming,69000000.0,USA,5,15,2526,13613,16139,0
Collaboration|Enterprises|Enterprise Software|Events|Networking|Productivity Software|SaaS|Social Media|Twitter Applications|Web Development,6309000.0,USA,4,4,2238,13726,15964,0
Messaging,500000.0,USA,1,1,0,14923,14923,0
Software,5500000.0,USA,1,2,0,14816,14816,0
Software,10000000.0,USA,1,2,0,12363,12363,0
Services,2500000.0,USA,1,19,0,16734,16734,0
Collaboration|Curated Web|Publishing,50000.0,USA,1,2,0,14975,14975,0
Contact Management|Curated Web|Databases,80000.0,USA,2,2,305,15095,15400,0
Manufacturing,32100000.0,USA,2,2,2689,13858,16547,0
Language Learning,1080000.0,JPN,3,2,1310,14669,15979,0
E-Commerce,770274.0,ESP,1,1,0,16335,16335,0
Software,2240733.0,FRA,1,2,0,16679,16679,0
Ad Targeting|Advertising|App Marketing|Brand Marketing|Curated Web|Market Research|Social Media|Weddings,166791.0,GBR,1,1,0,16128,16128,0
E-Commerce|Mobile|Public Transportation|Training|Transportation,1910000.0,USA,2,2,182,14883,15065,0
Delivery|Hospitality,405279.0,FRA,1,1,0,16156,16156,0
Curated Web|Marketplaces,25000.0,USA,1,1,0,16130,16130,0
Apps|Cooking,120959.0,GBR,2,2,92,16283,16375,0
Manufacturing,3384000.0,USA,1,3,0,16521,16521,0
Adventure Travel|Bicycles|Online Reservations,16674.0,CHN,1,1,0,16616,16616,0
P2P Money Transfer,1600000.0,DEU,1,7,0,16740,16740,0
Cooking|E-Commerce|Recipes,107500000.0,USA,7,26,4632,10682,15314,0
Collaborative Consumption|Curated Web|Hospitality,265199.0,GBR,1,1,0,15918,15918,0
Delivery|Hospitality|Startups,75000.0,USA,1,2,0,15126,15126,0
E-Commerce|Food Processing|Local Services|Marketplaces,362000.0,USA,2,1,12,16455,16467,0
Hardware + Software,458933.0,USA,1,1,0,15329,15329,0
Clean Technology,146769846.0,MEX,7,21,2114,14573,16687,0
Analytics|Big Data,7400000.0,ISR,2,3,218,16000,16218,0
Console Gaming|Data Centers|Energy Efficiency|Hardware|PC Gaming,8890000.0,USA,7,5,1068,15442,16510,0
Clean Technology|Solar,22750000.0,USA,3,1,287,13642,13929,0
Clean Technology,7200000.0,USA,1,2,0,14921,14921,0
Software,75000.0,USA,2,1,1472,14920,16392,0
Consumer Electronics|Hardware + Software|Internet|Networking,125000.0,USA,2,2,355,14744,15099,0
Messaging|Mobile|Mobile Social|Photo Sharing,28100000.0,USA,3,8,1324,13695,15019,1
Manufacturing,10000000.0,CAN,2,4,719,14533,15252,0
Startups,1500000.0,USA,1,4,0,16412,16412,0
Health Care,11250000.0,USA,4,4,1389,13731,15120,0
Clean Technology,12398700.0,FRA,2,5,257,15805,16062,0
Analytics|Collaborative Consumption|Mobile|Social Commerce,50000.0,PER,1,2,0,16202,16202,0
Software,10000003.0,USA,2,2,394,15893,16287,0
Software,10000000.0,IND,1,2,0,14571,14571,0
Analytics,71426633.0,USA,4,13,1268,13215,14483,1
Enterprise Software,16200000.0,USA,2,4,929,13608,14537,0
Local Businesses,4899605.0,USA,3,2,480,15505,15985,1
Curated Web,7000000.0,USA,2,3,393,15140,15533,0
Software,4901574.0,USA,3,6,594,14854,15448,1
Education,2190511.0,USA,3,8,751,15875,16626,0
Clean Energy|Impact Investing|Wealth Management,850000.0,CAN,1,1,0,16716,16716,0
Enterprise Software,4100000.0,USA,2,3,301,15167,15468,1
Security,627300.0,IRL,1,2,0,15487,15487,0
Semiconductors,14500000.0,ISR,1,3,0,13109,13109,1
Software,2200000.0,USA,1,3,0,13381,13381,0
Consumer Electronics|Mac|Music|Software,900000.0,USA,2,3,234,15943,16177,0
EdTech|Education|Games|Gamification|High Schools|ICT|Kids|Language Learning|Mobile|Publishing|Skill Assessment|Software,126980.0,SRB,2,2,61,16314,16375,0
EdTech|Education|Educational Games|Gamification|ICT|K-12 Education|Kids|Language Learning|Mobile|Skill Assessment|Software,126457.0,BGR,1,1,0,16344,16344,0
Social Media,6280622.0,USA,13,36,2242,14502,16744,0
Legal,40000.0,DNK,1,1,0,16028,16028,0
SaaS|Software,27700000.0,USA,2,7,674,13017,13691,1
Storage,114300000.0,USA,4,16,1461,14579,16040,0
Health and Wellness,6342950.0,DEU,2,3,562,16117,16679,0
Software,4000000.0,USA,1,1,0,13537,13537,0
Manufacturing,41784600.0,USA,5,4,1529,15075,16604,0
Clinical Trials|Health Care|Medical,18000000.0,USA,1,2,0,11975,11975,1
Messaging|Mobile|Social Media,1800000.0,USA,1,16,0,16317,16317,0
Software,3307790.0,USA,1,1,0,14732,14732,0
Business Development|Data Integration|PaaS|SaaS|Software,80000000.0,NLD,1,2,0,13621,13621,1
Biotechnology|Health Diagnostics,5000000.0,IND,1,1,0,15522,15522,0
Biotechnology,18432029.0,USA,4,4,1316,14067,15383,0
Software,22500000.0,USA,2,2,390,16233,16623,0
Security,4500000.0,USA,1,1,0,12884,12884,0
Data Mining,4300000.0,USA,1,1,0,16315,16315,0
Consulting|Enterprise Software|Services,25000000.0,USA,1,5,0,11443,11443,1
Software,29000000.0,USA,2,2,617,15952,16569,0
Services,573000000.0,USA,1,9,0,11120,11120,1
Software,13600000.0,USA,1,2,0,14068,14068,0
Manufacturing,3200000.0,ISR,1,2,0,13634,13634,0
Advertising|Analytics|Optimization,91000000.0,USA,2,5,757,13216,13973,1
Clinical Trials|Diabetes|Health and Wellness|Security,322500.0,USA,3,1,339,15336,15675,0
Web Hosting,89500000.0,DEU,4,22,2029,11941,13970,1
Linux|Security|Software|Web Hosting,20000000.0,USA,4,11,766,15765,16531,0
Health Care,5685000.0,USA,2,2,809,13920,14729,0
Semiconductors,17800000.0,ISR,1,6,0,16468,16468,0
Security,14500000.0,USA,1,6,0,12303,12303,0
Hardware + Software,1801500.0,SWE,1,2,0,14769,14769,1
Finance,4000000.0,USA,1,1,0,12614,12614,0
Cloud Computing|Enterprises|Enterprise Software|Mobility|Software,26200031.0,CHE,2,2,307,16016,16323,0
Security,20404494.0,USA,5,3,1736,13826,15562,1
Clean Technology,5303380.0,GBR,1,2,0,16127,16127,0
Cloud Computing|E-Commerce|Enterprise Software|SaaS,26670000.0,CAN,3,7,2083,12877,14960,0
Biotechnology,3000000.0,AUT,1,1,0,14809,14809,0
Biotechnology|Health Diagnostics,8067308.0,DEU,2,4,607,13535,14142,1
Networking|Network Security|Optical Communications,41300000.0,USA,2,5,820,11620,12440,0
Health Care,40000000.0,USA,1,3,0,13782,13782,1
Software,3000000.0,GBR,1,3,0,12377,12377,0
Software,5000.0,USA,1,1,0,16003,16003,0
Financial Services|Risk Management|Technology,1131729.0,IRL,1,2,0,16604,16604,0
Health Care,1000000.0,USA,2,2,973,14245,15218,0
Career Management|EdTech|Education|Enterprises|Software|Training,44700000.0,USA,3,7,1283,13773,15056,1
Biotechnology,19179100.0,USA,4,1,1908,14228,16136,0
Hardware + Software,148000000.0,USA,2,11,656,12475,13131,0
Biotechnology,10885000.0,USA,4,2,2102,12879,14981,0
Health and Wellness,2000000.0,USA,1,2,0,14923,14923,0
Android|Apps|Games|iPad|iPhone|Mobile|Software,3000000.0,USA,3,4,1079,14579,15658,1
Biotechnology|Health Care|Pharmaceuticals,62758534.0,USA,5,1,701,14460,15161,1
Social Media,100000.0,USA,1,1,0,15647,15647,0
Enterprise Software|iOS|Mobile|PaaS,300000.0,USA,1,1,0,16618,16618,0
Energy|Renewable Energies,9415005.40471479,SWE,2,1,139,16602,16741,0
Social Media,4500000.0,USA,1,3,0,15609,15609,0
Collaboration|Mobile|Transportation,600000.0,USA,1,3,0,16142,16142,1
Analytics,8620000.0,USA,3,7,2948,11674,14622,1
Analytics,1920000.0,ITA,1,1,0,13293,13293,0
Enterprise Software,11400000.0,USA,4,12,2551,12833,15384,1
Software,21000000.0,USA,6,20,2267,13696,15963,0
Biotechnology,27620904.0,USA,4,16,1561,14175,15736,0
Software,20000000.0,USA,2,8,742,12936,13678,1
Construction,13000000.0,USA,1,1,0,12559,12559,0
Hardware + Software,20700000.0,CAN,2,4,613,15901,16514,0
Game|Hardware + Software,80000000.0,USA,2,2,1418,14413,15831,1
Software,530338.0,USA,1,1,0,16059,16059,0
Social Media,107363.0,ITA,2,2,791,15065,15856,0
Biotechnology,7122120.0,DEU,2,2,661,15257,15918,0
Biotechnology,71724981.0,SWE,3,6,260,16373,16633,1
Finance,60699922.0,USA,4,5,2540,13998,16538,0
Artificial Intelligence|Social Media|Social Media Marketing,500000.0,USA,1,2,0,16519,16519,0
Brand Marketing|Graphics|Search|Software|Systems|Tracking|Video|Visualization|Wine And Spirits,6656887.0,GBR,3,3,2267,14245,16512,0
Semiconductors,1000000.0,USA,2,1,116,16233,16349,0
Biotechnology,23000000.0,USA,1,3,0,13867,13867,1
Advertising|Computer Vision|Publishing|Search,37900000.0,USA,4,7,2625,13514,16139,0
Delivery|E-Commerce|Groceries|Local|Organic Food,2473660.18739323,ITA,2,4,999,15380,16379,0
Hardware|Hardware + Software|Semiconductors|Software,162000000.0,USA,2,20,397,13005,13402,1
Software,8500000.0,IRL,2,2,614,13601,14215,0
Health Care|Health Care Information Technology|Sensors,1674801.38667086,DNK,2,2,442,16308,16750,0
Pharmaceuticals,19049982.0,USA,2,2,224,16188,16412,0
Pharmaceuticals,60000000.0,USA,1,17,0,12521,12521,0
Consulting|New Product Development,60000.0,ARG,1,1,0,14396,14396,0
Email,5500000.0,USA,1,1,0,12317,12317,1
Enterprise Software,31480000.0,USA,2,6,1251,12818,14069,0
Contact Centers|Software|Telecommunications,30000000.0,USA,1,1,0,16247,16247,0
Bio-Pharm,108500000.0,USA,2,1,298,16405,16703,0
Manufacturing,2368582.0,CHN,1,2,0,11354,11354,0
Clean Technology,86220000.0,USA,5,26,1998,13949,15947,0
Biotechnology|Pharmaceuticals|Product Development Services,50000000.0,USA,1,1,0,16356,16356,0
E-Commerce,356139.0,KOR,2,2,511,15775,16286,0
Application Platforms|Design,5200000.0,FRA,1,2,0,16160,16160,0
Chat|Contact Centers|Customer Service|Public Relations,15300000.0,USA,1,1,0,10897,10897,0
Development Platforms|Games|Video Games,40143.0,MEX,1,1,0,16495,16495,0
Electronics|Telecommunications,3700000.0,ESP,1,2,0,16336,16336,0
Collaboration|Enterprises|Enterprise Software|Mobile,15500000.0,USA,2,4,245,15853,16098,0
Content Delivery|Software,36000000.0,USA,4,12,1261,13879,15140,1
Health Care|Medical|Medical Devices,14382422.0,USA,3,3,805,15614,16419,0
Social Media,1500000.0,USA,1,2,0,15604,15604,0
Aerospace|Heavy Industry|Procurement,24841531.728846397,DEU,1,1,0,15491,15491,0
E-Commerce,9500000.0,USA,2,16,245,16273,16518,0
Curated Web,165000.0,CHL,3,5,276,15673,15949,0
Advertising|CRM|Twitter Applications,1100000.0,USA,1,6,0,14434,14434,1
Curated Web|Graphics|Photography|Video,3500000.0,RUS,2,3,376,15904,16280,0
Business Services|Internet,3100000.0,JPN,2,4,358,16188,16546,0
Analytics|Big Data|Databases|Enterprise Software,116000000.0,USA,6,20,2002,14245,16247,0
Apps|E-Commerce|Mobile Commerce|Web Development,1740690.0,DEU,4,5,320,15631,15951,0
Software,2000000.0,USA,1,1,0,14571,14571,0
Hospitality|Hotels|Social Media|Social Network Media|Social Search|Travel,22600000.0,USA,2,8,364,15210,15574,0
Social Media,130213.0,ECU,3,3,218,15344,15562,0
Advertising|Internet|Publishing|Video,6000000.0,GBR,2,3,863,15280,16143,0
Clean Technology,113993598.0,USA,7,19,2010,14270,16280,0
Biotechnology|Technology,103795000.0,USA,6,7,1514,14684,16198,0
Internet|Maps|Real Time,18000.0,USA,1,1,0,15857,15857,0
Risk Management|Sales and Marketing|Security,20000000.0,USA,1,7,0,12066,12066,1
Security,9500000.0,USA,1,3,0,13129,13129,1
Cloud Security|Security,67435732.0,USA,7,22,1728,14975,16703,0
Business Services|Service Providers|Taxis|Transportation|Travel|Travel & Tourism,16833.1275951072,IND,1,1,0,15878,15878,0
Health Care|Hospitals|Medical Devices,4566441.72712974,GBR,1,1,0,16199,16199,0
Cloud Infrastructure|Enterprise Software|Procurement|SaaS,169000000.0,USA,7,28,3002,13585,16587,0
Consumer Goods,75000.0,USA,1,1,0,12957,12957,0
E-Commerce,1418000000.0,KOR,5,15,1805,14783,16588,0
Coupons|Curated Web,500000.0,SGP,1,3,0,15980,15980,0
Advertising|Coupons|Curated Web|Discounts|Sales and Marketing,1000000.0,USA,1,1,0,14811,14811,0
Messaging,4200000.0,USA,1,14,0,15462,15462,0
Social Media,40000.0,USA,1,1,0,15308,15308,0
Advertising|Mobile|Mobile Games|Sales and Marketing,50000.0,SGP,1,2,0,14975,14975,0
Coupons|Curated Web,54000000.0,USA,1,1,0,15267,15267,0
E-Commerce,100000.0,ISR,1,1,0,16490,16490,0
Advertising|Coupons|Curated Web,276760000.0,USA,7,6,2952,13027,15979,1
Commercial Real Estate|Real Estate,1369963.0,USA,3,1,897,15761,16658,0
Software,9840000.0,USA,3,1,3359,12081,15440,0
Crowdsourcing|Education|Marketplaces,17393000.0,USA,6,27,2933,13452,16385,0
EdTech|Education,12000000.0,USA,1,2,0,13396,13396,0
Curated Web|EdTech|Education|Internet|Technology,1800000.0,USA,2,7,500,15624,16124,0
Enterprise Software,1640000.0,USA,1,1,0,15474,15474,0
Mobile|Service Providers|Services,62000.0,USA,1,1,0,16455,16455,0
All Students|Career Management|Education|Employment|Recruiting|Social Media|Social Network Media|Software|Systems|Web Tools,60000.0,CAN,1,2,0,15614,15614,0
EdTech|Education,146100000.0,USA,6,19,1287,15448,16735,0
All Students|Cloud Computing|Colleges|EdTech|Education|Publishing|Skill Assessment|Systems|Technology|Textbooks,600000.0,USA,1,1,0,15706,15706,0
E-Books|Online Education|Publishing,219131.0,DEU,1,1,0,16587,16587,0
Education,1280000.0,USA,2,6,222,16246,16468,0
Biotechnology,34272598.0,USA,5,8,2007,14610,16617,0
Finance|FinTech,3780000.0,FRA,1,2,0,14579,14579,0
Mobile,1359200.0,FRA,1,1,0,12784,12784,0
Information Technology|Legal|Services,15000000.0,USA,1,3,0,10927,10927,1
Big Data Analytics|Enterprise Software|Information Technology|Services,450000.0,IND,3,4,638,15607,16245,0
Biotechnology,90505207.0,CHE,5,17,1599,14522,16121,1
Information Services|Marketplaces,3500000.0,USA,2,2,492,15537,16029,0
Software,447000.0,GBR,1,1,0,13172,13172,0
Biotechnology,2590000.0,CHE,2,6,398,12815,13213,0
Advertising|Analytics|Content|Social Media,16000000.0,USA,2,4,341,13538,13879,1
Finance,11000000.0,CAN,4,16,1576,13297,14873,1
Analytics,1100000.0,USA,2,1,184,15775,15959,0
Cloud Security|Data Security|Software,21900000.0,USA,2,2,379,16383,16762,0
Finance,11900000.0,USA,2,2,199,15985,16184,0
Hardware + Software,27000000.0,USA,2,12,1251,12117,13368,0
Software,789000.0,GBR,1,2,0,13137,13137,0
Biotechnology,76336992.0,USA,14,3,1756,14330,16086,0
Advertising|Education|Fashion,3000000.0,USA,1,2,0,16484,16484,0
Enterprise Software|Search,69700000.0,CAN,5,19,3298,13446,16744,0
Health and Wellness|Insurance,15400000.0,USA,2,7,124,16451,16575,0
Insurance,12000000.0,IND,1,2,0,16549,16549,0
Cars|Finance|FinTech,56731487.0,USA,6,20,1666,15034,16700,0
Blogging Platforms|Curated Web|Events,1000000.0,USA,1,2,0,14273,14273,1
Enterprise Software|Open Source,22000000.0,USA,1,2,0,13910,13910,1
Health Care Information Technology|Pharmaceuticals|Software,250000.0,USA,2,2,1457,14922,16379,0
Consumer Electronics|Consumers|Hardware + Software|Mobile|Personalization,3800000.0,USA,2,8,340,14457,14797,0
Finance|FinTech|Stock Exchanges,23850000.0,USA,4,10,2204,13665,15869,1
Apps,25000.0,USA,2,2,278,16222,16500,0
Security,34010000.0,USA,3,12,969,12794,13763,0
Software,7000000.0,USA,1,3,0,13714,13714,1
Coworking|Office Space|Services,1500000.0,SGP,1,3,0,16595,16595,0
Freelancers|Startups,20313.0,ESP,1,1,0,15988,15988,0
Crowdsourcing|Curated Web|Information Technology,1950000.0,USA,2,2,570,14933,15503,0
Accounting|Bitcoin|Finance Technology,3118.0,DEU,1,1,0,16401,16401,0
Events|Hospitality|Journalism|Mobile|Shopping,5800000.0,USA,1,3,0,15736,15736,1
Curated Web|Online Scheduling|Tracking,29557587.0,USA,8,4,2583,13118,15701,0
Finance|Online Rental|Property Management|Real Estate,9868996.0,USA,3,12,1051,15617,16668,0
Open Source|PaaS|Web Hosting,1100000.0,FRA,1,2,0,16226,16226,0
Financial Services|Internet|Service Providers|Social Media|Software,500000.0,RUS,1,1,0,15738,15738,0
Software,11658743.0,USA,4,1,2299,12829,15128,0
Software,580000.0,URY,1,1,0,14377,14377,0
Consulting,100000000.0,BRA,1,1,0,14033,14033,1
Clean Technology,27680000.0,USA,2,11,578,13783,14361,1
Cloud Computing|Enterprise Software|PaaS|Startups,925000.0,USA,1,4,0,15958,15958,0
Advertising|Curated Web|Internet Marketing,30000000.0,USA,1,1,0,16155,16155,0
Software,15065000.0,IRL,3,4,2599,12920,15519,0
Consumer Electronics|Content|Entertainment|Games|Internet|Television|Video,1750000.0,USA,1,2,0,13118,13118,0
Hardware + Software,46500000.0,USA,3,15,918,12226,13144,0
Hardware + Software,65628255.0,USA,5,6,2086,14452,16538,0
Coffee|E-Commerce|Subscription Businesses,320000.0,USA,2,3,1049,15218,16267,0
E-Commerce,54500000.0,IND,4,12,1490,15266,16756,0
Curated Web,13500000.0,USA,1,1,0,12644,12644,0
Clean Technology,8665093.0,CAN,3,1,877,15181,16058,0
Curated Web|Education,9000000.0,USA,2,2,566,14147,14713,1
Fashion,340000.0,CHL,2,2,399,15686,16085,0
Enterprise Software,23500000.0,USA,2,13,1373,11953,13326,0
Mobile,6000000.0,USA,2,12,180,15260,15440,1
Big Data|Big Data Analytics|Cloud Computing|Storage,1500000.0,AUT,1,2,0,16184,16184,0
E-Commerce|E-Commerce Platforms|Subscription Businesses|Web Hosting,4000000.0,USA,1,2,0,16357,16357,0
SexTech|Toys,2400000.0,USA,2,2,469,15967,16436,0
E-Commerce,6469163.0,GBR,1,1,0,16304,16304,0
Marketplaces|SaaS|Web Design,1500000.0,USA,1,12,0,16555,16555,0
Analytics|Big Data|Big Data Analytics|Business Analytics|Data Mining|Technology,5338400.0,SGP,3,3,232,15887,16119,0
Design|E-Commerce|Optimization|SaaS,316770.550912597,ISR,2,3,638,16071,16709,0
Biotechnology,51145047.6778772,GBR,2,4,1215,14036,15251,0
Analytics,1364400.0,ITA,1,1,0,15739,15739,0
Design|Graphics|Social Media,4100000.0,FRA,1,1,0,16162,16162,0
E-Commerce|Fashion|Lifestyle|Mobile|Shopping,100000.0,USA,1,2,0,16409,16409,0
Financial Services,6200000.0,LVA,1,1,0,16402,16402,0
Enterprises|Enterprise Software,4000000.0,CHN,1,1,0,14000,14000,0
Big Data|Corporate Training|Intellectual Property,826956.0,GBR,1,1,0,16071,16071,0
Architecture|Construction|Finance|FinTech|Maps|Project Management,2800000.0,USA,2,6,585,16010,16595,0
Travel,2179030.0,FIN,2,6,246,16247,16493,0
Health Care Information Technology|Health Diagnostics|Medical,5000000.0,USA,1,1,0,15910,15910,0
Art|Crowdsourcing|Design|Music|Social Media,833197.0,USA,2,2,12,15058,15070,0
Consulting|Web Design,50000.0,USA,1,1,0,14061,14061,0
Business Intelligence|Business Productivity|Enterprise Software|Human Resources|Internet|Productivity|Small and Medium Businesses|Software,1500000.0,USA,5,2,1208,15287,16495,0
Education,29500000.0,USA,3,8,401,15622,16023,0
Creative|Design|Marketplaces|Public Relations,2300000.0,USA,2,7,464,15034,15498,1
Software,767000.0,GBR,2,3,1294,13422,14716,0
EdTech|Education,20000.0,USA,1,2,0,16275,16275,0
Enterprises|Enterprise Software,2420000.0,CHN,1,1,0,11354,11354,0
Automotive|Cloud Computing|Sports,50000.0,PER,2,3,245,16222,16467,0
Security,21000000.0,USA,3,7,2283,12031,14314,1
Finance,14301880.0,USA,4,18,586,16129,16715,0
Financial Services,8000000.0,USA,1,3,0,16566,16566,0
Software,90000.0,USA,3,4,447,15379,15826,0
Financial Services|FinTech|Risk Management,27000000.0,GBR,2,3,370,16260,16630,0
Banking|Finance Technology|Financial Services|Software,15000.0,USA,1,1,0,16495,16495,0
Credit|Finance|Personal Finance,368000000.0,USA,6,20,2442,14167,16609,0
Finance|FinTech,35350000.0,USA,4,16,1839,14728,16567,0
Financial Services,20352.0,BWA,1,1,0,16272,16272,0
Finance,20000000.0,CHN,2,3,395,14700,15095,0
Financial Services,6500000.0,USA,2,5,538,15840,16378,0
Financial Services|FinTech|Indians,2500000.0,IND,1,3,0,16612,16612,0
Finance,1000000.0,USA,1,1,0,15554,15554,0
Credit|Credit Cards|Curated Web|Lead Generation|Startups,580000.0,USA,1,6,0,14488,14488,0
Banking,15931.0,IND,1,1,0,16536,16536,0
Consumer Lending|Finance,39450000.0,USA,2,3,327,16130,16457,0
Construction,12500000.0,USA,1,1,0,16363,16363,0
Finance,34000000.0,COL,1,1,0,16342,16342,0
Semiconductors,8000000.0,CHN,1,1,0,16678,16678,0
Semiconductors,8000000.0,USA,1,1,0,16678,16678,0
E-Commerce,80000000.0,USA,4,5,1134,15236,16370,0
Internet|Social Network Media,18852.0,DEU,1,1,0,15586,15586,0
Health Care Information Technology|Medical|Medical Professionals|SaaS,1500000.0,USA,2,5,613,15974,16587,0
Babies|Curated Web|Fashion|Online Shopping,40898.0,IRL,1,1,0,16111,16111,0
Developer Tools|Medical|Medical Devices,13940339.0,GBR,2,5,295,16399,16694,0
3D Printing|Consumer Electronics,1941258.0,SGP,4,8,519,16238,16757,0
Automotive,3270120.0,CHE,1,2,0,16029,16029,0
Biotechnology,36847402.0,GBR,4,11,1791,14629,16420,0
Biotechnology,161600003.0,USA,5,12,1651,14057,15708,1
Web Hosting,24500000.0,ISR,3,16,971,13486,14457,1
Education,2600000.0,USA,1,1,0,16668,16668,0
Biotechnology,514640.0,ITA,1,1,0,15872,15872,0
Software,20885000.0,USA,4,7,2830,12784,15614,0
E-Commerce,600000.0,CAN,1,2,0,13445,13445,0
Curated Web|iPhone|Mobile|Social Media,12025032.2782581,CAN,3,19,575,16056,16631,0
Social Media,3700000.0,JPN,3,4,999,15618,16617,0
Consulting,11000000.0,USA,2,2,680,13766,14446,0
Real Estate,1147034.0,USA,2,3,54,16280,16334,0
Internet|Sports,21182848.0,NZL,5,1,1902,14700,16602,0
Content|E-Commerce|Gift Registries|Personalization,4500000.0,USA,2,7,170,16561,16731,0
Telecommunications,7468895.0,FRA,1,4,0,11932,11932,0
Curated Web|Data Visualization|Internet|Maps|Music,16494801.0,USA,3,2,147,14337,14484,1
Analytics|Brand Marketing|Social Media Monitoring,11158362.0,USA,5,3,1115,14496,15611,0
Clean Technology,5000000.0,USA,1,1,0,16108,16108,0
Biotechnology,41500000.0,USA,2,3,276,16465,16741,0
Email|Enterprise Software|Information Security|Messaging|SaaS,750000.0,USA,2,1,547,16040,16587,0
Non Profit,7000000.0,USA,1,1,0,16716,16716,0
Advertising|App Marketing|Media,16020000.0,USA,3,4,1700,13392,15092,0
Android|Apps|Photography|Video|Video Editing,40000.0,IND,1,1,0,15887,15887,0
Biotechnology,89000000.0,GBR,2,7,369,16184,16553,0
Art|Creative Industries|Digital Media|Entertainment,50000.0,USA,2,2,100,16091,16191,0
Games|Journalism,8250000.0,USA,1,1,0,14179,14179,0
Games,40000.0,IND,1,1,0,15777,15777,0
Games,429420.0,MLT,1,2,0,14488,14488,0
Pharmaceuticals,7479291.0,NLD,1,5,0,16419,16419,0
Advertising,63360000.0,FRA,4,8,2369,13239,15608,1
Security,250000.0,USA,1,1,0,15400,15400,0
Charter Schools|EdTech|Education|K-12 Education|Software|Unifed Communications,11400000.0,USA,2,7,307,13816,14123,0
Games|Video,6200000.0,USA,3,6,731,12418,13149,0
Broadcasting|Internet|Real Time|Social Media Monitoring,2000000.0,USA,1,5,0,12697,12697,0
Biotechnology,2577585.0,GBR,2,6,753,12814,13567,0
Telecommunications,13524140.0,CAN,1,4,0,12335,12335,0
Bio-Pharm|Clinical Trials|Health Care,56000000.0,USA,1,6,0,12335,12335,1
Enterprises|Real Time|Security,1000000.0,AUS,1,3,0,15955,15955,0
Software,17510000.0,GBR,5,17,1797,12326,14123,0
Biotechnology,2200000.0,ISR,2,5,378,12942,13320,0
Mobile,48720000.0,USA,5,19,1132,15062,16194,0
Software,100000.0,USA,1,1,0,15862,15862,0
CRM|Software,7003500.0,IND,1,1,0,16196,16196,0
Analytics,175000.0,USA,2,1,118,16121,16239,0
Curated Web,40000.0,USA,1,1,0,16049,16049,0
Shoes,200000000.0,USA,1,1,0,16070,16070,1
Clean Technology|Semiconductors,97613550.0,USA,4,25,3289,13313,16602,0
Audio|Blogging Platforms|Broadcasting|News|Video Streaming,500000.0,USA,1,1,0,16429,16429,0
Software,25000.0,USA,1,1,0,14061,14061,0
Cyber Security,2200000.0,ISR,1,1,0,16657,16657,0
E-Commerce|Facebook Applications|Payments|Social Commerce|Social Media|Twitter Applications,1000000.0,USA,1,1,0,15431,15431,0
Agriculture,9000000.0,ISR,1,4,0,16608,16608,0
E-Commerce,1340000.0,FRA,1,4,0,14874,14874,0
Advertising,17000000.0,USA,1,3,0,14455,14455,0
Advertising,1800015.0,USA,2,1,553,14762,15315,0
Services,1500000.0,IND,1,1,0,16443,16443,0
Hardware + Software,80587000.0,USA,3,24,1027,15665,16692,0
Security,24500000.0,USA,2,11,282,13641,13923,1
Manufacturing,13020000.0,USA,2,3,1400,12942,14342,1
Software,20000000.0,USA,2,3,739,15799,16538,0
Cloud Data Services|Cloud Security|Collaboration|Storage,270383.0,AUT,2,1,135,16405,16540,0
Digital Media|Entertainment|Media|Mobile|Music|Teenagers,5400000.0,USA,6,17,684,15584,16268,0
Manufacturing,16400000.0,USA,2,4,154,15441,15595,0
Semiconductors,13205000.0,USA,2,2,813,14004,14817,1
Collaboration|Curated Web|Training,10500000.0,USA,3,3,1132,13848,14980,0
Health and Wellness,21487877.0,USA,2,1,551,15911,16462,0
Analytics|Communications Infrastructure|Computers|Technology,36102807.0,USA,5,1,1270,14904,16174,1
Software,8100000.0,USA,1,3,0,11548,11548,1
Ad Targeting|Advertising|Big Data Analytics|Identity Management|Mobile Analytics|Online Identity,5000000.0,ISR,2,14,599,16078,16677,0
Consumer Electronics|Customer Service,200000.0,USA,2,2,115,15817,15932,0
Mobile|Small and Medium Businesses|Software|Startups,255510.0,JPN,2,2,495,15825,16320,0
Internet|Software|Web CMS,3000000.0,USA,1,3,0,14091,14091,0
Events|Social Media|Social Media Marketing|Social Media Monitoring,1828900.0,GBR,3,5,688,15824,16512,0
Advertising,2000000.0,USA,1,1,0,13848,13848,0
Analytics,65853.0,BGR,2,2,120,15706,15826,0
Consumer Electronics|Consumer Goods|Crowdfunding|E-Commerce|Hardware|Internet of Things|Online Shopping|Product Development Services,1435000.0,USA,3,4,882,15706,16588,0
Social Media,1000000.0,USA,1,5,0,13787,13787,0
Information Services,1000000.0,USA,1,3,0,16232,16232,0
Business Services|Non Profit|SEO,25000.0,USA,1,1,0,16001,16001,0
Analytics|SaaS|Social Media|Social Media Marketing,120412.0,CAN,2,2,671,15979,16650,0
Crowdsourcing|Enterprise Software|Mobile|Social Media,650000.0,CAN,1,2,0,15606,15606,0
Curated Web,437500.0,USA,1,2,0,16106,16106,0
Crowdfunding|E-Commerce|Events|Ticketing,34107.0,GBR,1,1,0,15949,15949,0
Customer Support Tools|Internet of Things|Q&A,5750000.0,CAN,3,6,911,15600,16511,0
Collaboration|Software,6000000.0,USA,1,2,0,14770,14770,1
Big Data|Crowdsourcing|Information Technology|Social Commerce|Social Media,650000.0,USA,1,1,0,16232,16232,0
Apps|Cloud Computing|Developer APIs|iPhone|Mobile|Online Scheduling,80000.0,USA,1,1,0,15345,15345,0
Real Estate,1700000.0,USA,3,1,703,16042,16745,0
Android|Apps|Consumer Internet|Events|iPad|iPhone|Mobile,1300000.0,USA,1,2,0,15319,15319,1
Software,22300000.0,USA,3,10,1213,14975,16188,0
Consumer Lending|Crowdfunding|Financial Services|FinTech|Marketplaces|Peer-to-Peer,2760000.0,JPN,2,6,227,16268,16495,0
Crowdfunding,15862857.0,GBR,2,6,379,16267,16646,0
Crowdfunding|Finance,320000.0,USA,2,2,287,15859,16146,0
Advertising|Analytics|Direct Marketing|Facebook Applications|Internet Marketing|Social Commerce|Social Media Marketing|Twitter Applications,12035360.0,USA,2,5,786,14214,15000,1
Big Data|E-Commerce|Entertainment|Mobile|Music,25000.0,USA,2,2,5,15765,15770,0
Brand Marketing|Cause Marketing|Digital Media|Entertainment|Games|Internet Marketing|Music|News|Sports|Video,1000000.0,USA,2,4,735,15810,16545,0
Cloud Data Services|Crowdsourcing|Enterprise Software,28000000.0,USA,4,32,2026,14304,16330,0
Crowdfunding|Finance|Small and Medium Businesses|Startups|Venture Capital,5900000.0,USA,4,17,866,15484,16350,0
Crowdfunding,814401.0,GBR,1,1,0,16161,16161,0
Brand Marketing|Celebrity|Crowdsourcing|Curated Web|Politics|Social Media,770000.0,USA,2,13,250,15584,15834,0
Advertising|Internet Marketing|Nightlife,3600000.0,GBR,2,2,1129,15614,16743,0
Digital Media|Social Media|Video on Demand|Video Streaming,1000000.0,CAN,4,2,559,15706,16265,0
Facebook Applications|Finance|Social Media|Social Media Marketing|Software,2250463.0,USA,6,11,1931,14671,16602,0
Crowdsourcing|Education|Human Resources|SaaS|Skill Assessment,786993.0,CAN,7,7,406,15464,15870,0
Crowdsourcing|Health and Wellness|Health Care|Software,2380000.0,USA,4,20,676,15536,16212,0
Marketplaces|Media|News|Photography|Social Media,372395.67807951296,CAN,3,4,532,15796,16328,0
Advertising|E-Commerce|Games|Local|Location Based Services|Mobile|Social Media,1000000.0,USA,1,10,0,14975,14975,0
Consumer Lending|Crowdfunding|Crowdsourcing|Finance|FinTech|Networking|Peer-to-Peer|Small and Medium Businesses,1900000.0,USA,1,4,0,16126,16126,0
Analytics,10028500.0,USA,11,6,1844,14816,16660,0
Big Data|Politics|Technology,2500000.0,USA,1,10,0,16080,16080,0
Business Services|Cloud Computing|Computers|Databases|Lighting|Linux|Networking|Software|Web Development|Wireless,880000.0,USA,3,2,851,14975,15826,0
Software,150000.0,USA,3,3,455,15674,16129,0
Crowdfunding|Curated Web,24600000.0,USA,3,8,1207,14975,16182,0
Apps|Reviews and Recommendations|Social Media,40000.0,IRL,1,1,0,15911,15911,0
Blogging Platforms|Curated Web|Opinions|Tech Field Support,40000.0,USA,1,1,0,15170,15170,0
Crowdsourcing|Software,170660.0,CAN,3,4,290,15659,15949,0
Facebook Applications|Games|Mobile|Mobile Games|News|Social Games|Startups,49000000.0,USA,4,12,741,15117,15858,0
Crowdfunding|Finance|Internet|Real Estate,1475000.0,USA,2,3,13,16323,16336,0
Security,156000000.0,USA,3,8,1236,15393,16629,0
Brand Marketing|Marketing Automation|Retail Technology,1300000.0,RUS,2,3,143,16063,16206,0
Brand Marketing|Nonprofits|Social Media,2200000.0,USA,1,8,0,16197,16197,0
Advertising|Collaboration|Crowdsourcing|Sales and Marketing|Social CRM|Social Media|Social Media Marketing,15000000.0,USA,3,10,1692,14457,16149,0
Finance|Social Commerce,67100000.0,USA,4,40,1098,15477,16575,0
P2P Money Transfer,40000.0,CHL,1,1,0,16222,16222,0
Cloud-Based Music|Gamification|Mobile,71000.0,USA,4,3,386,15840,16226,0
Analytics|Brand Marketing|Consumer Goods|Enterprise Software|Finance|Incentives|Loyalty Programs|Media|Publishing|Retail|SaaS|Sales and Marketing|Travel,16176000.0,USA,6,10,1379,14868,16247,0
Application Platforms|Finance|News,167371.0,ITA,1,2,0,16702,16702,0
Crowdsourcing|Curated Web,14570000.0,JPN,5,10,1011,15279,16290,1
Media|News|Publishing|Social Media,2962524.0,NLD,1,2,0,16447,16447,0
Crowdfunding|Crowdsourcing|Curated Web|Design|Fashion|Marketplaces|Music|Photography|Video,35000.0,USA,1,2,0,16027,16027,0
Biotechnology,82950000.0,USA,5,12,2334,13879,16213,0
Facebook Applications|Local Search|Maps|Social Media,130000.0,USA,2,2,978,14610,15588,0
SaaS|Software|Web CMS,12000000.0,USA,3,7,1638,13236,14874,0
Big Data Analytics|Developer APIs|Embedded Hardware and Software|Home Automation,138000.0,USA,2,1,317,16071,16388,0
Biotechnology|Health Care,443000000.0,NLD,1,1,0,14515,14515,1
Art|Design|Product Design,115015.0,IND,2,3,3,15915,15918,1
Application Platforms|Sensors|Travel,16800000.0,USA,2,22,625,16071,16696,0
Travel,253194.0,GBR,2,1,179,14883,15062,0
Leisure|Online Reservations|Travel,1740000.0,USA,4,7,204,14861,15065,0
Recruiting,581551.0,SWE,1,1,0,16660,16660,0
E-Commerce,262002.0,GBR,1,1,0,16160,16160,0
Accounting|Curated Web|Finance|Freelancers|Local Businesses|Taxis,1219093.65024844,GBR,3,4,397,14499,14896,0
Business Services|Curated Web|Databases|Startups|Technology,7000000.0,USA,1,1,0,16700,16700,0
E-Commerce,430000.0,USA,1,1,0,15796,15796,0
Mobile,5840116.0,SWE,3,5,1034,15584,16618,0
Games|Music|Subscription Businesses|Video,26799993.0,USA,3,5,2849,13910,16759,1
Advertising|Sales and Marketing,12032712.0,USA,3,5,959,15510,16469,0
Collaboration|Social Media,180000.0,USA,1,4,0,16407,16407,0
Biotechnology,8000000.0,USA,1,2,0,14245,14245,1
Banking|Financial Services|Technology|Trading,10000000.0,SWE,2,2,218,16344,16562,0
Medical Devices,39500000.0,USA,2,6,494,11715,12209,1
Business Services|Services,600000.0,USA,1,2,0,16041,16041,0
Biotechnology,8731646.0,DEU,2,5,411,15785,16196,0
Health Care,250000.0,USA,2,3,210,15434,15644,0
Biotechnology,3800000.0,USA,2,1,364,15140,15504,0
Cyber Security|Network Security|Predictive Analytics,861714.0,GRC,4,1,715,15257,15972,1
Finance|Virtual Currency,20000.0,HKG,1,1,0,16084,16084,0
E-Commerce|Payments,65000.0,GBR,1,1,0,16102,16102,0
Networking|Security|Trusted Networks|Virtualization,280000.0,USA,1,7,0,15126,15126,1
Software,898270.0,FRA,1,1,0,16335,16335,0
Software,15000000.0,SWE,1,2,0,16604,16604,1
Biotechnology,2400000.0,GBR,1,3,0,14979,14979,0
Semiconductors,15237785.0,USA,3,9,1453,13391,14844,0
Biotechnology,15400000.0,USA,2,2,894,15352,16246,0
Information Technology|Services|Technology,18500000.0,USA,1,3,0,11590,11590,0
Biotechnology,2894000.0,USA,6,1,2665,13825,16490,0
Clean Technology,2819200.0,NIC,1,1,0,14426,14426,0
Games,2194059.61456089,KOR,2,1,974,14610,15584,0
Software,12000000.0,USA,2,3,309,16085,16394,0
Information Technology,350000.0,USA,1,1,0,13665,13665,0
Biotechnology,6535000.0,USA,2,6,597,13306,13903,0
Messaging|Mobile|SMS|Software|Telecommunications,6545530.0,GBR,1,2,0,15764,15764,0
Health Care,49427303.0,USA,4,12,1542,14999,16541,0
Biotechnology,2500000.0,USA,1,4,0,16584,16584,0
Social Media,10000000.0,CHN,2,3,264,15737,16001,0
Electrical Distribution|Electronics|Solar,31253119.8860997,DEU,1,5,0,12810,12810,0
Enterprise Software|Facebook Applications|Social Network Media|Twitter Applications,42130000.0,USA,3,2,1646,13431,15077,0
Security|Services|Systems,3737446.0,GBR,2,2,748,14307,15055,1
All Markets|Consumer Electronics|Hardware + Software|Semiconductors|Wireless,19074918.0,USA,2,3,767,11201,11968,1
Consulting|Outsourcing|RIM|Web Design,47000000.0,USA,2,4,471,13149,13620,0
Semiconductors,30000000.0,USA,1,8,0,13298,13298,0
Biotechnology,8970000.0,CHE,1,1,0,14256,14256,0
Biotechnology|Health Diagnostics,2375000.0,USA,2,1,405,16274,16679,0
Education,40000.0,CHL,1,1,0,15911,15911,0
Cloud Data Services|Cloud Infrastructure|Mobile Enterprise|Software|Storage,45000000.0,ISR,3,8,2003,14250,16253,0
Agriculture|Electronics|Gas,40000.0,CHL,1,1,0,15652,15652,0
Business Services|Travel,500000.0,CHN,3,7,4049,10865,14914,1
Apps,261000.0,USA,1,2,0,16525,16525,0
Advertising|E-Commerce|Internet Marketing,1400000.0,GBR,2,1,854,15897,16751,0
Robotics|Technology,120000.0,SGP,1,3,0,16591,16591,0
Advertising,13000000.0,CHN,4,6,981,13149,14130,0
Risk Management|Service Providers,600000.0,USA,1,1,0,15340,15340,0
Audio|MicroBlogging|Social Media|Social Network Media|Software,114869.0,ESP,2,3,365,15826,16191,0
Big Data|Hardware|Personalization|Privacy|SNS|Social Media,200000.0,KOR,1,2,0,15764,15764,0
Software,7700000.0,USA,1,2,0,16727,16727,0
Public Relations|Transportation,9787513.0,DEU,1,2,0,11956,11956,1
Social Media,5860000.0,CAN,1,2,0,13102,13102,0
Networking,6061.0,EST,1,1,0,16561,16561,0
Gadget|Hardware|Hardware + Software|Health and Wellness|Internet of Things|Sensors,717000.0,SVN,2,1,466,16240,16706,0
Collaboration|Enterprise Software|Networking|Web Tools,11500000.0,USA,3,3,640,13910,14550,1
Analytics|Business Intelligence|Marketing Automation|Social Media,6065500.0,ITA,2,3,851,14610,15461,0
Consulting,40000.0,IND,1,1,0,16055,16055,0
Mobile|Web Development|Wireless,37125080.0,IRL,5,7,3776,12784,16560,0
Mobile,2400000.0,TWN,2,7,970,15646,16616,0
Mobile,10000.0,USA,1,1,0,15601,15601,0
Home Automation|Internet of Things,618192.0,HUN,2,1,426,16010,16436,0
Information Technology|Services|Transportation,160000.0,IND,3,2,602,15915,16517,0
Biotechnology,500000.0,CAN,1,1,0,15887,15887,0
Software,3540000.0,DEU,2,5,369,14652,15021,0
Diabetes|Health and Wellness|Health Care,200000.0,MEX,1,1,0,15522,15522,0
Curated Web,4715000.0,USA,3,13,365,14641,15006,1
Biotechnology,7500000.0,USA,1,2,0,16392,16392,0
Innovation Engineering|Medical Professionals|Robotics,20000.0,USA,1,1,0,15949,15949,0
Music,757625.0,GBR,1,1,0,16146,16146,0
Collaboration|Digital Media|Education|iPad|Mobile,168000.0,USA,2,1,405,15706,16111,0
Curated Web|Fashion|Jewelry,5000000.0,USA,2,4,492,15949,16441,0
Health and Wellness|Health Care,50000.0,USA,1,2,0,15857,15857,0
Data Visualization|Mobile|Social Network Media,218545.0,CHL,4,6,700,15522,16222,0
Search,33000000.0,USA,2,5,411,13573,13984,0
Big Data|Fashion|Green,2500000.0,USA,1,4,0,15318,15318,0
Curated Web|Local Coupons|Recipes|Restaurants|Reviews and Recommendations,650000.0,USA,1,1,0,14977,14977,0
Hardware + Software,460000.0,GBR,1,2,0,12941,12941,0
Mobile Payments|Point of Sale|Small and Medium Businesses,70593.0,PER,2,2,211,16315,16526,0
Apps|Events,20000.0,USA,1,1,0,16174,16174,0
Curated Web|Media|News|Technology,1300000.0,CAN,1,2,0,15265,15265,0
Digital Media|Entertainment|Media|Technology,21500000.0,IND,2,4,157,16314,16471,0
Browser Extensions|Education|Facebook Applications|Language Learning,6845000.0,IND,4,5,854,15765,16619,0
Analytics|Enterprises|Enterprise Software|Software,6300000.0,AUS,1,3,0,16498,16498,0
Data Visualization|SaaS|Software,200000.0,USA,1,2,0,16106,16106,0
Art|Curated Web|Design|E-Commerce,626076.0,GBR,1,2,0,15553,15553,0
Cloud Computing|Cloud Data Services|Databases|IaaS|Services|Software|Virtualization,1000000.0,USA,3,3,788,14989,15777,0
Finance,850000.0,USA,1,3,0,15705,15705,0
Cloud Computing|Linux|Networking|Web Hosting,51000000.0,USA,2,9,499,15572,16071,0
Cloud Computing|Cloud Management|Enterprise Software|PaaS,650000.0,USA,1,3,0,14975,14975,1
Casual Games|Games|Mobile Games|Social Games,40000.0,BRA,1,1,0,16408,16408,0
Art|Consumer Internet|Creative Industries|E-Commerce,120000.0,IND,1,1,0,16604,16604,0
Algorithms|Coupons|E-Commerce|Restaurants|Reviews and Recommendations|Sales and Marketing|Shopping|Software,700000.0,ARG,1,1,0,15248,15248,0
Advertising,40000.0,MEX,4,3,670,14770,15440,0
Apps|Mobile|Subscription Businesses,40000.0,USA,2,2,129,16076,16205,0
Health and Wellness|Hospitals|Manufacturing|Medical Devices,15000000.0,IND,2,2,892,15340,16232,0
Analytics,12350000.0,USA,3,10,752,15475,16227,0
Health and Wellness|Health Care|Medical,16200000.0,IND,1,1,0,16389,16389,0
Content|Entertainment|Video,1000000.0,JPN,1,3,0,16263,16263,0
E-Commerce|Internet|Mobile Commerce|Retail,34500000.0,USA,3,21,662,15949,16611,0
Health and Wellness|Hospitality,19000000.0,USA,2,1,4,16604,16608,0
Health Care|Health Care Information Technology|Software,19125000.0,USA,3,11,1337,15274,16611,0
Analytics|E-Commerce|Internet Marketing|Social Commerce|Social Media,1200000.0,USA,2,11,332,15034,15366,0
Biotechnology,4600000.0,USA,2,2,984,13482,14466,0
Art|E-Commerce|Startups,75000.0,USA,1,2,0,15492,15492,0
Advice,1150000.0,USA,1,1,0,16696,16696,0
Health and Wellness|Mobile Health|Technology,2000000.0,USA,1,1,0,16622,16622,0
Bioinformatics|Biotechnology|Technology,700000.0,USA,1,2,0,16261,16261,0
Biotechnology,4000000.0,ISR,1,2,0,15965,15965,0
Biotechnology|Health Diagnostics,67751146.0,DEU,5,13,1813,14581,16394,0
Biotechnology,328007000.0,DEU,5,12,3576,13166,16742,0
Art|Design|E-Commerce|Printing,2400000.0,USA,2,4,821,15550,16371,0
Enterprise Software|Networking|SaaS|Social Media,20000.0,USA,1,1,0,15857,15857,0
Digital Media|Education|Media|Video Streaming,6000000.0,USA,1,5,0,16385,16385,0
EdTech|Education,22500000.0,USA,2,9,287,15827,16114,0
Biotechnology,22964000.0,USA,4,1,777,14652,15429,1
Software,2880000.0,ISR,2,11,225,16236,16461,0
Enterprises|Software|Web Development,17900000.0,USA,1,3,0,12038,12038,0
Software,1500000.0,USA,1,6,0,16056,16056,0
Finance,40000.0,GBR,1,1,0,16055,16055,0
Finance|P2P Money Transfer|Peer-to-Peer|Virtualization,15449707.0,IRL,8,4,2115,14426,16541,0
Apps|Enterprise Software|Finance Technology|FinTech|Mobile|Virtual Currency,85620.0,AUS,1,1,0,16400,16400,0
Finance,18800000.0,USA,4,6,844,14518,15362,0
Software,13000000.0,USA,1,3,0,15230,15230,1
Software,100000000.0,USA,1,2,0,12970,12970,1
Automotive,700000.0,USA,2,3,160,14936,15096,0
News|Web Hosting,15000000.0,USA,1,2,0,12993,12993,0
Education,1800000.0,USA,1,5,0,15986,15986,0
Hospitality,25000.0,USA,1,1,0,14245,14245,0
Education|Internet|Social Network Media,782334.0,MEX,3,3,1096,15309,16405,0
Digital Media|Technology|Video Games,64000000.0,USA,5,6,2929,13695,16624,0
Business Services|Design|Development Platforms,2200000.0,USA,1,6,0,16562,16562,0
Education,1700000.0,ESP,2,9,361,15983,16344,0
Education,59393.0,PER,2,2,59,16436,16495,0
Media|Publishing|Services,100000000.0,USA,1,1,0,12193,12193,0
Manufacturing,6280000.0,USA,1,1,0,15252,15252,0
Data Center Infrastructure|Hardware + Software|Internet Infrastructure|IT Management|Networking,13950000.0,USA,2,1,2430,13130,15560,0
Open Source|Social Network Media|Software,588384.0,GBR,1,3,0,13514,13514,1
Analytics,50000.0,USA,1,2,0,15903,15903,0
Advertising Networks|Consumer Internet|Curated Web|E-Commerce|Marketplaces|Mobile|New Product Development|Product Development Services,140000.0,USA,2,1,449,16108,16557,0
Biometrics|Customer Service|Databases,228637.0,AUS,1,1,0,16588,16588,0
Digital Media|Product Search|SaaS,400000.0,USA,4,6,1049,15461,16510,0
Technology,50000.0,IND,1,1,0,16604,16604,0
Customer Service|Customer Support Tools|Mobile Enterprise|Mobile Software Tools|Real Time,500000.0,IND,2,1,612,15949,16561,0
Gamification|Social Media Marketing|Software,500000.0,GBR,1,1,0,14641,14641,0
Big Data|Big Data Analytics|CRM|Customer Support Tools|Enterprise Search|Enterprise Software|Machine Learning|Sales Automation,5500000.0,USA,2,2,544,15883,16427,0
Customer Service|Software|Technology,4000000.0,IND,2,2,965,15139,16104,0
E-Commerce,2500000.0,IND,1,3,0,16498,16498,0
E-Commerce|Fashion|Printing,40600000.0,USA,3,2,5632,10957,16589,0
E-Commerce,25650000.0,USA,5,21,1622,14245,15867,0
E-Commerce Platforms|Email Marketing|Marketing Automation|Predictive Analytics,6500000.0,USA,3,16,1557,14975,16532,0
Game|Mobile|Startups,13259.0,FIN,1,1,0,15918,15918,0
Pharmaceuticals,20000000.0,USA,2,1,7,16434,16441,0
Bicycles|Electric Vehicles|Manufacturing,480000.0,USA,2,3,120,15645,15765,0
Fashion|Mobile,200000.0,USA,1,1,0,15400,15400,0
Advertising,131310.0,FIN,1,5,0,15462,15462,0
Technology,458550.0,KOR,1,1,0,16386,16386,0
E-Commerce,1700000.0,USA,1,1,0,15862,15862,0
Health Care,32676154.0,USA,4,3,1339,14390,15729,0
Recruiting,2800000.0,EST,1,3,0,11355,11355,0
B2B|Internet Marketing,550000.0,ISR,1,3,0,16161,16161,0
Career Management|Certification Test|Finance|Social Media,737630.0,USA,2,1,266,15621,15887,0
Event Management|Software,136911999.0,USA,3,4,4155,11201,15356,1
Consulting|Document Management|Internet,97643.0,ARG,2,2,244,15309,15553,0
Biotechnology,205600000.0,USA,5,17,2692,13643,16335,0
Creative|Games|Online Gaming,600000.0,KOR,1,1,0,16324,16324,0
CRM|Customer Service|iPad|iPhone|Lead Management|Mobile|Software|Windows Phone 7,1500000.0,USA,2,6,597,14396,14993,0
Enterprise Software,7659999.0,USA,3,3,1146,14245,15391,0
Computers|Internet|Software,4800000.0,USA,1,2,0,12114,12114,0
Enterprise Software,1250000.0,USA,1,4,0,15728,15728,0
Biotechnology,2555672.0,GBR,1,2,0,13934,13934,1
Enterprise Software,3000000.0,USA,1,2,0,13748,13748,1
Security,29000000.0,USA,2,1,1518,15058,16576,0
Software|Telecommunications,130082104.0,USA,7,8,3021,13406,16427,1
Services|Software,115000000.0,USA,3,20,551,15966,16517,0
Cyber|Cyber Security|Technology,4099999.0,USA,1,4,0,16573,16573,0
Information Security|Security,43000000.0,USA,2,3,1942,13387,15329,1
Clean Technology,3300000.0,USA,3,6,1211,13682,14893,0
Security,35194393.0,USA,4,11,3502,13192,16694,0
Software,16333000.0,USA,2,1,2143,12449,14592,0
Software,8500000.0,USA,4,1,2324,14216,16540,0
Cyber Security|IT and Cybersecurity,88600000.0,USA,3,7,608,16112,16720,0
Analytics|Internet of Things|Network Security|Security|Software,4000000.0,USA,2,5,680,15902,16582,0
Service Providers,2700000.0,USA,1,4,0,11313,11313,0
Clean Technology,1894064.0,GBR,2,2,540,15340,15880,0
Health Care,24765989.0,USA,4,5,1134,13886,15020,0
3D Technology|Application Platforms|Big Data Analytics|Energy IT|Industrial|Internet of Things|Mobile|Open Source,4200000.0,FIN,1,2,0,16294,16294,0
Enterprise Software,22500000.0,USA,1,1,0,13187,13187,0
Software,5000000.0,USA,1,2,0,16127,16127,0
Security,3695000.0,USA,4,1,1209,15248,16457,0
Security,2020000.0,ISR,2,5,267,15958,16225,0
Software,2506000.0,USA,2,3,1071,13248,14319,0
Education,400000.0,USA,1,2,0,16672,16672,0
Software|Television,57000.0,FRA,1,1,0,14610,14610,0
Mobile,2535759.0,GBR,2,2,436,15247,15683,0
Biotechnology,132188186.0,USA,7,19,5458,10712,16170,1
Recycling,40000.0,CHL,1,1,0,16222,16222,0
Clean Technology|E-Commerce|Green|Retail,2080000.0,USA,3,2,782,15870,16652,0
Software,29360000.0,NLD,1,1,0,14106,14106,0
Biotechnology,26000000.0,USA,2,7,173,15806,15979,0
Biotechnology,12000000.0,JPN,1,2,0,16496,16496,0
Health and Wellness,9760000.0,IND,1,2,0,16360,16360,0
Cyber Security|Security,77000000.0,USA,3,11,895,15749,16644,0
Software,20800000.0,FRA,2,4,512,14217,14729,0
Biotechnology,98802924.0,USA,5,20,2798,12929,15727,0
Technology,17000000.0,USA,2,2,903,15706,16609,0
Biotechnology|Health Diagnostics,23800000.0,USA,2,8,1280,13579,14859,0
Design|Furniture|Home & Garden|Software,1000000.0,DNK,2,5,196,16301,16497,0
Clean Technology,9553118.0,IRL,1,2,0,16251,16251,0
Biotechnology,171505694.0,USA,8,41,4368,12293,16661,1
E-Commerce|Furniture,25000000.0,CAN,2,5,1534,15189,16723,0
Batteries|Hardware + Software|Semiconductors,69492827.0,USA,10,11,5357,11323,16680,0
Health Care|Medical Devices|Therapeutics,11500000.0,USA,1,4,0,16602,16602,0
Analytics|Media|Social Media,7400000.0,USA,1,3,0,12318,12318,1
Enterprise Security,10600000.0,ISR,3,5,678,16071,16749,0
Advertising,175000.0,USA,1,1,0,15887,15887,0
Web Hosting,6623651.0,USA,3,3,2191,12915,15106,1
Biotechnology,36713046.0,CAN,5,3,1098,15427,16525,1
Apps|Cloud Infrastructure|Social Network Media,10010878.0,USA,5,1,1060,15390,16450,0
Biotechnology|Health Diagnostics,42600000.0,USA,4,4,1087,13719,14806,0
Biotechnology|Health Diagnostics,45825885.0,USA,10,3,2375,14228,16603,0
Semiconductors,77000000.0,USA,2,9,1939,13061,15000,1
Security,27250000.0,USA,4,8,1604,11170,12774,1
Apps|Messaging|Privacy,500000.0,USA,1,2,0,16680,16680,0
Big Data|Cloud Computing|Enterprise Software|Network Security|Security,53700000.0,USA,4,11,1550,15037,16587,0
Manufacturing,34450002.0,USA,6,11,2079,14642,16721,0
Biotechnology|Chemicals|Sensors,23000000.0,USA,1,7,0,11021,11021,0
Innovation Engineering|Manufacturing|Technology,2880000.0,SWE,1,1,0,14153,14153,0
Manufacturing|Solar|Systems,17606421.643725302,CAN,2,7,960,13131,14091,0
Biotechnology|Software,850000.0,USA,1,2,0,16561,16561,0
Web Hosting,150600000.0,USA,2,3,1774,14578,16352,1
Cyber Security|Intelligent Systems|IT and Cybersecurity|Risk Management|Security,3000000.0,ISR,1,4,0,16729,16729,0
Biotechnology|Health Care|Medical,1208791.0,DEU,1,1,0,16554,16554,0
Biotechnology,16490000.0,USA,2,3,390,15132,15522,0
Technology,2000000.0,USA,1,2,0,12207,12207,0
Biotechnology,45700000.0,FRA,2,12,1321,13446,14767,0
Biotechnology,8247656.0,USA,5,1,2057,14621,16678,0
Biotechnology,10984320.0,DEU,3,3,2634,13886,16520,0
Biotechnology,68470098.00754151,USA,4,16,2416,11674,14090,1
Biotechnology,104775000.0,USA,8,1,1526,14721,16247,1
Biotechnology,11885330.3329477,FRA,1,3,0,13207,13207,0
Biotechnology,133500000.0,USA,5,18,1931,14671,16602,1
Biotechnology,14700000.0,FRA,2,5,785,14518,15303,0
Health Care,47686876.0,USA,3,10,789,14554,15343,0
Biotechnology,54751700.0,USA,4,3,1926,14425,16351,1
Biotechnology,500000.0,USA,1,1,0,14649,14649,1
Biotechnology,4300000.0,USA,2,2,207,16024,16231,0
Biotechnology,42500000.0,USA,2,2,1323,15048,16371,1
Biotechnology,2272877.0,GBR,1,5,0,16163,16163,0
Software,11000000.0,GBR,1,2,0,11477,11477,0
Biotechnology|Clinical Trials|Life Sciences,22304410.0,USA,5,1,1515,14652,16167,1
Information Security|Security,13100000.0,ISR,3,4,499,15431,15930,1
B2B|Big Data|Business Services|Credit|Finance|Financial Services,200000000.0,USA,1,1,0,14819,14819,1
Design,1210185.0,DEU,2,1,1054,13346,14400,0
Clean Technology|Solar,25775000.0,CYM,4,13,2229,14193,16422,0
Food Processing,4200000.0,USA,1,3,0,12445,12445,0
Aerospace|Technology,1830000.0,ITA,1,3,0,16716,16716,0
Bio-Pharm|Business Development|Pharmaceuticals,33200000.0,ISR,2,7,4846,11611,16457,0
Software,1342281.0,BEL,1,1,0,16287,16287,0
Data Mining|Health and Wellness|Software,2866335.0,BEL,3,3,1001,13868,14869,0
Semiconductors,123831181.0,CAN,10,26,3180,13284,16464,0
Games,7500000.0,USA,2,2,245,13509,13754,0
Semiconductors,21663227.0,USA,2,3,918,14336,15254,0
Financial Services|Software,17000000.0,USA,2,1,1,16366,16367,0
Chemicals|Design|Product Design|Services,19375512.0,GBR,1,2,0,16532,16532,0
Billing|Human Resources|Internet|Tracking,25025.0,MEX,1,1,0,16010,16010,0
Entertainment Industry,25000.0,USA,1,2,0,16719,16719,0
Big Data|Data Visualization|Predictive Analytics|Public Safety,45000.0,USA,2,2,261,15323,15584,0
Financial Services|Payments|Software,448063.0,NLD,1,1,0,16700,16700,0
Apps|Entertainment|Games|iPhone|Mobile|Social Media|Technology,1016000.0,USA,1,6,0,15521,15521,0
Curated Web|Education,905500.0,USA,4,5,1095,15461,16556,0
Web Hosting,6200000.0,BEL,1,2,0,15182,15182,0
Games,1000000.0,CHN,1,1,0,12843,12843,0
Advertising|Big Data|Enterprise Software|Social Media Marketing,37500000.0,USA,2,2,806,14978,15784,1
EdTech|Education|Entertainment|K-12 Education|Kids,102585.535439503,ESP,1,1,0,16570,16570,0
Classifieds|Peer-to-Peer|Real Estate,211241.0,MEX,4,5,791,15614,16405,0
Application Platforms|Location Based Services|Services|Travel,37800000.0,CHN,2,2,184,16524,16708,0
Game,3846791.0,KOR,1,2,0,16185,16185,0
Software,1458392.0,GBR,2,1,519,14245,14764,0
E-Commerce|Fashion|Lifestyle|Shoes,249299000.0,BRA,5,8,1123,14975,16098,0
Fashion,1300000.0,USA,2,5,161,16161,16322,0
Sporting Goods,1026570.0,CHE,1,4,0,15887,15887,0
News,5708020.0,USA,5,5,886,14714,15600,0
Content|Curated Web|Email Newsletters|Local,6550000.0,USA,4,3,1186,15397,16583,0
Photo Sharing|Public Relations,7015000.0,USA,3,15,566,14475,15041,1
Exercise|Finance|Fitness|Health and Wellness|Nutrition|Social Network Media,540000.0,USA,2,5,390,14000,14390,1
Curated Web,420000.0,USA,2,7,107,15034,15141,0
Curated Web,9360000.0,DEU,1,2,0,14705,14705,1
Audio|Content|Facebook Applications|Social Network Media|Video,150000.0,USA,2,2,485,14610,15095,0
E-Commerce|Fashion|Retail|Shopping,2500000.0,USA,1,9,0,15797,15797,0
Databases|Mobile|Social Network Media|Twitter Applications,35345.0,DEU,2,1,244,14456,14700,0
Curated Web,5000000.0,USA,1,1,0,13651,13651,1
Digital Media|Finance|Women,5100000.0,USA,4,27,1309,15035,16344,0
Clean Technology,12000000.0,USA,2,1,349,14699,15048,0
Design|Mobile|Reviews and Recommendations,400000.0,USA,2,1,517,14975,15492,0
Education,7700000.0,CHN,2,3,212,15006,15218,0
Curated Web,9588257.0,CHN,2,2,395,14761,15156,0
Hardware + Software,12600000.0,USA,2,1,970,13931,14901,0
Outsourcing,27000000.0,USA,2,2,387,11589,11976,1
Advertising|Web Design|Web Development,6000000.0,IND,1,1,0,11589,11589,1
Biotechnology|Health Diagnostics,52119995.0,USA,7,13,1952,14544,16496,0
Language Learning|Local|Software|Translation,600000.0,USA,1,6,0,15826,15826,0
Manufacturing,16349622.0,CAN,1,1,0,15558,15558,0
Billing|Financial Services|Service Providers,30000000.0,USA,1,2,0,12545,12545,0
E-Commerce,14641288.0,CHN,1,1,0,14669,14669,0
Cyber Security,57500000.0,USA,6,19,2801,13381,16182,0
Health and Wellness,10000000.0,USA,1,1,0,15370,15370,0
Mobile|Mobile Commerce|Mobile Payments|Payments,14500000.0,USA,2,1,2191,13665,15856,0
Bio-Pharm|Health and Wellness|Health Care|Medical,14578000.0,USA,2,1,51,16433,16484,0
Music|Social Media|Video,4500000.0,USA,2,11,276,13634,13910,0
Music|Video on Demand,4000000.0,USA,2,5,179,15988,16167,0
Games,3744621.0,KOR,2,1,381,15340,15721,0
Advertising Platforms|Marketplaces|Social Commerce,50000.0,USA,1,2,0,16328,16328,1
Semiconductors,1760000.0,DNK,1,1,0,14691,14691,0
Mobile,32000000.0,CHN,2,3,548,14883,15431,0
Software,118300000.0,USA,5,21,2251,11222,13473,1
Social Media,649456.0,CHN,2,2,122,15796,15918,0
Clean Technology,42700000.0,USA,3,11,1014,14202,15216,0
Service Providers,13500000.0,USA,1,2,0,12725,12725,0
Games,17136.0,DEU,1,1,0,16571,16571,0
Delivery|Hospitality,67000000.0,CHN,4,8,1354,14975,16329,0
Enterprise Software,811820.0,CHN,1,1,0,15887,15887,0
Information Technology,4000000.0,CAN,1,1,0,16644,16644,0
Advertising|Music|Web Tools,4000000.0,USA,2,3,355,13493,13848,1
Collaboration|Project Management|SaaS|Software,30500000.0,USA,4,8,1449,12961,14410,1
Collaboration|Project Management|Startups|Task Management,4100000.0,ISR,2,4,1117,15554,16671,0
Augmented Reality|Enterprise Software|Internet of Things|QR Codes,15000000.0,USA,1,1,0,15860,15860,0
E-Commerce|Online Shopping,55600000.0,PAK,1,2,0,16700,16700,0
Apps|Games,26671.0,GBR,2,3,286,16115,16401,0
Auto|Cars|Collaborative Consumption|Marketplaces|Online Rental|Peer-to-Peer|Transportation|Travel,10000.0,RUS,1,1,0,16626,16626,0
Network Security,40500000.0,GBR,2,4,127,16511,16638,0
Games,5440000.0,FRA,1,1,0,14662,14662,0
Hardware + Software|Health and Wellness|Health Care,65000.0,USA,3,2,165,16170,16335,0
Biotechnology,1500000.0,USA,1,1,0,16254,16254,0
Curated Web|Gift Card|Services|Social Media,86000.0,RUS,2,2,518,15400,15918,0
3D Technology|Creative Industries|Interface Design,40000.0,CHL,1,1,0,16222,16222,0
Software,48000000.0,USA,1,1,0,13733,13733,0
Web Hosting,23000000.0,KOR,1,1,0,14852,14852,0
E-Commerce|Social Commerce|Software,150000.0,USA,1,1,0,15065,15065,0
Gps|Maps|Mobile|Navigation,65000000.0,USA,3,20,761,13149,13910,1
Brand Marketing|Business Analytics,611000.0,USA,2,5,236,16261,16497,0
Big Data|Finance|FinTech|Hardware + Software|Internet of Things|Mobile,1500000.0,USA,2,4,400,15670,16070,0
Internet Radio Market|Music,2000000.0,USA,1,10,0,16333,16333,0
Hardware + Software,1691696.0,USA,3,3,591,15957,16548,0
Hospitality|Mobile|Mobile Payments|Payments|Restaurants,1900000.0,USA,2,9,224,15904,16128,0
Advertising,5480028.0,USA,4,3,1660,15062,16722,0
Project Management|Software,2190000.0,RUS,1,2,0,16400,16400,0
Information Technology|Mobile|Real Time|Web Development,200000.0,CAN,1,1,0,15944,15944,0
Chat|Messaging|Real Time,2090000.0,USA,2,7,239,16357,16596,0
Analytics|Business Intelligence|Business Services|Collaboration|Software,3250000.0,USA,1,5,0,16560,16560,0
Cloud Computing|Identity Management|Payments|Privacy|Security|Software,30000000.0,USA,3,9,971,15238,16209,0
Transportation,755000.0,USA,2,1,252,16076,16328,0
Mobile,3859459.0,USA,2,4,594,14377,14971,1
Curated Web,2000000.0,USA,1,3,0,14288,14288,1
Big Data Analytics|Education,2240000.0,BEL,3,4,657,16052,16709,0
Data Mining|Design|Development Platforms,67893.0,BGR,2,2,105,15966,16071,0
Hardware + Software,15000000.0,USA,1,2,0,16107,16107,0
Enterprise Software|Software,17000000.0,USA,1,3,0,12403,12403,1
Software,5000000.0,USA,1,1,0,14872,14872,1
Data Security|Hardware + Software,1600000.0,USA,2,1,821,13879,14700,0
Customer Service|Low Bid Auctions|Real Time,832963.0,RUS,1,1,0,15737,15737,0
Software,33793.0,BGR,1,1,0,15979,15979,0
Electronics|Manufacturing|Software|Wireless,12000000.0,USA,1,2,0,11719,11719,0
Services,4920000.0,USA,2,1,370,10991,11361,1
Software,5000000.0,DEU,1,2,0,15453,15453,0
Databases,1500000.0,USA,2,2,436,16267,16703,0
Software,4000000.0,USA,1,2,0,14027,14027,0
Advertising,5000000.0,USA,1,3,0,13374,13374,0
Software,20000.0,USA,1,1,0,14761,14761,0
Analytics,47000000.0,USA,2,3,278,15973,16251,0
Cloud Security|Enterprise Software,14500000.0,USA,5,4,1481,14202,15683,0
Internet,6730154.0,GBR,1,1,0,16218,16218,0
Legal,17500000.0,USA,3,5,2213,11478,13691,1
Developer Tools|Development Platforms|Service Providers,5900000.0,CAN,1,3,0,12242,12242,0
Consulting,4230300.0,POL,1,1,0,14896,14896,0
Software,60000000.0,USA,2,5,2348,11625,13973,0
Health and Wellness|Manufacturing|SaaS|Software|Supply Chain Management,4000000.0,USA,1,1,0,13647,13647,0
Machine Learning|Software,2000000.0,CAN,1,2,0,15545,15545,0
Software,1621171.0,GBR,1,2,0,14184,14184,0
SaaS|Software,53400000.0,USA,5,23,1646,14817,16463,0
Aerospace|Energy|Utilities,400000.0,USA,1,1,0,16283,16283,0
Angels|Big Data|Business Intelligence|Enterprise Software|Finance|Finance Technology|FinTech|Market Research|News|Predictive Analytics|Startups|Venture Capital,6800000.0,USA,3,22,659,15979,16638,0
Software,92000000.0,USA,3,6,901,15511,16412,0
Web Hosting,2000000.0,USA,1,1,0,15607,15607,0
Enterprise Software,16250000.0,USA,2,1,922,15055,15977,0
Analytics|Big Data Analytics|Data Visualization,10250000.0,USA,3,9,1083,15491,16574,0
Analytics|SaaS|Sales and Marketing|Sales Automation,5500000.0,USA,2,7,551,15275,15826,0
Analytics|Big Data|Data Integration|Machine Learning|Productivity Software,3700534.0,FRA,1,2,0,16454,16454,0
Analytics|Software,3104714.0,USA,6,4,1464,14657,16121,0
Services|Software|Web Design|Web Development,1299000.0,IRL,1,3,0,14270,14270,0
Web Hosting,63100000.0,USA,4,15,1629,12418,14047,1
Advertising,86545843.0,USA,6,11,1750,14533,16283,1
Enterprise Software|Information Technology|IT Management|SaaS|Services,779663.0,GBR,3,8,406,16342,16748,0
Enterprise Software,1200000.0,USA,1,1,0,15187,15187,0
Hardware + Software,8880000.0,GBR,1,5,0,13462,13462,0
Analytics|Big Data|Big Data Analytics|Data Integration|Data Visualization|Enterprise Software|Software,76750000.0,USA,5,15,1951,14714,16665,0
Analytics,179566000.0,USA,6,20,1870,14838,16708,0
Enterprise Software|Finance Technology|SaaS|Small and Medium Businesses,729207.0,SVK,2,3,158,15949,16107,0
Artificial Intelligence|Big Data Analytics|Cloud Computing|Cyber Security|FinTech|SaaS,300000.0,CHE,1,1,0,16587,16587,0
Mobile,25000000.0,CHN,1,3,0,13297,13297,0
Enterprise Software,6300003.83690592,GBR,5,7,1237,12265,13502,1
B2B|Big Data|Business Intelligence|Enterprise Software|Lead Generation|SaaS|Sales and Marketing,2000000.0,USA,1,10,0,16307,16307,0
Analytics|Big Data|Big Data Analytics|Business Intelligence|Visualization,1700000.0,USA,1,9,0,15706,15706,1
Crowdsourcing|Parenting,40000.0,CHL,1,1,0,16222,16222,0
Cloud Computing|IaaS|Internet Infrastructure|SaaS|Software,118000.0,DEU,1,1,0,16601,16601,0
Web Hosting,487358426.0,USA,3,7,1788,14068,15856,0
Advertising|Comparison Shopping|E-Commerce|Internet Marketing|Local|Search|Semantic Search|Social Commerce,9200000.0,USA,3,9,1149,14305,15454,1
E-Commerce,500000.0,UKR,1,1,0,16308,16308,0
Enterprise Software,1588000.0,USA,3,3,783,15765,16548,1
Enterprise Software|Machine Learning|Predictive Analytics|SaaS,24418000.0,USA,3,8,578,15719,16297,0
Analytics|Big Data|Business Intelligence|Real Time|Software|Web Development,5900000.0,USA,2,4,117,16023,16140,0
Analytics|Big Data|Big Data Analytics|Business Intelligence|Cloud Data Services|Databases|Data Integration|Data Visualization|Internet of Things,6000000.0,USA,2,7,343,16245,16588,0
Network Security,4000000.0,USA,1,1,0,16383,16383,0
Analytics|Big Data,77892396.0,USA,6,22,1484,14610,16094,0
Hardware + Software,500000.0,GBR,1,1,0,12989,12989,0
Analytics|Big Data|Information Services,1250000.0,USA,1,10,0,16335,16335,0
Advertising|Incentives|Local|Media|SaaS|Search|Television,28805381.0,USA,3,2,798,14614,15412,0
Big Data|Databases,189700000.0,USA,6,27,1595,14722,16317,0
Data Visualization|Marketplaces|Real Time,368000.0,SGP,2,1,168,16325,16493,0
Software,15000000.0,USA,1,3,0,11484,11484,1
Analytics|Big Data,23750000.0,USA,3,10,1092,15461,16553,0
Analytics,16000.0,ISL,1,1,0,15492,15492,0
Software,41000000.0,USA,3,5,965,13300,14265,0
Analytics|Databases|Hardware + Software|Networking,13690000.0,USA,4,4,2252,13903,16155,0
Big Data Analytics|Cyber Security|Fraud Detection,14500000.0,USA,1,2,0,16721,16721,0
Big Data|E-Commerce|Enterprise Software,500000.0,USA,1,1,0,16071,16071,0
Big Data|Email Marketing|Enterprises|Enterprise Software|Social Media,100000.0,USA,1,1,0,15248,15248,0
Application Performance Monitoring|CRM|Enterprise Software,38999.0,USA,1,1,0,15694,15694,0
Telecommunications,11000000.0,CAN,1,4,0,12265,12265,0
Ad Targeting|Advertising|Big Data Analytics|Data Visualization|Digital Media|Enterprise Software|Internet Marketing|Technology,55800000.0,USA,4,14,1755,14351,16106,0
Retail Technology|SaaS,804500.0,USA,6,11,850,15129,15979,0
Facebook Applications|Networking|Online Dating|Social Media|Women,20000.0,IND,1,1,0,15336,15336,0
Networking|Social Media,100000.0,USA,1,1,0,15309,15309,0
Software,6910000.0,USA,5,11,1220,15328,16548,0
Analytics,7000000.0,USA,1,1,0,16700,16700,0
Advertising|Big Data|SaaS|Software,18000000.0,USA,2,5,423,15919,16342,0
Big Data|Cloud Computing|Databases|Enterprise Software,15250000.0,USA,2,4,441,16252,16693,0
Advertising,69477054.0,USA,2,1,2269,12843,15112,0
Enterprise Software,8459197.0,USA,2,6,2593,12041,14634,1
Apps|Mobile|Online Dating|Social Media,1874645.0,GBR,4,11,688,15824,16512,0
Business Services|Cloud Computing|Flash Storage|Homeland Security|Software|Storage|Virtualization,100000000.0,USA,2,2,805,15951,16756,0
Civil Engineers,5000000.0,ISR,1,1,0,16188,16188,0
B2B|Big Data|Data Integration|Internet of Things|Networking|Software,18192.0,ESP,2,1,195,16241,16436,0
Analytics,64330.0,CZE,1,1,0,16161,16161,0
Pharmaceuticals,15000195.0,USA,2,1,41,16596,16637,0
Oil & Gas,355000.0,USA,4,4,1579,14974,16553,0
E-Commerce,13962782.0,CAN,1,1,0,15441,15441,1
Financial Services|Franchises|Governments|Small and Medium Businesses,2220000.0,USA,1,3,0,16435,16435,0
Application Platforms|Energy|Internet of Things|Manufacturing|Oil & Gas|Software|Transportation|Utilities,3599581.9759102995,USA,2,4,869,15889,16758,0
Software,7750000.0,USA,2,2,2064,14061,16125,0
Software,40000.0,CHL,1,1,0,15309,15309,0
Energy|Renewable Energies|Solar,9322033.89830509,CAN,2,2,418,13119,13537,1
Enterprise Software,50000.0,USA,1,1,0,14855,14855,0
Software,228382.34249231103,GBR,1,1,0,16758,16758,0
Cloud Computing|Enterprise Software|Finance|News|Online Scheduling|Video on Demand,40000000.0,CAN,3,4,614,14365,14979,1
Social Media,41000000.0,CHN,4,7,734,15492,16226,0
Curated Web|Publishing,12300000.0,USA,2,3,746,13665,14411,1
Biotechnology|Health Diagnostics,31000000.0,USA,4,5,1839,13327,15166,0
Consumers|Games,1171460.0,SGP,2,5,654,15857,16511,0
Games|iOS,600000.0,USA,1,4,0,12053,12053,0
Software,4200000.0,USA,1,3,0,13665,13665,0
Communications Infrastructure|CRM|Customer Support Tools|Event Management|Events|Lead Generation|Marketing Automation|Mobile Social|Social CRM|Social Media|Social Media Advertising|Social Media Management|Social Media Marketing|Social Media Monitoring|Social Media Platforms|Supply Chain Management|Video Streaming,1000000.0,GBR,1,9,0,16495,16495,0
Data Security|Information Security|Network Security|Security,23800000.0,USA,3,4,709,15706,16415,0
Software,5174000.0,ITA,1,1,0,15341,15341,0
Technology,9000000.0,USA,1,1,0,12459,12459,0
Public Transportation,35000000.0,USA,1,1,0,16146,16146,0
Software,6000000.0,ISR,1,3,0,13263,13263,0
Biotechnology,309700000.0,FRA,3,5,1677,14960,16637,1
Health Care,44736836.0,USA,2,7,934,15765,16699,0
Software,860000.0,ISR,1,1,0,14588,14588,0
Curated Web,40000000.0,CHN,5,6,1826,13970,15796,0
Digital Media|Internet|Networking|Software|Video Streaming|Web Tools,632200.0,NLD,1,1,0,14304,14304,0
Crowdfunding|Media|Nonprofits|Social Media,1530625.0,ITA,2,4,594,15555,16149,0
E-Commerce|Manufacturing,50000.0,USA,1,1,0,15734,15734,0
Coupons|Curated Web|Discounts|Finance|Flash Sales|Group Buying,516000.0,USA,2,4,92,14914,15006,0
Coupons|E-Commerce|Group Buying,1000000.0,SGP,1,1,0,14914,14914,0
E-Commerce|Furniture,1200000.0,USA,1,8,0,15575,15575,0
Coupons|Discounts|E-Commerce,75000.0,ARE,2,2,433,15190,15623,0
E-Commerce,6167000.0,DEU,3,10,716,14453,15169,0
Finance|Hotels|In-Flight Entertainment|Online Travel|Travel,868000.0,USA,3,4,443,15034,15477,0
Curated Web|Hotels|Travel,1000000.0,USA,1,3,0,14372,14372,0
Finance,750000.0,DNK,1,4,0,16132,16132,0
Auctions|E-Commerce,1500000.0,USA,1,1,0,15318,15318,0
Internet,5000000.0,NGA,1,1,0,16485,16485,0
Advertising,5000000.0,USA,2,1,587,14624,15211,1
Advertising|Cloud Computing|Databases|Web Development,100000.0,USA,1,1,0,14330,14330,0
Automotive|E-Commerce,8582862.0,NLD,1,2,0,16548,16548,0
Business Services|Finance|Technology,436180930.0,USA,2,1,4357,11778,16135,1
Curated Web|Entertainment,1700000.0,USA,3,25,720,15552,16272,0
Advertising|Group Buying|Service Providers,5270907.05282503,AUS,1,2,0,15149,15149,0
Internet|Software,15000.0,IDN,2,3,415,16040,16455,0
Mobile,50000.0,SGP,1,2,0,14610,14610,0
Advertising,1500000.0,USA,1,2,0,15063,15063,1
Curated Web|E-Commerce|Flash Sales|Group Buying|Social Commerce,18500000.0,IND,2,1,457,14822,15279,0
Finance|Marketplaces,69500000.0,USA,6,4,1299,15340,16639,0
Brand Marketing|Design|Direct Marketing|Internet Marketing|Loyalty Programs|Marketing Automation,120000.0,USA,1,1,0,16405,16405,0
E-Commerce,60000.0,AUS,1,1,0,15949,15949,0
Finance,1584593.0,USA,2,1,744,13864,14608,1
Financial Services|Local|Networking|Social Media,55000.0,USA,3,3,731,14975,15706,0
Digital Media|Games|Internet|Video,15000000.0,USA,2,7,499,13757,14256,0
Software,2009100.0,FRA,1,1,0,14256,14256,0
Enterprise Software|Location Based Services|Navigation|Software,56063148.0,USA,6,14,2680,12859,15539,1
Electronics|RFID|Semiconductors,22629440.0,IRL,10,7,2509,14092,16601,0
Manufacturing|Medical Devices|Technology,533980.0,CAN,1,1,0,15963,15963,0
Consumer Electronics|Curated Web|E-Commerce|Machine Learning|Search|Shopping,16500000.0,USA,3,9,1155,14610,15765,1
Curated Web|Social Media,100000.0,IND,1,2,0,15353,15353,0
Biotechnology,8450000.0,USA,3,6,1467,14879,16346,0
Pharmaceuticals,75000000.0,USA,1,1,0,16699,16699,0
Software,1080000.0,GBR,1,1,0,13488,13488,0
Collaboration|Real Time|Software,6900000.0,USA,3,1,73,16203,16276,0
Enterprise Software,14000000.0,USA,1,2,0,11479,11479,1
Software,1000000.0,USA,1,1,0,15881,15881,0
Education|Enterprise Software|SaaS|Software,5965000.0,USA,9,4,1827,14334,16161,0
Enterprise Software|Optimization|Predictive Analytics,2800000.0,USA,1,5,0,16489,16489,0
Online Education|Services|Training,1850000.0,GBR,1,2,0,16680,16680,0
Software,10510626.0,USA,4,3,1002,13724,14726,1
Content|Predictive Analytics|Social Media,120000.0,USA,1,1,0,16622,16622,0
Software,45145000.0,USA,5,3,1663,15047,16710,0
Online Travel|Travel,1500000.0,USA,1,1,0,13879,13879,0
Enterprise Software,600000.0,IND,1,2,0,16055,16055,0
Collaboration|Education,30000000.0,USA,3,10,257,15975,16232,0
Online Travel|Travel & Tourism,270000000.0,BRA,2,2,1048,15457,16505,0
Curated Web|E-Commerce|Home Decor|Marketplaces,4500000.0,USA,1,3,0,16570,16570,0
Home Decor|Interior Design|Manufacturing,508475.0,DNK,1,1,0,16395,16395,0
Computers|Data Security|Network Security|Security,40000000.0,USA,1,5,0,11900,11900,1
Development Platforms|Information Technology|Software Compliance,3471859.0,SWE,1,1,0,12306,12306,1
Curated Web,40000.0,CHL,1,1,0,15184,15184,0
Biotechnology,64330000.0,ITA,1,1,0,16092,16092,0
Drones|Security|Technology,2900000.0,DEU,1,1,0,16553,16553,0
Contests|Event Management|Gamification|Software,186500.0,BGR,4,2,335,15614,15949,0
Advertising|Games|Location Based Services|Mobile|New Product Development|Outdoor Advertising|Social Media|Social Network Media,215000.0,USA,3,2,486,16102,16588,0
Collaboration|Enterprises|Enterprise Software|Productivity,118000.0,EST,1,1,0,16622,16622,0
Content Syndication|E-Commerce|Marketplaces|Productivity Software|Trading,504985435.0,USA,9,26,3856,12418,16274,0
Fashion,40000.0,CHL,1,1,0,15685,15685,0
Advertising|Dental|Health and Wellness|Health Care,120000.0,CHL,1,1,0,15722,15722,0
Hardware + Software,11064068.0,GBR,2,3,1817,14000,15817,0
Analytics,784324.0,USA,4,1,932,15705,16637,0
Algorithms|Big Data|Mobile Advertising,8207892.0,USA,3,1,185,16250,16435,1
Biotechnology|Machine Learning|Software,3700000.0,CAN,1,2,0,16757,16757,0
Analytics|Computer Vision|Machine Learning|Security,18000000.0,CHN,3,4,638,15584,16222,0
Software,470000.0,SGP,1,1,0,16394,16394,0
Manufacturing,6159223.0,USA,9,9,1608,15002,16610,0
Analytics|Big Data|Big Data Analytics|Databases|Software,18000000.0,USA,2,4,841,15706,16547,0
Data Security|Network Security|Security,9000000.0,USA,1,1,0,13550,13550,0
Security,5596159.0,GBR,1,2,0,14600,14600,0
Collectibles|E-Commerce|Fashion|Home & Garden|Jewelry|Lifestyle,4350000.0,USA,1,2,0,15905,15905,0
Consumer Goods|E-Commerce|Image Recognition|Technology,1400000.0,FRA,1,3,0,16692,16692,0
Concerts|Games|Music,3000000.0,USA,1,2,0,13879,13879,0
Big Data|Computers|Services|Software,6000000.0,USA,2,1,415,16344,16759,0
Manufacturing,15169529.0,GBR,1,2,0,13417,13417,0
Oil & Gas,3500000.0,USA,1,1,0,15611,15611,0
Clean Technology,3500000.0,USA,1,1,0,14081,14081,1
Contact Management|Identity|Mobile|Networking,1500000.0,USA,1,1,0,15669,15669,0
Entertainment|Facebook Applications|File Sharing|Journalism|Music|Social Media|Web Development,149300000.0,FRA,3,5,1559,14061,15620,0
Consumer Goods|Manufacturing|Security,500000.0,USA,2,2,364,16239,16603,0
Mobile,36575000.0,USA,4,3,634,16002,16636,0
Security,9500000.0,USA,1,2,0,15923,15923,1
Entertainment|Games|Video Games,40898.0,IRL,1,1,0,16111,16111,0
Curated Web|Fashion|Teenagers,690000.0,USA,1,3,0,15310,15310,0
Analytics|Data Mining|Health Care|Health Diagnostics|Image Recognition,33272398.0,DEU,2,5,630,15614,16244,1
Biotechnology,5951016.0,GBR,2,3,172,16051,16223,0
Advertising|Brand Marketing|Digital Media|E-Commerce|Internet Marketing|Public Relations|Social Media|Web Development,15000000.0,USA,1,1,0,14438,14438,0
Mobile,15100000.0,USA,3,11,1392,12207,13599,0
Health and Wellness|Medical Devices|Pharmaceuticals,27000000.0,ISR,1,1,0,14914,14914,0
Education|Internet,9700000.0,USA,3,2,839,15674,16513,0
Electronic Health Records|Electronics|Medical|Software,250000.0,COL,1,1,0,13300,13300,0
Broadcasting|Media|Mobile Video|Video Streaming,4500000.0,CAN,2,2,1616,14596,16212,0
3D|Computer Vision|Mobile,5100000.0,USA,3,23,631,15203,15834,0
Nonprofits,300000.0,USA,1,1,0,14855,14855,0
E-Commerce|Mobile|Wine And Spirits,7000000.0,USA,3,17,826,15371,16197,0
Biotechnology,41300000.0,CHE,3,16,1090,14925,16015,0
Security,1600000.0,USA,2,1,337,14683,15020,0
Logistics|Supply Chain Management,127500000.0,IND,4,10,1008,15553,16561,0
Media|Software,16232.0,POL,1,1,0,15675,15675,0
Comics,108579.0,FRA,4,5,334,14640,14974,0
Curated Web|Internet|Messaging|Mobile|SMS|SNS|Technology,100000.0,KOR,1,2,0,14159,14159,0
Banking|Technology|Wealth Management,16249.0,GBR,1,1,0,16635,16635,0
Analytics|Artists Globally|Concerts|Events|Local|Mobile|Music|Music Venues|Ticketing|Video Streaming,9350000.0,USA,1,3,0,15986,15986,0
Software,25000.0,USA,1,1,0,14976,14976,0
E-Commerce|Hospitality|Restaurants|Social Media,360080.0,GBR,2,2,218,15792,16010,0
E-Commerce,12350000.0,USA,4,27,333,15792,16125,0
Delivery,2350000.0,USA,3,2,693,15932,16625,0
Food Processing,199585753.0,GBR,4,15,515,16247,16762,0
E-Commerce,12000000.0,RUS,2,4,449,15609,16058,0
E-Commerce,138442109.0,USA,12,19,3437,12871,16308,0
Health and Wellness|Health Care Information Technology|Technology,108000000.0,USA,1,3,0,16729,16729,0
Enterprise Software|Software,590000.0,DNK,1,1,0,16497,16497,0
Automotive,8000000.0,USA,1,1,0,14043,14043,1
Health Care,58500000.0,USA,3,10,1877,14811,16688,0
Software,119500000.0,USA,4,16,2350,14279,16629,0
Software,12679995.0,USA,1,1,0,16335,16335,0
Oil & Gas,750000000.0,NLD,1,3,0,13595,13595,0
Hardware + Software,6100000.0,USA,2,1,371,15946,16317,0
Fuels|Technology,324942.0,USA,1,1,0,13367,13367,0
Electronics|Manufacturing|Wireless,4000000.0,USA,1,1,0,12913,12913,0
Software,20395.0,EST,1,1,0,15737,15737,0
Analytics,4300000.0,GBR,2,6,475,15902,16377,0
Life Sciences,6100000.0,GBR,1,1,0,13788,13788,0
Finance,12000000.0,USA,1,3,0,13865,13865,0
Analytics|Big Data|Data Mining|Intellectual Property,378000.0,GBR,3,5,560,15236,15796,0
Application Platforms|Beauty|E-Commerce,20000.0,PER,1,1,0,15979,15979,0
Audio|Games|Search|Video|Video Streaming,11567800.0,USA,3,4,930,13483,14413,1
Networking|Search|Social Search,4000000.0,ISR,2,2,414,13665,14079,1
Business Intelligence|Natural Language Processing|SaaS|Software,216476.0,GBR,2,1,310,15817,16127,0
Software,5750000.0,GBR,2,5,676,12965,13641,0
Analytics|Internet Marketing|SaaS,93000000.0,USA,6,27,2515,14116,16631,0
Software,10119801.0,USA,3,3,654,14610,15264,1
Software,750000.0,USA,1,2,0,16757,16757,0
Advertising|Art|Content|Health and Wellness|Home & Garden|Social Media,100000000.0,USA,1,5,0,13781,13781,1
Consulting,1507989.0,USA,2,3,1912,12823,14735,0
Fmcg|Predictive Analytics|Retail Technology|SaaS|Software,6000000.0,USA,1,3,0,13734,13734,1
Enterprise Software|Technology,54100002.0,USA,5,7,3181,13192,16373,1
Consumer Electronics|Fashion|Internet|Media|Pharmaceuticals|Supply Chain Management,16600000.0,USA,1,1,0,12192,12192,1
Advertising|SaaS,8500000.0,USA,3,5,647,14092,14739,1
Education|iOS|iPad|Mobile|Publishing|Software|Tablets|Textbooks,533000.0,USA,4,3,556,15089,15645,1
Consulting,187539.0,GBR,1,1,0,15561,15561,0
Software,2600000.0,USA,2,5,163,16371,16534,0
Marketplaces|Social Network Media,3840000.0,USA,3,5,973,15614,16587,0
Governance|Governments|Software,220000.0,USA,2,3,55,16405,16460,0
Enterprise Software,40000.0,CAN,1,1,0,15180,15180,0
E-Commerce,1500000.0,CHN,2,2,853,15187,16040,0
Analytics,5000000.0,USA,3,7,638,15580,16218,0
Home Automation|Internet of Things|Manufacturing,1011792.0,GBR,2,9,69,16540,16609,0
E-Commerce|Games|Messaging|Mobile|Mobile Games|Social Games|Social Network Media,19362564.0,JPN,3,7,617,11039,11656,1
Biotechnology|Health Diagnostics|Therapeutics,217000000.0,USA,1,4,0,16569,16569,0
Biotechnology,8324204.0,SWE,4,8,2176,13258,15434,0
E-Commerce|Financial Services|Payments,2000000.0,RUS,1,1,0,15705,15705,0
Advertising|Auctions,3800000.0,USA,3,9,274,15736,16010,0
Pharmaceuticals,501408.0,CAN,1,1,0,15430,15430,0
Computers|Information Services|Software,22000000.0,USA,1,5,0,12429,12429,0
Biotechnology,4595000.0,USA,5,2,1270,15432,16702,0
Design|Manufacturing|Semiconductors,30000000.0,SGP,1,1,0,11697,11697,0
Medical Devices|Software,250000.0,CAN,1,1,0,16729,16729,0
Dental|Health Care|Medical,121000000.0,CAN,1,2,0,16279,16279,0
Dental,265064.0,ESP,1,1,0,15867,15867,0
SaaS|Software,290000.0,CHL,2,2,290,15324,15614,0
Dental|Health Care|Technology,4500000.0,IND,1,1,0,16195,16195,0
Collaboration|Service Providers|Transportation,3216500.0,FRA,1,1,0,15887,15887,0
Artificial Intelligence|Big Data|Health and Wellness|Health Care|SaaS,1159132.0,GBR,1,1,0,16310,16310,0
Funeral Industry|Insurance,1250000.0,USA,1,2,0,16001,16001,0
Software,36000000.0,USA,2,2,1179,10918,12097,1
Pharmaceuticals,875000000.0,USA,2,2,190,16317,16507,1
Android|iOS|iPhone|Marketplaces|Mobile|Social Media,10315715.0,GBR,7,8,1185,15279,16464,0
Curated Web|Image Recognition|Photography|Stock Exchanges,3000000.0,USA,1,1,0,15182,15182,0
Software,13000000.0,USA,3,3,1186,13641,14827,0
Games,1000000.0,CAN,1,1,0,15862,15862,0
Gambling|Games|Social Games,6500000.0,USA,2,9,705,15765,16470,0
Hotels|Information Technology|Internet|Tourism,30500000.0,USA,4,5,2708,13453,16161,0
Crowdsourcing|E-Commerce|Marketplaces|Mobile,25000.0,USA,2,1,43,15658,15701,0
Software,2190000.0,USA,1,2,0,12894,12894,0
Curated Web|Design,3919981.0,USA,2,6,600,15855,16455,0
Software,12700000.0,USA,2,4,608,14090,14698,1
Health Care,1500000.0,USA,1,1,0,15433,15433,0
Biotechnology,23514640.0,USA,4,1,2790,13962,16752,0
Clean Technology,22250000.0,ISR,3,5,930,15476,16406,0
Algorithms|Databases|Internet|Technology,5000000.0,USA,2,7,200,16556,16756,0
3D|Games|Video Games,600000.0,USA,1,1,0,16535,16535,0
Education|Entrepreneur|Internet|Video,14060000.0,BRA,4,13,934,15664,16598,0
Social Media,50000.0,USA,1,1,0,15917,15917,0
Digital Media|Media|News|Publishing,45000.0,USA,2,1,469,15553,16022,0
Marketplaces|Travel|Travel & Tourism,47434.0,GTM,1,1,0,15584,15584,0
Industrial|Natural Gas Uses|Services,1140000.0,USA,1,2,0,12844,12844,0
Games,6000000.0,USA,2,5,358,13545,13903,0
EdTech|Education,1200000.0,IND,1,3,0,15340,15340,0
Electronics|Hardware + Software|Manufacturing|UV LEDs,1516196.0,GBR,2,1,1875,13330,15205,0
Software,2700000.0,USA,2,5,788,11996,12784,1
Software,2000000.0,ISR,2,4,543,13922,14465,1
Crowdsourcing|Design|Freelancers|Marketplaces|Web Design,10966004.785247099,AUS,4,8,1952,14518,16470,1
Design,50000.0,SGP,1,2,0,14975,14975,0
Design|Education|Online Education|Training|User Experience Design|Web Design,400000.0,USA,2,3,315,15922,16237,0
Biotechnology,12731053.0,USA,4,6,1491,14777,16268,0
Design|Fashion|Printing,366681000.0,ESP,1,1,0,16148,16148,0
Assisitive Technology|Assisted Living,533444.2897456,DEU,2,3,634,16139,16773,0
EdTech|Enterprise Software|Mobile|Software,165000000.0,CAN,2,8,708,15587,16295,0
Commercial Real Estate,1600000.0,NLD,1,3,0,16770,16770,0
Advertising|Chat|Email Marketing|Interface Design|Marketing Automation|SaaS|Software,86625.0,USA,1,1,0,15750,15750,0
E-Commerce|Furniture,460180.0,ESP,1,2,0,15445,15445,0
Hospitality,18193.0,GBR,1,1,0,15786,15786,0
Analytics|Apps|Internet|Mobile|Software,280000.0,BRA,3,2,417,14963,15380,0
Software,4156680.0,FRA,2,2,1392,12784,14176,1
Web Hosting,26249976.0,USA,5,3,1600,13724,15324,1
Biotechnology|Life Sciences|Software,3223444.0,GBR,7,5,1190,15503,16693,0
3D Printing|3D Technology|Startups,14000000.0,USA,1,3,0,16735,16735,0
Consulting,1929900.0,DNK,2,5,305,15780,16085,0
Education|Software,900000.0,USA,3,4,419,15191,15610,0
Sports,236887.192115513,ITA,1,2,0,16735,16735,0
Leisure|Travel,291000000.0,USA,2,1,1084,15420,16504,0
Health Care|Information Technology|Services,18500000.0,USA,1,1,0,13901,13901,1
Software,16500000.0,CAN,2,4,737,13024,13761,0
Games,12000000.0,USA,1,1,0,13265,13265,0
Biotechnology,4709879.0,GBR,1,2,0,16286,16286,0
Manufacturing,50000.0,USA,1,1,0,13342,13342,0
Security,1700000.0,SWE,1,6,0,16500,16500,0
Crowdsourcing|Non Profit|Social Fundraising|Water,100000.0,USA,1,1,0,16436,16436,0
Education|Software,100000.0,USA,1,1,0,16010,16010,0
Games|Mobile|Startups,19611.0,EST,1,1,0,15765,15765,0
Security,215000000.0,USA,1,1,0,15167,15167,0
Development Platforms,11000000.0,USA,1,3,0,11479,11479,0
Audio|Electronics|High Tech,39100000.0,FRA,2,8,948,15656,16604,0
Art|Curated Web|Design|Graphics|Photography,13537704.0,USA,2,4,2289,13685,15974,0
Fraud Detection,2300000.0,DEU,2,1,273,15492,15765,0
Data Centers|Software,4505000.0,USA,2,2,25,16416,16441,0
Mobile,9646024.0,USA,4,2,789,14979,15768,0
Android|Home & Garden|iPhone|Linux|Location Based Services|Mac|Mobile|Software|Wireless,26812411.0,USA,5,7,2936,12814,15750,0
Environmental Innovation|Internet|Software,45500000.0,USA,4,24,1401,13361,14762,0
Bitcoin|Customer Service|Internet|Payments,200000.0,KOR,1,1,0,16350,16350,0
Construction|Energy|Enterprise Software|Governments|Utilities,13550000.0,USA,2,2,1077,13887,14964,0
Mobile,50000.0,USA,2,2,292,14612,14904,0
Games,4601259.0,KOR,2,3,405,14749,15154,0
Search,2600000.0,USA,1,1,0,14123,14123,0
Cloud Computing|Enterprise Software|Finance|Web Development,515000.0,USA,2,3,153,14000,14153,0
Curated Web|Software,20000000.0,USA,2,5,775,15452,16227,0
Hardware + Software|Health Care,26464019.0,USA,2,4,2653,12789,15442,1
Android|Software,1200000.0,IND,2,3,472,15264,15736,0
Games,20000000.0,CHN,1,2,0,14365,14365,0
Carbon|Clean Energy|Energy Management|SaaS|Software,1389159.0031395,ESP,1,2,0,15272,15272,0
Mobile|Optimization|Software,144500000.0,USA,7,34,2131,12023,14154,1
Mobile,35560000.0,USA,1,3,0,13570,13570,0
Interface Design|Mobile|Tablets|Usability|User Experience Design,340000.0,AUS,2,1,229,15826,16055,0
Artificial Intelligence|Computer Vision|Machine Learning,1710000.0,USA,1,10,0,16238,16238,0
Entertainment|Game|Internet,115549.0,BGR,2,2,151,16344,16495,0
Consulting,48000000.0,USA,1,1,0,13732,13732,0
Software,3000000.0,USA,1,6,0,15564,15564,0
Classifieds|Curated Web,50000.0,ARG,1,1,0,15048,15048,0
Architecture|Curated Web|E-Commerce|Home Decor|Home Renovation|Interior Design,165000.0,USA,2,1,37,16594,16631,0
Health Care|Medical Devices,127342000.0,USA,7,21,2300,13131,15431,0
Semiconductors,6838559.0,USA,5,2,1151,14645,15796,0
Semiconductors,6900000.0,CAN,2,4,862,12326,13188,0
Health Care|Innovation Management|Technology,1100000.0,USA,1,2,0,16727,16727,0
Curated Web,4750000.0,USA,1,2,0,13818,13818,0
E-Commerce,16000000.0,CHN,2,3,3179,13149,16328,0
Apps|Entertainment Industry|Music|Video Streaming,8250000.0,USA,2,5,633,15006,15639,1
Games,5000000.0,IND,1,1,0,13479,13479,0
Health and Wellness,11202957.0,USA,4,5,398,15083,15481,0
Biotechnology,1210000.0,GBR,1,2,0,12949,12949,0
Mobile,40000.0,USA,1,1,0,15670,15670,0
Health and Wellness|Health Diagnostics,10000000.0,USA,3,2,1247,15259,16506,0
Semiconductors,63500000.0,CAN,4,12,2068,14089,16157,0
Biotechnology,8000000.0,USA,1,1,0,16444,16444,0
Biotechnology,68700000.0,USA,4,11,2775,13525,16300,1
Biotechnology,927000.0,DEU,1,3,0,13703,13703,0
Biotechnology,9700000.0,CHE,2,5,1637,14226,15863,0
Health and Wellness|Health Care Information Technology|Medical,639401.0,NLD,2,3,304,15553,15857,0
Databases|Doctors|Health and Wellness|Information Technology|Internet|Medical|Pharmaceuticals|Remediation|Search,1700000.0,AUT,2,7,708,15279,15987,0
Biotechnology,1503411.0,GBR,1,2,0,15765,15765,0
Biotechnology,1621510.0,USA,3,2,1015,15198,16213,0
Diagnostics|Health Care|Medical,34000000.0,USA,1,2,0,12880,12880,0
Health Care Information Technology|Mobile Health,1700000.0,USA,1,1,0,15737,15737,0
Health Diagnostics|Medical,2010000.0,USA,6,13,760,15250,16010,1
Apps|Audio|Messaging|Web Development,1456000.0,IRL,1,2,0,14594,14594,0
Biotechnology,1780000.0,ITA,1,3,0,13149,13149,0
Brand Marketing|E-Commerce|Internet Marketing|Social Media Marketing,129454.0,GBR,2,1,183,15796,15979,0
Customer Service|Reviews and Recommendations|Social Media,25000.0,RUS,1,1,0,15778,15778,0
Events|Mobile|Productivity Software|Task Management,1825000.0,USA,5,4,455,16065,16520,0
Banking|Financial Services|Innovation Management|Investment Management,147000000.0,NGA,1,1,0,16398,16398,0
Analytics|Mobile|Sensors|Sports,1100000.0,USA,1,1,0,16268,16268,0
Semiconductors,2160000.0,GBR,1,2,0,14578,14578,0
3D|E-Commerce|SNS|Social Buying,390000.0,CHN,1,1,0,15199,15199,0
Health Care|Medical|Services,5000000.0,CHN,1,2,0,16549,16549,0
Social Media,10000000.0,CHN,1,3,0,15065,15065,0
Messaging,13000000.0,CHN,2,3,2498,11747,14245,0
Apps|Guides|Information Services|Internet,1041000000.0,CHN,5,10,3267,13239,16506,0
Finance,219000000.0,CHN,4,6,597,16070,16667,0
E-Commerce|Local|Local Search|Service Providers,12000000.0,CHN,3,3,1224,15475,16699,0
Security,3850000.0,CAN,2,6,1083,11752,12835,0
Email|Health and Wellness|Online Scheduling|SMS|Software,817895.0,IRL,1,1,0,16222,16222,0
Diagnostics|Medical Devices|Personal Health|Testing,120000.0,USA,2,2,334,16071,16405,0
Software,1000000.0,IRL,1,1,0,12784,12784,0
Medical Devices,20000.0,USA,1,1,0,14761,14761,0
Ad Targeting|Advertising|Mobile|Monetization|Software,349327.0,GBR,3,1,640,15706,16346,0
Semiconductors,57358050.0,FRA,2,15,674,13024,13698,1
Big Data|Content Discovery|Entertainment|Music|Ticketing,3800827.0,GBR,3,8,334,16314,16648,0
Biotechnology|Health Care,225450628.0,USA,5,15,1842,14075,15917,1
Cloud Infrastructure|Health Care,33884138.0,USA,6,7,2074,14677,16751,0
Health Care Information Technology,430930.0,GBR,1,1,0,13117,13117,0
Public Transportation|Transportation,4418000000.0,CHN,7,18,1101,15584,16685,0
Application Platforms|Digital Media|Mobile|Social Media|Social Network Media|User Experience Design,2518500.0,USA,2,1,171,16433,16604,0
Software|Tracking,20000.0,USA,1,1,0,15918,15918,0
Health and Wellness,599887.0,ESP,1,2,0,16518,16518,0
Analytics|Developer APIs|Enterprises|Internet|Mobile|Semantic Search,2500000.0,USA,2,10,1099,15491,16590,0
Biotechnology,1358459.0,USA,2,1,413,15015,15428,0
Manufacturing,830000.0,USA,1,1,0,14518,14518,0
Customer Service|Restaurants|Specialty Foods,21500000.0,USA,3,1,52,16403,16455,0
Software,17258983.0,USA,6,6,2129,14433,16562,0
Android|App Marketing|iPhone|Mobile|Software,18533749.0,USA,5,5,1688,13738,15426,1
EdTech|Education,2500000.0,USA,1,1,0,16077,16077,0
Health Diagnostics|Photography,386406.0,GBR,1,1,0,13208,13208,0
Design|News|Social Bookmarking|Social Media|Technology|Web Tools,49000000.0,USA,5,15,3695,13057,16752,1
Games,11150000.0,USA,2,1,65,15138,15203,0
Hardware + Software,77431466.0,GBR,1,1,0,15322,15322,0
Software,2290000.0,FRA,1,2,0,13657,13657,0
Games|Mobile,5500000.0,CHN,2,4,700,12449,13149,0
Mobile Security|Security|Technology,482786.0,USA,1,2,0,15706,15706,0
Information Services|Information Technology|Telecommunications,362660.0,BRA,1,1,0,11413,11413,0
Innovation Management|Manufacturing|New Product Development,9000000.0,USA,3,8,4189,12006,16195,0
Advertising,3203316.0,CHN,2,2,762,15248,16010,0
Biotechnology,10399999.0,USA,2,1,71,16203,16274,1
Games,5000000.0,HKG,1,1,0,14426,14426,0
Health Care|mHealth|Software,7800000.0,USA,1,4,0,16475,16475,0
Finance|Financial Services|Payments|Technology,13800000.0,USA,2,19,140,16420,16560,0
Game|Games|Video Games,3750000.0,IRL,2,5,274,15461,15735,0
Public Relations,10000000.0,USA,2,5,1064,12856,13920,0
Automotive|Digital Media|Social Media Management,13600000.0,USA,2,7,642,13901,14543,0
Search,5000000.0,USA,2,4,546,11336,11882,0
Mobile Health|Reputation|Software,12500000.0,USA,4,6,263,14998,15261,0
Education|Internet|SaaS,3000000.0,GBR,2,1,738,15857,16595,0
Mobile,31000000.0,USA,3,5,1075,13493,14568,0
Enterprise Software|Hardware + Software|Information Technology,73140000.0,CHN,1,2,0,14124,14124,1
Health Care|Health Care Information Technology|Mobile Health,250000.0,GBR,1,1,0,16240,16240,0
Games,370200.0,USA,2,1,237,14741,14978,0
EdTech|Education,150000.0,USA,4,3,931,15742,16673,0
Brand Marketing|Digital Media|Services,8000000.0,USA,1,1,0,12367,12367,0
Software,13000000.0,USA,3,9,1718,12241,13959,1
Artificial Intelligence|Machine Learning|Natural Language Processing|Software,3250000.0,USA,2,5,235,16373,16608,0
Analytics|Big Data Analytics|Energy|Enterprise Software|Oil & Gas|Software|Water,1275000.0,USA,1,1,0,16138,16138,0
Finance,11000000.0,USA,1,2,0,12993,12993,0
Consulting,20000000.0,USA,1,1,0,15601,15601,0
Big Data Analytics|Business Services|Enterprise Software|Manufacturing,10000000.0,USA,1,1,0,16238,16238,0
Energy Efficiency|Energy IT|Energy Management|Industrial Energy Efficiency|Internet of Things|Lighting|Sensors,49300645.0,USA,5,15,1764,14609,16373,0
Finance|Incubators|Startups|Venture Capital,4662412.0,ITA,2,2,136,16290,16426,0
Software,4400000.0,USA,2,2,124,12851,12975,0
Broadcasting|Digital Media,3100000.0,USA,1,1,0,9861,9861,1
Cloud Computing|Enterprise Software|IaaS,1058625.0,IRL,1,2,0,15058,15058,0
Music,22600000.0,IND,1,1,0,13505,13505,0
Media,300000.0,MYS,1,1,0,16384,16384,0
E-Commerce,19903476.0,USA,4,5,2002,13192,15194,0
Web Hosting,7060006.0,USA,3,5,3138,12207,15345,0
Software,3000000.0,TUR,1,1,0,14187,14187,1
Image Recognition|Social Media,26409.0,USA,1,1,0,15706,15706,0
Advertising|Automotive,4775579.0,USA,4,4,1486,13479,14965,0
Curated Web|Photography,15200000.0,USA,2,5,601,12948,13549,0
Analytics|Big Data|Big Data Analytics|Machine Learning|Natural Language Processing|Software|Text Analytics,28959965.0,USA,4,4,1408,14944,16352,0
Legal,20000000.0,USA,2,2,1004,13149,14153,1
Apps|Mobile|Mobile Commerce|Mobile Payments|Payments|Retail|Shopping,763333.528407457,CAN,1,1,0,16657,16657,0
Digital Media|Personal Branding|Social Commerce,500000.0,USA,1,1,0,15473,15473,0
Hardware + Software,41100000.0,USA,1,5,0,12879,12879,0
Analytics|Cyber Security|Financial Services|Information Security,8000000.0,GBR,3,4,791,15686,16477,0
Enterprise Software,85860220.0,USA,4,11,1387,15084,16471,0
Film|Lighting|Television,540000.0,USA,1,6,0,16358,16358,0
Games,1203771.0,GBR,1,1,0,15719,15719,1
Mobile,600000.0,USA,1,2,0,16283,16283,0
Advertising|Curated Web|Email Marketing|Performance Marketing,1000000.0,GBR,1,1,0,16143,16143,0
Facebook Applications|Games|iPhone|Mobile Games|Social Games,60900000.0,USA,5,18,2970,12387,15357,0
Data Security|Data Visualization|Enterprise Software,69050788.0,USA,5,6,3486,12662,16148,0
Analytics|Big Data|Machine Learning|Predictive Analytics|SaaS,1020000.0,GBR,1,5,0,15948,15948,0
Cloud Computing|Finance|Networking|Virtualization|Web Hosting,175205800.0,USA,6,11,1147,15477,16624,0
Biometrics|Hardware + Software|Network Security|Security,13000000.0,USA,1,5,0,12513,12513,1
Software,1300000.0,USA,2,1,314,14782,15096,0
Software|Video|Web Development,38251364.0,USA,6,12,2683,13434,16117,1
Manufacturing,1920000.0,USA,4,4,963,15305,16268,0
Brand Marketing|Concerts|Content|Games|Internet|Media|Social Media|Social Network Media|Travel & Tourism|Video|Video Streaming,12200000.0,USA,3,10,1644,15084,16728,0
Databases|Email|Internet|Mobile|VoIP,2500000.0,FRA,1,1,0,12784,12784,0
Audio|Communications Hardware|Software|VoIP,13800000.0,USA,1,1,0,13369,13369,0
Internet|Internet Marketing|Photo Editing|Web CMS|Web Development|Web Tools,40000.0,USA,2,4,92,16222,16314,0
Enterprises,10000000.0,CHN,1,2,0,14853,14853,0
Biotechnology,3209000.0,USA,3,4,364,16106,16470,0
Health and Wellness,20000.0,USA,1,1,0,15431,15431,0
Software,3145714.0,SWE,1,1,0,13725,13725,0
Advertising|E-Commerce|Retail|Sales and Marketing|Trading,2000000.0,USA,2,3,492,14457,14949,1
Collaboration|iOS|iPad|Mobile|SaaS|Security|Software,8000000.0,USA,2,1,782,13545,14327,1
Security,32500000.0,USA,2,7,1051,12695,13746,1
Digital Media|Mobile,99670000.0,USA,8,25,2604,12165,14769,0
Hardware + Software,2720000.0,DEU,2,2,807,13879,14686,0
Match-Making|Mobile|Online Dating,900000.0,USA,1,2,0,16526,16526,0
Curated Web,8400000.0,USA,2,5,516,13545,14061,1
EdTech|Music|Music Education,3000000.0,USA,1,2,0,16150,16150,0
Biotechnology,124500000.0,USA,4,10,519,16027,16546,0
Retail|Shopping|Skill Assessment,1350000.0,RUS,1,1,0,15492,15492,0
Biotechnology,768887.727014101,AUS,1,1,0,13041,13041,0
Broadcasting|Entertainment Industry|Social Television,500000.0,USA,1,1,0,16077,16077,0
Databases|Entertainment|Local|Mobile|Networking|Social Search,552000.0,USA,1,1,0,15431,15431,0
Education,16780.212773098,ESP,1,1,0,16703,16703,0
Delivery|Hospitality,514793.0,GBR,1,1,0,16094,16094,0
Restaurants|SMS|Software|Technology,20000.0,USA,1,1,0,15709,15709,0
Internet|Internet Marketing|Restaurants,25000.0,USA,1,1,0,16504,16504,0
Finance|Mobile,75000.0,HKG,1,1,0,15675,15675,0
E-Commerce,3600000.0,ARG,2,1,1331,13180,14511,0
Cloud Computing|Mobile|SaaS|Transportation,260000.0,ARG,3,1,927,14975,15902,0
Entertainment,2200000.0,GBR,2,1,65,16552,16617,0
Entertainment|Facebook Applications|Game|Games|MMO Games|Social Games|Social Media,400000.0,HKG,1,1,0,14396,14396,0
Events|Peer-to-Peer|Ticketing,252302.0,GBR,1,1,0,16290,16290,0
Customer Service|Online Reservations|Restaurants|Software,50000.0,USA,1,1,0,15218,15218,0
Enterprise Software,500000.0,BEL,1,2,0,15187,15187,0
Hospitality,10100000.0,USA,3,5,429,16224,16653,0
Hospitality,90918.0,GBR,1,1,0,15847,15847,0
Advertising|Internet|News|Public Relations|Publishing,81462.0,BRA,1,1,0,16344,16344,0
E-Commerce,6000000.0,IDN,1,2,0,15279,15279,0
Consulting,250000.0,USA,1,1,0,15248,15248,0
Biotechnology,31080000.0,USA,2,9,577,13042,13619,0
Semiconductors,18000000.0,USA,3,9,487,12022,12509,1
Curated Web|Facebook Applications|Social Media,900000.0,USA,1,3,0,13757,13757,0
Software,30000.0,USA,1,2,0,14214,14214,0
Health Care,240000.0,USA,1,1,0,15314,15314,0
Health Care,134347607.0,USA,5,21,2604,13805,16409,0
Search,26000000.0,USA,1,2,0,10805,10805,1
Electronics|Information Technology|Services,2000000.0,USA,1,1,0,11971,11971,0
Financial Exchanges|Financial Services|FinTech,3000000.0,USA,1,8,0,16562,16562,0
Web Hosting,4200000.0,CAN,1,2,0,15142,15142,0
Nanotechnology,4260000.0,GBR,1,1,0,14398,14398,0
Advice|Finance|Internet,16000000.0,USA,1,1,0,11666,11666,0
Legal,300000.0,USA,1,1,0,14092,14092,0
Apps|Customer Service,13000000.0,USA,3,6,1509,15065,16574,0
Consulting,7715715.0,USA,2,1,1785,12830,14615,1
Entertainment|Film|Photography|Private Social Networking,1717000.0,USA,2,10,698,15520,16218,1
Enterprise Software|Information Technology|Services,4000000.0,USA,1,2,0,16728,16728,0
Messaging,400000.0,CAN,1,1,0,14940,14940,0
Biotechnology,43747800.0,DEU,4,14,2687,12027,14714,1
Software,10000000.0,USA,1,3,0,12345,12345,1
Clean Technology,46941951.0,CAN,2,8,1065,13990,15055,1
Consumer Goods|E-Commerce|Specialty Foods,156000.0,USA,1,1,0,16587,16587,0
Aerospace|Defense,248086.0,GBR,1,1,0,16071,16071,0
Diagnostics|Health Diagnostics|Therapeutics,33250000.0,USA,2,4,0,12552,12552,0
Semiconductors,59311000.0,USA,5,19,3023,12515,15538,0
Analytics|Big Data|Enterprise Software|PaaS|SaaS,20000000.0,USA,1,1,0,16686,16686,0
Software,10000000.0,CAN,2,3,575,14742,15317,0
Content|Developer APIs|Search|Social Media,150000.0,ISR,1,1,0,16027,16027,0
Privacy|Search|Security,4100000.0,USA,2,12,452,15421,15873,0
Android|Entertainment|Hospitality|iPhone|Lifestyle|Nightlife|Travel,500000.0,USA,1,1,0,16322,16322,0
E-Commerce|Information Technology|Internet|Recycling,8500000.0,USA,1,1,0,14978,14978,0
Career Management|Education|Employment|Recruiting|Skill Assessment|Training|Young Adults,33724.0,GBR,1,1,0,16191,16191,0
Enterprises|Productivity Software|Social Media,778000.0,USA,2,6,33,15737,15770,0
Hospitality|Online Reservations|Travel,558612.0,GBR,2,1,267,15987,16254,0
Consumer Goods,15000000.0,USA,1,2,0,15572,15572,0
Pharmaceuticals,4900000.0,USA,2,2,106,16238,16344,1
Artificial Intelligence|Knowledge Management|Oil & Gas|Simulation|Software|Training|Virtual Worlds,150000.0,USA,1,1,0,14224,14224,0
Biotechnology,1610000.0,USA,1,3,0,16533,16533,0
Internet|Software,150470.0,ESP,2,2,366,15248,15614,0
Batteries|Databases|Diagnostics|Health Diagnostics|Medical Devices,500000.0,USA,2,1,47,16205,16252,0
E-Commerce,1138136.0,MEX,4,4,721,15765,16486,0
Hospitality|Local Search|Location Based Services|Mobile|Restaurants|Reviews and Recommendations,150000.0,RUS,1,1,0,15251,15251,0
Consumer Internet|Events|Hospitality|Restaurants|Social Media,150000.0,USA,1,1,0,15899,15899,1
Curated Web|Discounts|Promotional,100000.0,IDN,1,1,0,15187,15187,0
Networking,12200000.0,USA,2,4,1136,11416,12552,1
Cloud Computing|File Sharing|Finance|FinTech|Messaging|Productivity Software|Web Hosting,983000.0,USA,3,14,1189,15156,16345,1
Developer APIs|Enterprise Software|SaaS,6100000.0,USA,2,5,212,16375,16587,0
Services,6300000.0,USA,1,4,0,11996,11996,0
Biotechnology,14275217.0,USA,4,1,1106,15363,16469,0
Hardware + Software,4980000.0,RUS,3,9,180,15340,15520,0
Hardware + Software|Semiconductors,86650000.0,USA,7,25,2622,12971,15593,0
Software,1594194.0,GBR,1,1,0,16363,16363,0
Advertising|Crowdsourcing,725000.0,USA,2,2,422,15445,15867,1
Blogging Platforms|Curated Web|Forums|Opinions|Venture Capital,10500000.0,USA,3,6,1433,13665,15098,0
Big Data|Business Intelligence|Finance|Financial Services|FinTech|Investment Management|Venture Capital,2990725.0,USA,3,8,593,15793,16386,1
Communities|Digital Entertainment|Games|Internet|Mobile Games|PC Gaming|Social Games,4791000.0,USA,4,11,923,15470,16393,0
Advertising,4869058.0,CAN,1,1,0,15961,15961,0
Clean Technology,36893203.0,CAN,1,4,0,15785,15785,1
Cloud Computing|Cloud Infrastructure|Developer Tools|Enterprise Software|SaaS,2875000.0,USA,1,1,0,16455,16455,0
Advertising|Cloud Computing|Content Delivery|Digital Media|E-Commerce|Security|SEO,38048000.0,USA,10,29,1276,15340,16616,0
Software,3048000.0,CAN,3,3,474,13208,13682,1
Enterprise Software|Human Resources|Online Scheduling|Recruiting,1300000.0,USA,1,9,0,15965,15965,1
Software,3850000.0,AUS,1,1,0,12888,12888,1
News,7000000.0,USA,1,3,0,16244,16244,0
Energy Management,17000.0,USA,1,1,0,16191,16191,0
Fitness|Health and Wellness|Software,18885.0,USA,1,1,0,15522,15522,0
Apps|Curated Web|iPhone|Location Based Services|Online Reservations,775000.0,USA,1,2,0,14858,14858,1
Design|E-Commerce,8000000.0,USA,2,3,1176,15218,16394,0
Ad Targeting|Artificial Intelligence|Brand Marketing|Computer Vision|Deep Information Technology|Digital Media|Market Research|Mobile Analytics|Social Commerce|Social Media,9679742.0,USA,4,6,736,15917,16653,0
Biotechnology,11615514.0,GBR,3,3,1700,14587,16287,0
Curated Web|Diving|Travel,100000.0,FRA,1,2,0,15584,15584,0
Agriculture|Biotechnology,11800000.0,USA,1,3,0,14286,14286,1
Clean Technology,3155252.0,GBR,1,1,0,14951,14951,0
Travel,340931.0,GBR,1,1,0,15968,15968,0
Facebook Applications|Games|Social Games,300000.0,USA,2,4,277,14900,15177,0
Internet|Software,2000000.0,MEX,1,1,0,15095,15095,0
Social Media,65208.0,BGR,2,2,122,15796,15918,0
Software,25000000.0,USA,3,12,1103,14883,15986,1
Public Relations,5000000.0,USA,1,1,0,15964,15964,0
Messaging,41644215.0,USA,6,11,1718,13255,14973,0
Digital Media|Telecommunications|Video,5477332.0,NLD,2,3,474,15949,16423,0
Curated Web,2500000.0,USA,1,1,0,13757,13757,0
Legal|SaaS,25000.0,USA,1,1,0,16559,16559,0
Application Platforms|Curated Web|Interface Design|Web Hosting,1180000.0,USA,2,10,209,15574,15783,0
Software,750000.0,USA,3,6,169,15961,16130,0
Collaboration|Content|Social Media Marketing|Software,1800000.0,USA,3,8,684,15932,16616,0
Curated Web,10000.0,USA,1,1,0,14245,14245,1
Software|Video,35000000.0,USA,4,17,1881,11201,13082,1
Advertising|Portals,8250000.0,ARE,2,1,289,15860,16149,0
Hardware + Software,9350000.0,IND,1,1,0,13997,13997,0
Education|Kids|Skill Assessment,5500000.0,USA,2,4,420,15316,15736,0
Education,40000.0,CAN,1,1,0,15440,15440,0
Apps,12500.0,HKG,1,1,0,16405,16405,0
Advertising|Network Security|Search|SEO|Social Media,3500000.0,USA,4,4,2009,14384,16393,0
Contests|Designers|Marketplaces,62500.0,RUS,1,3,0,16049,16049,0
Web Hosting,4578080.0,USA,2,5,931,15531,16462,0
Games|Kids|Virtual Worlds,2000000.0,USA,2,3,201,13916,14117,0
Consumer Electronics|Technology,105000000.0,CHN,2,2,369,16191,16560,0
E-Commerce,798000.0,DEU,1,1,0,13489,13489,0
Banking,14000000.0,USA,1,1,0,16304,16304,0
Clean Technology,6769900.0,USA,2,4,1,15838,15839,0
Software,3610000.0,FRA,1,2,0,13858,13858,0
Ad Targeting|Big Data Analytics|Consumer Behavior|Data Mining|Electronic Health Records|Health and Insurance|Health and Wellness|Health Care Information Technology|Interest Graph|Natural Language Processing|Personal Health|Pharmaceuticals|Predictive Analytics|Public Relations|Reviews and Recommendations|Semantic Search|Social Media Advertising|Social Media Monitoring|Text Analytics,3600000.0,USA,2,3,731,14975,15706,0
Intellectual Asset Management,5000000.0,USA,1,2,0,12030,12030,0
Big Data|Biometrics|Data Privacy|Enterprise Software|Health Care Information Technology|Maps,250000.0,USA,1,1,0,15506,15506,0
Software,3575000.0,USA,2,5,233,15138,15371,0
Software,4530000.0,CAN,1,2,0,13641,13641,0
Clinical Trials|Genetic Testing|Testing,485759.0,GBR,3,3,276,16191,16467,0
Biotechnology,1940000.0,NLD,1,2,0,12886,12886,0
Biotechnology,46550000.0,USA,4,16,2088,14459,16547,0
Art|Entertainment|Graphic Design,40000.0,CHL,1,1,0,15440,15440,0
Biotechnology,39554718.0,USA,10,12,3081,13276,16357,0
Education|Social Network Media,11500000.0,RUS,3,3,612,14975,15587,0
Clean Technology,12000000.0,USA,1,6,0,14626,14626,0
Meeting Software|Productivity Software|Software,2400000.0,USA,2,15,495,16009,16504,0
Mobile Devices,1420000.0,USA,2,4,295,16267,16562,0
Technology,1000000.0,USA,2,3,357,11250,11607,0
E-Commerce,45180.0,CAN,1,1,0,16161,16161,0
Apps|Document Management|Events,1500000.0,ISR,1,3,0,16673,16673,0
Analytics|B2B|Document Management|Software,560000.0,USA,2,6,192,15856,16048,0
Doctors|Health Care|Internet|Portals|Startups,8600000.0,SGP,1,3,0,16552,16552,0
Doctors|Internet|Recruiting|Reviews and Recommendations|Search,1000000.0,RUS,1,1,0,15645,15645,0
Software,1500000.0,FRA,1,4,0,14762,14762,0
Corporate Training|EdTech|Education|Enterprise Software|Software|Training,6371788.0,ITA,3,3,3119,13359,16478,1
Development Platforms|Open Source|Software,180000000.0,USA,5,19,1700,15048,16748,0
Professional Networking|Public Relations|Small and Medium Businesses|Social Network Media,550200.0,ESP,1,1,0,15006,15006,0
Doctors|Health Care|Marketplaces|Mobile|News,1000000.0,USA,2,1,258,15340,15598,0
Health and Wellness,14000000.0,POL,3,12,891,15677,16568,0
Health Care,700000.0,IND,1,2,0,16714,16714,0
Curated Web|Legal,850000.0,USA,2,4,427,15281,15708,0
Law Enforcement|Legal|Software,1250000.0,USA,3,6,160,15218,15378,0
Software,863000.0,FRA,1,2,0,13866,13866,0
Software,1700000.0,USA,1,3,0,16071,16071,0
Curated Web,4000000.0,USA,2,6,179,13818,13997,0
Curated Web|Dental|Doctors,26348240.216442,FRA,3,12,650,16071,16721,0
Health Care,5800000.0,RUS,3,4,861,15492,16353,0
Manufacturing,23918.0,GBR,1,1,0,15431,15431,0
Medical|Real Time|Training,324713.0,NLD,2,1,149,15434,15583,0
Health Care,86749919.0,USA,3,25,587,16049,16636,0
Finance Technology|FinTech|Insurance|Property Management|Retirement|Reviews and Recommendations,640000.0,SGP,1,4,0,16356,16356,0
Diagnostics|Doctors|Health and Wellness|Health Care,410000.0,IND,1,3,0,16329,16329,0
Healthcare Services|Online Scheduling,20000.0,USA,1,1,0,16357,16357,0
Analytics|Document Management|Enterprises|Finance|FinTech|PaaS|SaaS|Security,2000000.0,FRA,2,11,252,15363,15615,1
Analytics|Deep Information Technology|Software Compliance,700000.0,NOR,1,1,0,16375,16375,0
Recruiting,596946.0,GBR,1,2,0,16518,16518,0
Security,12862048.0,USA,6,1,1224,14393,15617,1
Nonprofits,2439500.0,USA,3,1,1832,14426,16258,0
B2B|Collaboration|Enterprise Software|SaaS,5350000.0,USA,2,1,615,15492,16107,0
Cloud Management|Software,508099999.0,USA,14,61,4529,12053,16582,0
Software,2250000.0,USA,4,6,1186,14944,16130,1
Health Care,28301362.0,USA,4,3,734,15399,16133,0
Curated Web,1300000.0,USA,1,4,0,14083,14083,1
Document Management|Enterprise Software|Information Technology|Software Compliance,218000.0,USA,2,2,154,16590,16744,0
Colleges|EdTech|Education|Technology|Tutoring,250000.0,USA,1,1,0,14488,14488,0
Consulting,1594442.0,GBR,1,1,0,15400,15400,0
Bitcoin|Finance|Internet|Mobile Payments|Payments|Service Providers,500000.0,USA,1,1,0,16379,16379,0
Consulting|Veterinary,1653913.0,GBR,1,2,0,16071,16071,0
Coupons|Discounts|Pets|Social Commerce,2500000.0,USA,2,3,719,15221,15940,0
Pets|Social Media|Social Network Media,1000000.0,USA,1,9,0,13392,13392,1
Curated Web,1000000.0,USA,1,1,0,13757,13757,1
Pets,47000000.0,USA,5,27,976,15408,16384,0
Cloud Computing|Productivity Software|Project Management|Software|Task Management,40000.0,CHL,1,1,0,14975,14975,0
Facebook Applications|Social Media|Social Media Marketing,880000.0,USA,2,1,418,15013,15431,0
Business Analytics|Entertainment Industry|Events,1199994.0,GBR,1,5,0,16461,16461,0
Analytics|Machine Learning|PC Gaming|Sports,2250000.0,DEU,1,5,0,16596,16596,0
Collaboration|Document Management|Email|File Sharing|Software,535726.0,CAN,2,3,610,14365,14975,1
Health Care|Health Care Information Technology|Personal Health,141461.0,PER,3,3,61,16495,16556,0
E-Commerce|Retail,163500000.0,USA,5,29,1353,15405,16758,0
Advertising|Internet|Public Relations,5000000.0,USA,1,5,0,16736,16736,0
E-Commerce,5900000.0,USA,2,1,942,15351,16293,0
Automotive|Content Delivery|Peer-to-Peer,9700000.0,USA,2,6,294,16415,16709,0
Advice|Legal|Professional Services,10000000.0,USA,1,1,0,12486,12486,0
Curated Web|Domains,230000.0,USA,1,1,0,13970,13970,0
Domains|Finance,120000.0,CYM,1,1,0,14457,14457,0
Web Hosting,4884228.0,USA,3,4,1786,14376,16162,0
Finance,7530000.0,LUX,1,1,0,14763,14763,0
Biotechnology,45373444.0,USA,5,2,1140,14995,16135,0
Biotechnology,37586346.0,FRA,6,21,4455,11719,16174,0
Biotechnology,5485431.0,GBR,3,5,2268,13992,16260,0
Domains|Registrars|Search,250000.0,LUX,1,1,0,15218,15218,0
Cloud Computing|Cloud Security|Information Technology|Linux|Networking|Network Security|Security,12800000.0,ISR,3,5,1592,15117,16709,0
Religion,500000.0,ITA,1,2,0,16198,16198,0
Analytics|Data Mining|Machine Learning|Software,3100000.0,USA,2,3,111,16540,16651,0
Art|Curated Web|Events|Local|Local Based Services|Mobile|Nightlife|Restaurants,75000.0,USA,3,3,92,15400,15492,0
Business Intelligence|Enterprise Software|SaaS|Web Development,483687225.0,USA,8,45,2546,14092,16638,0
Home Automation,644016.0,CHE,2,5,620,15645,16265,0
Advertising|App Marketing|Mobile,23000000.0,CHN,3,4,425,15006,15431,0
Furniture|Health Care,473664.0,BEL,1,2,0,15706,15706,0
Information Technology,28000.0,NOR,1,1,0,16019,16019,0
Mobile Payments|Online Rental|Real Estate,25000.0,USA,1,1,0,16734,16734,0
Curated Web|Design|Freelancers|Recruiting|Search|Writers,1000000.0,ISR,2,4,1274,13879,15153,0
Employer Benefits Programs|Environmental Innovation|Sustainability,393781.0,GBR,3,3,418,15987,16405,0
Apps|Enterprise Software|Location Based Services|Mobile,1165000.0,USA,2,6,190,15916,16106,1
Apps|Mobile,200000.0,USA,3,4,0,15918,15918,0
Advertising,30000.0,USA,1,1,0,14791,14791,0
Advertising,1612036.0,CHN,1,1,0,16161,16161,0
Games,9300000.0,USA,2,3,645,13131,13776,0
Curated Web,27500.0,KOR,1,1,0,15584,15584,0
Nonprofits,250000.0,USA,2,2,239,15706,15945,0
Analytics|Data Integration|Internet|Search,25000.0,USA,1,1,0,15778,15778,0
All Students|Crowdfunding|Games|Non Profit,400000.0,USA,2,2,365,14975,15340,0
Domains|Enterprise Software|Internet,101060000.0,USA,4,9,886,15093,15979,0
Cloud Computing|Document Management|Enterprise Software|Productivity Software|SaaS|SEO,10000000.0,DEU,2,8,197,15309,15506,0
Cosmetics|E-Commerce,1300000.0,USA,1,2,0,15918,15918,0
Analytics,968000.0,USA,3,10,915,14638,15553,0
Cloud Computing|Document Management|Enterprise Software|Internet,622125.0,ESP,1,3,0,15034,15034,0
Android|Apps|Business Development|Business Services|Digital Media|Entertainment|Entrepreneur|Facebook Applications|Internet|iOS|iPad|iPhone|Social Media,100000.0,USA,1,1,0,16071,16071,0
Curated Web|E-Commerce|Parenting,1270000.0,USA,1,17,0,14641,14641,1
College Recruiting|Internet|Recruiting,250000.0,USA,1,2,0,16680,16680,0
Hospitality,31800000.0,USA,3,3,1183,15574,16757,0
Delivery|Local|Local Businesses|Logistics|Mobile|Small and Medium Businesses,59700000.0,USA,4,24,755,15765,16520,0
Delivery|E-Commerce|Logistics|Mobile|Shipping,3000000.0,USA,3,7,681,16012,16693,0
Apps,3000000.0,IND,2,3,110,16542,16652,0
Career Management|Curated Web|Employment|Networking|Search|Social Network Media,5750000.0,USA,3,2,1100,13545,14645,1
Android|Games|iOS|Music|SNS|Social Network Media,887303.0,KOR,1,1,0,15365,15365,0
Advertising|Digital Media|E-Commerce Platforms|Market Research,33284175.0,DEU,3,4,532,10926,11458,1
Tourism|Travel,154392.0,GRC,1,1,0,15902,15902,0
Games,11000000.0,USA,1,6,0,13726,13726,0
Audio|Consumer Electronics|Consumer Goods|Wearables,17635000.0,USA,4,33,521,16102,16623,0
Colleges|Curated Web,950000.0,USA,2,1,856,13879,14735,0
E-Commerce,250000.0,USA,1,1,0,14730,14730,0
Software,645000.0,USA,1,2,0,16414,16414,0
Analytics,750000.0,CAN,1,5,0,14600,14600,0
E-Commerce,500000.0,ZMB,1,4,0,16687,16687,0
Health Care,861815.0,GBR,1,1,0,15552,15552,0
Curated Web|Gambling,3762066.0,USA,3,5,1362,13514,14876,0
Cloud Computing|PaaS|Software|Venture Capital,28679147.0,USA,4,16,1271,14822,16093,1
Web Development,10000000.0,USA,1,2,0,11122,11122,0
Travel,40000.0,USA,1,1,0,15419,15419,0
Real Estate,7000000.0,USA,1,1,0,15482,15482,1
Open Source|Software|Web Tools,10338000.0,USA,3,6,1318,14204,15522,0
Games|Mobile|Mobile Games,10000000.0,USA,1,6,0,16420,16420,0
Fashion,51000000.0,USA,1,1,0,15961,15961,0
Public Relations|Semantic Search,300000.0,USA,1,2,0,13757,13757,0
Entertainment|Music|Reviews and Recommendations|Social Media|Textbooks,59000000.0,CHN,3,5,1888,13330,15218,0
Financial Services|Software,3200000.0,RUS,1,3,0,16504,16504,0
B2B|Brand Marketing|Enterprise Software|Gamification|Loyalty Programs|Market Research|Social Media|Surveys,40000.0,ARG,1,2,0,15972,15972,0
Curated Web,59000000.0,USA,4,12,1592,13098,14690,0
Genetic Testing|Natural Resources|Risk Management|Sustainability,707138.270547945,SGP,1,2,0,16283,16283,0
Hardware + Software|iPad|Robotics,250000.0,USA,1,4,0,15604,15604,0
Software,11310000.0,CAN,1,3,0,12808,12808,0
Enterprise Application|Enterprise Software|Marketing Automation|Mobile,78499000.0,USA,7,36,1793,14866,16659,0
Public Transportation,40000.0,USA,1,1,0,16029,16029,0
Advertising|Displays|Internet|Internet Marketing|Lead Generation|Sales and Marketing,7200000.0,USA,3,9,1057,13392,14449,1
Advertising,1600000.0,USA,1,5,0,15383,15383,0
Finance,7500000.0,USA,2,6,342,14000,14342,0
Advertising,49500000.0,USA,4,8,834,14382,15216,0
Software,9000000.0,USA,1,2,0,12363,12363,0
Investment Management|Personal Finance|Social Investing,29000000.0,USA,2,2,594,15675,16269,0
E-Commerce|Hospitality|Local|Logistics,100000.0,USA,1,1,0,16375,16375,0
Manufacturing,44542416.0,CHN,4,5,1267,15126,16393,0
E-Commerce,4000000.0,CHN,1,1,0,15522,15522,0
Information Services|Web Hosting,1000000.0,BRA,1,2,0,16101,16101,0
Auctions|Finance|Governments,13000000.0,USA,1,2,0,12363,12363,1
Curated Web,1000000.0,USA,1,2,0,15824,15824,0
Android|Apps|iOS|Online Scheduling|Private Social Networking|Social Media,12500.0,USA,2,2,195,16189,16384,0
Health Care,81800000.0,USA,3,9,1140,15049,16189,0
Data Security|E-Commerce|Internet,18750000.0,USA,4,5,1939,14123,16062,0
Enterprise Software|SaaS|Search Marketing|Social Media Marketing,1500000.0,USA,1,5,0,16328,16328,0
Medical,20000.0,USA,1,1,0,16293,16293,0
Hospitality,5600000.0,USA,1,1,0,15027,15027,0
Internet|Mobile|SMS|Telecommunications,25000.0,RUS,1,1,0,16040,16040,0
Games,875000.0,USA,1,1,0,15434,15434,0
Recruiting,3197000.0,USA,2,6,41,16574,16615,0
Fantasy Sports|Games|Sports,375000000.0,USA,6,25,1102,15540,16642,0
Hardware|Hardware + Software,2600000.0,USA,3,7,277,15925,16202,0
E-Commerce|Retail,115452.0,BGR,1,1,0,15798,15798,0
Legal|SaaS,41250.0,HKG,1,1,0,16252,16252,0
Mobile,120000.0,CHN,1,1,0,13776,13776,0
Analytics|Big Data|Cloud Computing|Financial Services,15931.0,SGP,2,1,679,15857,16536,0
News,3000000.0,USA,1,3,0,13942,13942,0
Big Data|Big Data Analytics|Cloud Data Services,1200000.0,USA,1,1,0,16587,16587,0
Career Management|Curated Web|Freelancers|Human Resources|Recruiting|Staffing Firms,20000.0,AUS,1,1,0,15371,15371,0
Games,1000000.0,USA,1,1,0,14617,14617,0
Android|Games|Social Games,14000000.0,ISR,2,4,350,15432,15782,1
Web Hosting,34674740.0,CAN,2,3,4307,11976,16283,1
Clean Technology,18742845.0,USA,8,8,2136,14102,16238,0
Mobile|Networking,2099376.0,KOR,2,4,212,16190,16402,0
Freemium|Games|Television|Video|Video on Demand|Video Streaming,11491490.0,USA,4,15,865,15054,15919,1
Retail,10000000.0,USA,1,3,0,16710,16710,0
Clean Technology,7500000.0,USA,2,2,33,13859,13892,1
Ad Targeting|Advertising|Marketing Automation|Mobile|Online Identity|Optimization|SaaS,20500000.0,USA,2,5,286,15471,15757,0
Cyber Security|Enterprise Security|Network Security|Security,1710000.0,USA,1,6,0,16416,16416,0
Analytics|Big Data|Cloud Computing|Consumer Electronics|Databases|Enterprises|Search|Software,925000.0,USA,1,2,0,15408,15408,0
Web Hosting,350000.0,TWN,1,1,0,14623,14623,0
Hardware + Software,500000.0,USA,1,1,0,12993,12993,1
Apps|App Stores|Developer APIs|Doctors|Electronic Health Records|Health and Wellness|Health Care|Medical|Physicians,6725000.0,USA,8,22,1192,14978,16170,0
Software,36500000.0,RUS,3,3,1065,15126,16191,0
Financial Services,6000000.0,CAN,1,3,0,16520,16520,0
Apps|Social Games|Weddings,7500000.0,USA,1,1,0,16237,16237,0
EdTech|Education|Software|Tutoring,45600000.0,USA,5,10,2868,13803,16671,0
Fashion,100000.0,USA,1,1,0,15356,15356,0
Biotechnology,10000000.0,USA,1,7,0,13670,13670,0
Developer APIs|Enterprise Software|Mobile Software Tools|SaaS,18800000.0,USA,5,2,3258,13151,16409,0
Angels|Crowdfunding|Finance Technology|Marketplaces|Venture Capital,200000.0,USA,1,1,0,16313,16313,0
Software,25000.0,USA,1,1,0,16664,16664,0
Cloud Computing|Cloud Data Services|Domains|Web Hosting,30000000.0,USA,1,1,0,16043,16043,0
Online Travel|Shipping|Transportation|Travel|Travel & Tourism,37059448.0,DEU,3,13,838,15553,16391,0
Android|Apps|Content|Curated Web|Databases|Facebook Applications|Health and Wellness|Internet|iPhone|Mobile|Publishing|Social Media|Windows Phone 7,2000000.0,USA,1,1,0,16308,16308,0
B2B|Domains|Entrepreneur|Internet|Sales and Marketing|Small and Medium Businesses|Software|Startups|Web Development,20000.0,USA,1,1,0,15765,15765,0
Developer APIs|Games|Publishing,158080.0,FRA,2,2,0,15218,15218,0
Software,54945.0,IRL,1,1,0,15507,15507,0
Software,10000000.0,USA,1,2,0,16703,16703,0
Semiconductors,590000.0,DEU,1,1,0,13110,13110,0
Retail,750000.0,SGP,1,1,0,16071,16071,0
Internet,2117354.65769402,ITA,2,5,317,16434,16751,0
Electronic Health Records|Software,50500000.0,USA,4,3,434,16288,16722,0
Information Technology,5000000.0,USA,1,1,0,14060,14060,0
Hardware + Software|Internet of Things,20000.0,USA,1,1,0,16072,16072,0
Internet Marketing|Marketing Automation|Social Media Marketing,1000000.0,GBR,1,3,0,16160,16160,0
Business Services|Communications Infrastructure|Customer Support Tools,15000000.0,USA,1,6,0,16448,16448,0
Biotechnology|Health Diagnostics|Pharmaceuticals,500000.0,USA,1,2,0,15929,15929,0
Software,9179849.0,USA,4,4,741,15484,16225,0
Analytics|Business Information Systems|Oil and Gas,191577006.0,USA,3,4,1103,15404,16507,0
Real Estate,5140000.0,FRA,2,2,189,13690,13879,0
Games,4000000.0,RUS,1,2,0,14634,14634,1
Advertising|Mobile|Sales and Marketing|Technology,240000.0,USA,3,2,503,15533,16036,0
Personal Branding|Social Media,50000.0,USA,1,1,0,15706,15706,0
Health Care|Medical,8600000.0,USA,3,10,398,15898,16296,0
Android|App Discovery|App Marketing|iPad|iPhone|iPod Touch|Mobile,6350000.0,USA,3,15,1481,15134,16615,0
Educational Games|Insurance|Training|Travel,250000.0,USA,2,1,463,16071,16534,0
Automotive|Transportation,952601.0,SGP,2,2,427,15712,16139,0
Curated Web|Online Rental|Travel,5500000.0,TUR,1,1,0,15846,15846,0
Hardware + Software,808000.0,CAN,1,1,0,12789,12789,0
Systems|Technology|Video,46000000.0,USA,2,5,614,12959,13573,0
Analytics,5049999.0,USA,2,3,603,15330,15933,1
Cars|Insurance|Mobile|Reviews and Recommendations,300000.0,USA,1,2,0,15070,15070,0
Automotive|Cars|Mobile,2650000.0,USA,2,1,344,16071,16415,0
Automotive|Cars,10607806.0,USA,3,5,778,14068,14846,0
Marketplaces,70000000.0,USA,2,3,213,16489,16702,0
Finance Technology|Financial Services|FinTech|Personal Finance|Social Investing|Wealth Management,4000000.0,USA,2,2,1130,15423,16553,0
Public Transportation,7500000.0,CAN,2,3,313,15939,16252,0
Android|Apps|Automotive|Information Technology|iPhone|Mobile|Public Transportation|Technology,9968387.88827189,DNK,11,3,1414,15309,16723,0
Delivery|Hospitality,17750000.0,USA,3,28,481,16092,16573,0
Hardware + Software,47000000.0,USA,5,15,3627,13080,16707,0
Mobile,11752639.0,CHN,3,2,852,14944,15796,0
Mobility|Software|Virtualization,13945000.0,USA,3,2,806,15706,16512,0
Curated Web,4532800.0,FRA,1,1,0,13788,13788,0
Cloud Computing|Software|Testing,28000.0,USA,1,1,0,15896,15896,0
Drones,120000.0,USA,2,5,128,16405,16533,0
Drones|Internet of Things|SaaS|Software,11000000.0,USA,3,10,699,15826,16525,0
Clean Technology,1500000.0,ISR,1,6,0,16687,16687,0
Automotive|E-Commerce Platforms|Marketplaces,18000000.0,IND,2,2,405,16241,16646,0
Local|Location Based Services|Messaging|Proximity Internet|Search|Social Media,1250000.0,USA,1,3,0,16287,16287,0
Consumer Goods|Cooking|Hardware + Software,3637713.0,USA,3,15,286,16071,16357,0
EdTech|Education|Email|File Sharing|Finance|FinTech|Flash Storage|Mobile,8750000.0,USA,3,6,882,13850,14732,1
E-Commerce,1250000.0,USA,1,2,0,16019,16019,0
Cloud Data Services|Storage|Web Hosting,1107215000.0,USA,6,29,2501,13665,16166,0
Hardware|Security|Software|Video,47800000.0,USA,4,20,1613,14304,15917,1
Apps|Curated Web|Mobile|Photography,1000000.0,ISR,1,1,0,14980,14980,0
Customer Service|Social Media|Social Media Agent|Software|Tech Field Support,100000.0,USA,2,2,470,15340,15810,0
Restaurants,300000.0,IND,1,2,0,16678,16678,0
Mobile Video|Video|Video Conferencing|Video Processing|Video Streaming,700000.0,USA,2,3,547,16083,16630,0
Mobile|Mobile Payments,2390168.10981543,GBR,5,3,1226,15340,16566,0
Enterprise Software|File Sharing|Mobile|Software,738516.0,USA,2,3,199,15996,16195,0
Logistics Company,7000000.0,USA,1,5,0,16608,16608,0
E-Commerce|Enterprise Software|SaaS|Software|Supply Chain Management,4300000.0,USA,2,4,137,15603,15740,0
Analytics|Customer Service|Information Technology,4902500.0,USA,3,2,643,15810,16453,0
Advanced Materials|Clean Technology|Energy Efficiency|Industrial Energy Efficiency|Manufacturing,340000.0,USA,4,5,226,16372,16598,0
Aerospace|Analytics|Drones|Hardware + Software|Open Source|SaaS,39240.3076440119,SGP,1,2,0,16344,16344,0
Biotechnology,48038886.0,USA,2,8,671,11382,12053,0
E-Commerce,63000000.0,USA,1,3,0,11413,11413,1
Consumers|Enterprises|Mobile|Social Media,500000.0,USA,2,3,6,15196,15202,0
Contact Management|Location Based Services|Messaging|Mobile,1000000.0,ISR,1,2,0,16314,16314,0
Enterprise Software|File Sharing|Mobility|Storage,67000000.0,USA,4,11,1582,14706,16288,0
Big Data Analytics|Information Technology|Internet of Things|Software|Technology,50000.0,THA,2,1,221,16499,16720,0
Games,460222.0,KOR,1,1,0,15735,15735,0
E-Commerce,48500000.0,USA,5,5,1363,14885,16248,0
Mobile|Reviews and Recommendations|Wine And Spirits,3050000.0,USA,3,8,898,15271,16169,0
Design|Internet|Marketplaces,20000.0,USA,1,1,0,15890,15890,0
Software,2650000.0,FRA,1,2,0,12849,12849,0
E-Commerce|Fashion,5400000.0,USA,2,17,571,15813,16384,0
Financial Services,600000.0,ARG,1,1,0,16255,16255,0
Security|Software,15000000.0,USA,1,2,0,16491,16491,0
Hospitality|Retail Technology|Specialty Retail|Technology,67000000.0,USA,3,2,1603,14405,16008,0
3D|Apps|Image Recognition|Licensing|Software,7100000.0,USA,2,3,118,16393,16511,0
Big Data|Cloud Computing|Cloud Infrastructure|Consulting|Information Security|Training,200000.0,USA,1,2,0,16252,16252,1
Public Transportation|Ride Sharing|Transportation|Travel,25000.0,RUS,1,2,0,16479,16479,0
Business Services|Mobile,7516703.0,USA,4,1,1404,14092,15496,0
Group SMS|Messaging|Video,5910179.0,DEU,2,8,426,16252,16678,0
Clean Technology,26294000.0,BEL,1,2,0,14963,14963,0
Software,7000000.0,USA,1,1,0,12914,12914,1
Search,3000000.0,USA,1,7,0,15260,15260,0
Android|Apps|EdTech|Education|iPad|iPhone|Kids|Mobile,7000000.0,USA,1,3,0,15610,15610,0
Analytics|Developer APIs|Software|Web Development|Web Tools,747936.0,ESP,2,6,662,15431,16093,1
Curated Web|Internet|Mobile|Optimization,18600000.0,USA,3,13,1193,14610,15803,0
Software,100000000.0,USA,1,1,0,16104,16104,0
Analytics|Transaction Processing,22000000.0,GBR,5,13,1006,15126,16132,0
Games,200000.0,USA,1,3,0,15279,15279,0
Big Data|Business Intelligence|Cloud Computing|Hospitality|Hotels|News|Price Comparison|SaaS|Software|Travel,93276604.0,USA,5,23,1321,15449,16770,0
E-Commerce,2000000.0,TUR,1,1,0,15891,15891,0
E-Commerce|Social Commerce,50000.0,PER,1,1,0,15645,15645,0
Apps|Fashion|Mobile Commerce,124319.0,BRA,2,1,304,16040,16344,0
Software,190000.0,KOR,1,1,0,15763,15763,0
Local Businesses,8485408.0,GBR,1,1,0,16049,16049,0
Health Care,26500000.0,ISR,2,3,2920,13327,16247,0
Semiconductors,2000000.0,USA,1,1,0,13007,13007,0
Semiconductors,12000000.0,USA,2,7,885,13007,13892,1
Collaboration|Enterprise Software|Human Resources|SaaS,1750000.0,USA,3,12,363,16115,16478,0
Crowdsourcing|Education|Translation,83300000.0,USA,4,14,1330,15266,16596,0
Agriculture|Automotive|Business Services|Investment Management,9000000.0,USA,1,1,0,14427,14427,1
Biotechnology,250000.0,USA,1,1,0,14790,14790,0
Biotechnology|Health Care|Pharmaceuticals,70000000.0,USA,1,1,0,16016,16016,1
Manufacturing,1896024.0,GBR,1,2,0,15383,15383,0
E-Commerce|Marketplaces|Mobile Commerce|Social Commerce,3300000.0,SGP,2,4,476,16049,16525,0
Consulting|Consumer Goods|Sales and Marketing,498000.0,BRA,1,1,0,8126,8126,0
Mobile,29000000.0,USA,2,7,351,12466,12817,0
Mobile,140000.0,CHL,3,2,642,15346,15988,0
Hardware + Software,1408405.0,GBR,1,1,0,14845,14845,0
Automated Kiosk|Entertainment|Manufacturing,20000000.0,USA,1,4,0,13327,13327,0
Doctors|Health and Wellness|Health Care|Medical,15000.0,USA,1,2,0,15924,15924,0
Games,28500000.0,USA,1,1,0,13201,13201,0
Manufacturing,14600000.0,USA,1,3,0,15169,15169,1
Manufacturing,21500000.0,USA,2,3,1419,15154,16573,0
Home Owners|Service Providers|Social Commerce,138978.0,FRA,1,1,0,14914,14914,0
Life Sciences|Travel,2000000.0,USA,1,3,0,16231,16231,1
Big Data Analytics|Business Analytics|Finance Technology|Information Services|Internet|Predictive Analytics|Real Estate,2181000.0,USA,2,7,98,16054,16152,0
Customer Service|Data Integration,31000000.0,USA,1,2,0,11589,11589,1
CRM|Real Estate|Software,35000.0,USA,3,4,376,15658,16034,0
Apps,14000000.0,USA,2,2,379,16316,16695,0
Accounting|Mobile Payments|Software|Virtualization,32505000.0,USA,6,13,1794,14549,16343,0
Software,12820000.0,FRA,1,6,0,13178,13178,0
Biotechnology,1000000.0,USA,1,1,0,15567,15567,0
Health Care|Medical|Networking|Physicians,82000000.0,CHN,3,5,1645,14669,16314,0
E-Commerce,1350000.0,FRA,1,2,0,15706,15706,0
Advertising|Brand Marketing|Discounts|Entertainment|Media|Music|Sponsorship,402500.0,USA,1,6,0,13998,13998,0
Cloud Computing|Internet|SaaS|Web Hosting,38000000.0,USA,1,1,0,15615,15615,0
Enterprise Software,2000000.0,USA,1,2,0,14617,14617,0
Advertising|Brand Marketing|Video,4500000.0,FRA,2,1,837,15492,16329,0
Cloud Computing|Enterprise Software|Software,1215385.0,ESP,3,6,1115,13495,14610,0
Energy,300000.0,USA,1,1,0,16239,16239,0
Software,1700000.0,GBR,1,1,0,13411,13411,0
Enterprise Software|Services,10000000.0,USA,1,4,0,11416,11416,0
Hardware + Software,1200000.0,USA,1,1,0,12871,12871,0
Content|Corporate IT|Human Resource Automation|SaaS|Social Media Marketing|Software,43300000.0,USA,3,15,1666,15022,16688,0
Curated Web,50000.0,SGP,1,2,0,14610,14610,0
Advertising|Cloud Computing|Marketing Automation|Optimization|Personalization|SaaS,14225000.0,USA,3,10,933,15279,16212,0
Cloud Management|Enterprise Software,16300000.0,USA,2,4,193,15033,15226,1
Finance,110700000.0,USA,3,6,1900,14512,16412,0
Advertising Platforms|Email,20600000.0,USA,4,15,4794,10680,15474,0
Software,3640000.0,USA,2,2,597,15747,16344,0
Mobile|Software|Video,1600000.0,USA,1,1,0,16643,16643,0
Games,138756.0,FRA,1,1,0,16139,16139,0
Hardware + Software,720801.0,USA,4,3,616,15636,16252,0
Health Care,500000.0,CAN,1,1,0,12081,12081,0
Energy|Gas|Manufacturing|Oil,18000000.0,USA,2,6,338,13710,14048,0
Software,1000000.0,USA,1,3,0,13788,13788,1
Manufacturing,3000000.0,USA,1,1,0,15554,15554,1
Application Performance Monitoring|Apps|Software,21900000.0,USA,3,5,1419,13562,14981,1
Semiconductors,1515251.0,GBR,1,1,0,16167,16167,0
Messaging,981000.0,GBR,1,1,0,13538,13538,0
Health and Wellness|Medical|Pharmaceuticals,63250000.0,USA,2,8,522,12006,12528,0
Elder Care|Health and Wellness,10100000.0,USA,2,5,350,16322,16672,0
Health Care,11556988.0,GBR,3,6,554,15810,16364,0
Advertising|Android|Computers|Facebook Applications|Games|iPad|Mac,14078664.0,USA,3,3,1360,13726,15086,0
Manufacturing|Wireless,13200000.0,USA,4,8,2291,13149,15440,0
Mobile,34726279.0,FRA,7,19,3457,12784,16241,0
Discounts|Flash Sales|Hospitality,120000.0,CHE,1,3,0,14456,14456,0
Curated Web,3474608.0,ITA,2,2,494,13568,14062,1
Enterprise Software,5285481.0,CHN,1,1,0,15949,15949,0
Automotive,1317010.0,GBR,3,6,328,15789,16117,0
Search,363000.0,NOR,1,1,0,13601,13601,0
Clean Technology|Energy Efficiency|Internet of Things|Smart Building,600000.0,USA,2,2,295,16120,16415,0
Curated Web|Legal|Real Time|Services|Trading,270100.0,ESP,1,1,0,13695,13695,0
Music|Software,2500000.0,FRA,1,2,0,15973,15973,0
Enterprise Software,20500000.0,USA,2,6,1088,12570,13658,0
Application Performance Monitoring|Designers|User Interface,41250.0,HKG,1,1,0,16648,16648,0
Manufacturing,2582545.0,GBR,2,3,98,16111,16209,0
Apps|Doctors|Health and Wellness,560000.0,IND,1,1,0,16108,16108,0
Hardware + Software|Restaurants|Tablets,52500000.0,USA,4,15,1545,14792,16337,0
Textiles,8425073.0,GBR,2,2,344,16211,16555,0
E-Commerce|Logistics,91713.0,JPN,3,2,322,11001,11323,0
Technology,124092.0,GRC,1,1,0,16415,16415,0
Human Resources|Internet|Recruiting,40000.0,CHL,1,1,0,15750,15750,0
E-Commerce,75000000.0,USA,2,6,3567,10592,14159,0
Software,18000000.0,USA,2,7,1226,11338,12564,1
Electronics|Information Technology|Security,122466.0,GBR,1,1,0,16251,16251,0
Web Development,2500000.0,USA,1,2,0,11611,11611,0
Clean Technology,130861.0,USA,1,1,0,14944,14944,0
Biotechnology,6570000.0,FRA,3,2,1903,14566,16469,0
News|Startups,1265000.0,SGP,2,6,894,15749,16643,0
Clean Technology|Manufacturing|Sustainability,3400000.0,USA,1,5,0,14632,14632,0
Cloud Computing|Web Hosting,176605.0,IND,3,4,1337,14549,15886,0
Health and Wellness,3500000.0,USA,1,1,0,15757,15757,0
E-Commerce,14000000.0,USA,1,4,0,12425,12425,0
Information Technology|Services|Systems,10000000.0,USA,1,2,0,11962,11962,1
Analytics|Intelligent Systems|Network Security|Security,9800000.0,USA,1,3,0,16504,16504,0
Online Shopping,30000000.0,RUS,1,1,0,16010,16010,0
Curated Web,94000.0,SGP,2,2,366,13879,14245,0
Agriculture,17000.0,TAN,1,1,0,16191,16191,0
Education,2606855.0,CHN,2,1,91,15796,15887,0
Android|Cloud Computing|iPad|iPhone|Mobile|Software|Technology|Web Development,3000000.0,USA,1,3,0,15344,15344,0
Education|Marketplaces|Software,132831.0,BRA,2,2,92,15918,16010,0
Curated Web|Semantic Search|Social Media,4400000.0,USA,3,17,544,15954,16498,0
Analytics|Big Data Analytics|Finance Technology|FinTech,6300000.0,IRL,4,1,613,16128,16741,0
Energy|Natural Resources|Oil,300000000.0,USA,1,1,0,16052,16052,0
Biotechnology,2136504.0,GBR,2,4,1,16030,16031,0
Games,1563274.0,GBR,1,1,0,15411,15411,0
Health Care,95000000.0,USA,1,1,0,12335,12335,1
Internet Radio Market|Music,630000.0,USA,3,7,807,15142,15949,1
Events|Music|Music Services|Music Venues,340000.0,USA,1,2,0,16191,16191,0
Art|Consumer Goods|Music|Services,459339.562574894,GBR,2,5,168,16358,16526,0
Financial Services,1500000.0,IND,1,1,0,16764,16764,0
Biotechnology,53000000.0,ISR,4,17,1726,14813,16539,0
Consumer Lending|Credit|Finance,299100000.0,USA,4,22,546,16210,16756,0
Analytics|Banking|Finance|Financial Services|Insurance|Price Comparison,10000000.0,ISR,2,3,1087,13039,14126,0
Clean Energy|Curated Web|Energy Efficiency|Incentives,4000000.0,USA,2,3,732,14276,15008,1
Clean Technology,28900008.0,USA,2,3,3231,12537,15768,0
Email|Messaging,28800000.0,USA,4,5,1004,13149,14153,0
Manufacturing,9000000.0,USA,1,1,0,12559,12559,0
Education,219358.0,GBR,1,1,0,16071,16071,0
Entertainment,17000000.0,USA,1,1,0,16378,16378,0
Colleges|Education|K-12 Education,40000.0,USA,2,1,162,15558,15720,0
Art|E-Commerce,245000.0,USA,2,2,236,16222,16458,0
Chat|iOS|Real Time,12500000.0,JPN,1,3,0,16645,16645,0
Semiconductors,139143676.0,USA,9,20,3393,12566,15959,0
Contact Management|Email|Events|Facebook Applications|iPhone|Mobile|Networking|Productivity Software|Search|Social Media,4300000.0,USA,1,2,0,15688,15688,0
Fashion,642077.0,GBR,2,2,254,15817,16071,0
Digital Media|Internet|Mobile,3902664.0,FIN,1,3,0,16415,16415,0
Games,3591900.0,JPN,1,1,0,13186,13186,0
Online Dating|Social Media,580000.0,USA,1,1,0,16234,16234,0
Automotive|Collaboration|CRM|Email|Lead Management|Project Management|Public Relations|Task Management|Tracking,100000.0,CAN,1,3,0,13818,13818,0
Consumer Electronics|Services,20000000.0,USA,1,1,0,16110,16110,0
Software,8362387.0,USA,3,2,636,15959,16595,0
Finance|Information Technology|Payments|Software,1800000.0,GIB,2,7,182,16343,16525,0
Distribution|E-Commerce|Logistics,120000.0,CHL,2,2,318,16222,16540,0
E-Commerce|Fashion|Retail|Social Network Media,1900000.0,ISR,3,5,455,15651,16106,0
Security,14200000.0,USA,2,2,1108,14745,15853,0
Cars|Consumers|Mobile|Public Transportation|SaaS|Taxis|Transportation,77000000.0,BRA,5,9,663,15614,16277,0
Travel,45943240.0,FRA,2,2,0,14518,14518,0
Freemium|Maps|Software,36000.0,ZAF,2,2,92,15645,15737,0
Collaboration|Collaborative Consumption|Curated Web|Logistics,850000.0,GBR,1,1,0,16657,16657,0
Application Platforms|Developer Tools|Software,56479.0,BGR,1,1,0,16467,16467,0
Bridging Online and Offline|Local Services|Marketplaces,485000.0,USA,2,3,1373,15340,16713,0
Curated Web|Employment|Hospitality|Human Resources|Marketplaces|Networking|Recruiting|Restaurants|Technology,40000.0,USA,1,1,0,15712,15712,0
Shipping,3450000.0,USA,3,28,487,15862,16349,0
Online Rental|Property Management|Real Estate|Rental Housing,10292726.0,GBR,3,4,549,15765,16314,0
Document Management|Enterprise Software,20118.0,LTU,1,1,0,15396,15396,0
Communities|Home & Garden|Internet|Services,40000.0,BRA,1,1,0,16222,16222,0
E-Commerce,12500.0,HKG,1,1,0,16648,16648,0
Accounting|Billing|CRM|Enterprise Software|SaaS,4786928.0,CHE,1,2,0,16489,16489,0
Apps|B2B Express Delivery|Delivery|Logistics|Transportation,20000000.0,HKG,2,7,247,16440,16687,0
Apps|Hospitality|Local|Mobile|Restaurants|Reviews and Recommendations|Wine And Spirits,40000.0,USA,1,1,0,15633,15633,0
Social Media,84751.0,KOR,1,1,0,15492,15492,0
E-Commerce|Hospitality,16500000.0,USA,3,16,1123,15126,16249,0
Apps|Mobile|Real Time,300000.0,BHR,1,1,0,16456,16456,0
Consumer Goods|Delivery,8000000.0,GBR,1,2,0,16756,16756,0
Delivery|Hospitality|Marketplaces,360000.0,PAK,1,4,0,15765,15765,1
Delivery|Hospitality|Local Services|Restaurants,27125000.0,USA,4,16,1277,15495,16772,0
Food Processing,350000.0,SGP,1,9,0,16587,16587,0
Curated Web|Travel,8000000.0,USA,2,2,261,16070,16331,0
Cannabis|Mobile Commerce,12500000.0,USA,2,6,160,16379,16539,0
E-Commerce,3000000.0,IND,1,5,0,16672,16672,0
Software,36000000.0,CHN,1,2,0,15741,15741,0
Cars|Service Providers|Services,5000000.0,CHN,1,1,0,16374,16374,0
All Markets|Auctions|Business Services|E-Commerce|Internet|Search,6700000.0,USA,1,1,0,10013,10013,1
Software|Web CMS,4550000.0,USA,1,1,0,13941,13941,0
E-Commerce,23000000.0,USA,2,6,712,13411,14123,0
Biotechnology|Health Diagnostics,55000000.0,USA,1,1,0,15016,15016,0
Software,40000.0,CHL,1,1,0,15379,15379,0
E-Commerce,1100000.0,ISR,1,1,0,14305,14305,0
Digital Media|Distribution|E-Commerce|Networking|Social Buying|Social Media|Social Media Marketing|Software,650000.0,USA,1,1,0,13879,13879,0
Automotive|Digital Media|E-Commerce|EdTech|Online Education|SaaS,350000.0,USA,1,4,0,15493,15493,0
E-Commerce|Home Decor|Kids|Wine And Spirits,2052410.0,ITA,3,4,886,15675,16561,0
Biotechnology|Medical,81000026.0,USA,4,15,3476,13057,16533,0
Software,2134000.0,USA,8,8,998,15401,16399,0
Curated Web,2500000.0,USA,1,1,0,14882,14882,0
Biotechnology,5563925.0,DEU,2,5,2043,14623,16666,0
Advertising,5500000.0,IND,1,1,0,13306,13306,0
Databases|Media|Messaging,15930093.2213407,USA,2,2,467,13447,13914,0
Enterprises|Enterprise Software|Information Technology|Outsourcing|Software,5626680.0,SWE,1,2,0,14482,14482,0
Analytics,43000000.0,USA,5,6,4123,12418,16541,0
Finance|FinTech,119241650.03901298,GBR,5,7,787,15970,16757,0
Freelancers|News,6500000.0,USA,2,1,338,14921,15259,1
Sports,2300000.0,AUS,2,1,1691,14610,16301,0
Enterprise Software,500000.0,USA,1,1,0,14488,14488,0
Health Care|Health Care Information Technology|Hospitals|mHealth|Senior Citizens|Software|Telecommunications,3500000.0,USA,1,2,0,16176,16176,0
Games|Music,76700000.0,USA,6,22,3528,11592,15120,0
Cloud Computing|Enterprise Software,7709323.0,USA,1,1,0,15401,15401,0
Algorithms|Clean Technology|FinTech|Information Services,20323.0,NLD,1,1,0,15991,15991,0
Biotechnology,2360000.0,USA,2,1,218,16491,16709,0
Biotechnology|Finance|Stock Exchanges,1500000.0,USA,1,1,0,15187,15187,0
Messaging,8000000.0,USA,1,1,0,14901,14901,0
Language Learning,100000.0,USA,1,1,0,16650,16650,0
Automotive,200000.0,USA,1,1,0,15883,15883,0
Consulting|Transportation,17400000.0,USA,1,1,0,13369,13369,1
Consumer Electronics|Fitness|Mobile Health,1500000.0,USA,1,3,0,16495,16495,0
Biotechnology,42914126.0,USA,9,1,1972,14454,16426,1
EdTech|Education,76552021.0,USA,6,2,1680,14706,16386,0
Social Media,980575.0,DEU,1,1,0,15765,15765,0
Consumer Electronics,15000000.0,USA,1,5,0,16423,16423,0
Clean Technology,13700000.0,USA,1,2,0,14880,14880,1
Energy,500000.0,USA,2,2,1033,13757,14790,0
Mobile,200000.0,USA,1,4,0,15713,15713,0
Environmental Innovation|Technology|Water,500000.0,CAN,1,1,0,14210,14210,0
Web Hosting,39985886.0,USA,6,9,2627,12241,14868,1
Biotechnology|Medical Devices,4099999.0,USA,2,2,130,15883,16013,0
Diagnostics|Manufacturing|Medical Devices,33000000.0,FRA,1,1,0,16555,16555,0
Curated Web|Legal,8500000.0,USA,2,2,730,13057,13787,1
Mobile,12500000.0,CHE,2,2,597,12965,13562,0
Web Hosting,222500000.0,ISR,3,5,2962,11657,14619,0
Supply Chain Management,2000000.0,USA,1,1,0,11187,11187,0
Local Businesses|Marketing Automation|Promotional,1800000.0,USA,2,2,358,15456,15814,0
Email Marketing|Software,87168000.0,DEU,1,1,0,14620,14620,1
Advertising|E-Commerce|Non Profit,264414.0,GBR,2,1,629,14101,14730,0
Health and Wellness,50000.0,USA,1,4,0,15967,15967,0
Clinical Trials|Software,2612595.0,GBR,1,3,0,16314,16314,0
Curated Web|Education|Internet Marketing|Social Media|Social Media Marketing|Video,565000.0,USA,3,1,607,16010,16617,0
Mobile,2000000.0,CHN,1,1,0,15796,15796,0
Analytics,6500000.0,USA,2,4,1421,11621,13042,0
Curated Web|Reputation,460000.0,USA,1,1,0,15953,15953,0
Clean Technology,15915862.0,GBR,2,4,203,13885,14088,0
Clean Technology,13335737.0,USA,5,1,1372,14182,15554,0
Clean Technology,4000000.0,USA,2,1,267,14126,14393,0
Clean Technology,5828444.0,USA,6,6,895,15261,16156,0
Mobile,20850000.0,USA,2,1,402,15649,16051,0
Clean Technology,2000000.0,ISR,1,1,0,16665,16665,0
Clean Technology,6500000.0,USA,1,1,0,14036,14036,0
Clean Technology,71400000.0,USA,4,9,1085,14657,15742,1
Financial Services,285000000.0,TGO,1,1,0,16702,16702,0
Consumer Electronics|Internet of Things,16149048.0,CAN,3,10,2039,13514,15553,0
Auctions|Recycling|Waste Management,88049.0,COL,2,2,304,15918,16222,0
Manufacturing,14250000.0,ITA,1,1,0,15198,15198,0
Energy Efficiency|Energy Management|Enterprise Software,27394996.0,USA,4,8,1287,14705,15992,0
Energy|Energy Management|Smart Building,40859.0,POL,1,1,0,16223,16223,0
Hardware + Software,1600000.0,IND,1,2,0,15852,15852,0
Clean Technology,4864293.0,USA,3,1,984,15695,16679,0
Manufacturing,7000000.0,USA,1,2,0,16189,16189,0
Clean Technology,805833.0,GBR,1,1,0,15455,15455,0
E-Commerce|Logistics,149500000.0,IND,2,2,268,16322,16590,0
E-Commerce|Retail|Shipping|Supply Chain Management,2400000.0,USA,2,2,0,16489,16489,0
Carbon|Clean Technology|Environmental Innovation|Geospatial|Maps|Software|Supply Chain Management|Sustainability,391655.0,GBR,1,1,0,15414,15414,0
Software,51410000.0,GBR,3,9,1616,14508,16124,0
E-Commerce|Green|Organic,10700000.0,USA,4,59,689,14877,15566,1
Clean Technology,58750000.0,USA,4,7,2842,13889,16731,0
Internet of Things|M2M|Software|Wireless,3272000.0,USA,6,7,1127,15156,16283,0
Manufacturing,9466686.0,GBR,2,4,666,15391,16057,0
B2B|Big Data|Information Services|SaaS|Sales and Marketing,132562.0,BRA,2,2,61,15918,15979,0
Clean Technology,653200.0,ITA,1,1,0,14966,14966,0
Logistics,41250.0,HKG,1,1,0,16405,16405,0
Software,15800000.0,USA,1,3,0,12026,12026,0
Clean Technology,29000000.0,USA,1,1,0,14019,14019,0
Energy,40000000.0,USA,1,1,0,13894,13894,0
Clean Technology,56788185.0,USA,5,1,1415,15005,16420,0
Clean Technology,15021489.0,USA,4,7,1697,14040,15737,0
Clean Technology|Water,10000000.0,USA,1,1,0,14447,14447,0
Health and Wellness|Healthcare Services|Manufacturing|Medical Devices,540000.0,USA,5,8,748,15492,16240,0
Clean Technology,40000.0,CHL,1,1,0,15671,15671,0
Clean Technology|Environmental Innovation|Water Purification,1345291.0,BRA,1,1,0,15979,15979,0
Clean Technology,18789048.0,USA,3,10,2134,12488,14622,0
Clean Technology,130300000.0,USA,4,2,956,14457,15413,0
Environmental Innovation,837000.0,USA,2,3,651,15796,16447,0
Architecture|Design|Designers,4000000.0,USA,1,2,0,13647,13647,0
Algorithms|Curated Web|Postal and Courier Services,15071350.0,GBR,4,5,1447,12310,13757,1
Clean Technology|Sustainability,14000000.0,USA,2,3,899,15118,16017,0
Building Products|Clean Energy|Clean Technology|Communications Hardware|Consumer Electronics|Consumer Goods|Embedded Hardware and Software|Energy Efficiency|Green Building|Green Consumer Goods|GreenTech|Hardware|Hardware + Software|Home Automation|Internet of Things|Machine Learning|Smart Building|Startups,9705000.0,USA,3,6,457,16160,16617,0
Energy Management|Environmental Innovation|Sustainability,20000.0,USA,1,1,0,15949,15949,0
Manufacturing|Renewable Energies|Solar,5959015.0,GBR,1,1,0,16308,16308,0
Agriculture|Clean Technology|Energy|Social Entrepreneurship,1000000.0,IND,2,2,481,16051,16532,0
Automotive|Browser Extensions|CRM|Enterprise Software|Google Apps|Web Browsers,590000.0,CAN,5,4,1230,13971,15201,0
Enterprise Software,8198403.0,GBR,2,1,824,15582,16406,0
Credit|Risk Management,32000000.0,USA,2,15,1643,10927,12570,1
Software,27000000.0,USA,2,11,778,12997,13775,0
Web Development,20000000.0,USA,1,5,0,11185,11185,0
Real Time|Solar|Waste Management,937054.0,KOR,2,2,92,15583,15675,0
Heavy Industry|Manufacturing,45299500.0,USA,3,1,1031,15167,16198,0
Energy Efficiency|Telecommunications|Utilities,3300000.0,USA,2,2,296,15949,16245,0
Analytics|Hardware + Software|Training,1550000.0,ESP,1,1,0,13102,13102,0
E-Commerce,6500000.0,USA,2,3,895,15323,16218,0
Celebrity|Collaboration|Design|E-Commerce|Fashion|Retail,565000.0,USA,1,7,0,15095,15095,0
Fashion,2850000.0,IND,3,4,523,15431,15954,0
Financial Services,10000000.0,CHN,1,1,0,16220,16220,0
Software|Technology,100000000.0,CHN,1,3,0,16561,16561,0
China Internet|Internet|Services,123200000.0,CHN,3,7,382,16273,16655,0
Health and Wellness|Nutrition|Search|Semantic Web,1900000.0,USA,2,6,757,15706,16463,0
Manufacturing,14557833.0,CHN,2,5,365,14214,14579,0
Education,15690376.0,CHN,1,1,0,15309,15309,0
Internet,112000.0,USA,1,1,0,16384,16384,0
Nonprofits,19600000.0,USA,2,2,1100,14886,15986,0
EdTech|Education,800000.0,USA,1,3,0,15946,15946,0
Education|Non Profit|Professional Services,2000000.0,USA,1,1,0,16664,16664,0
All Students|EdTech|Education|Portals,6000000.0,USA,1,9,0,16335,16335,0
Biotechnology,24000000.0,HKG,1,3,0,14869,14869,0
Marketplaces|Software,2100000.0,CAN,1,1,0,12025,12025,0
Advertising,950000.0,USA,3,3,762,14975,15737,1
Consumers|Services|Tech Field Support,3300000.0,USA,2,18,56,16630,16686,0
Charities|Education|Enterprises,2432103.0,USA,1,1,0,16344,16344,0
Environmental Innovation|Green|Sustainability,1000000.0,ISR,1,1,0,16441,16441,0
Software,1100000.0,ISR,1,2,0,13180,13180,0
Social Media|Web Development,329250.0,IRL,1,3,0,13514,13514,0
Consulting,1890000.0,GBR,1,1,0,12906,12906,0
E-Commerce|Fashion|Social Buying|Social Media|Social Network Media,114298.0,ESP,2,3,152,15340,15492,0
Biotechnology,111670000.0,USA,7,34,2465,13990,16455,0
Agriculture|Clean Technology,875000.0,USA,1,2,0,16566,16566,0
Manufacturing|Software|Video,1234208.0,GBR,1,1,0,16102,16102,0
Education,300000.0,USA,3,4,183,15796,15979,0
Clean Technology,200000000.0,USA,1,1,0,15715,15715,0
Content Creators|Marketplaces|Public Relations|Small and Medium Businesses,69049.0,SVN,2,5,184,16076,16260,0
Digital Media|Finance,14000000.0,USA,3,3,4353,10430,14783,0
Software,23502.0,GBR,1,1,0,15309,15309,0
Health Care Information Technology|Medical Devices,18000000.0,ISR,1,3,0,13130,13130,0
Biotechnology,101472500.0,USA,7,8,1613,14921,16534,1
Content|Content Delivery|Web Hosting,74000000.0,USA,5,8,2543,13361,15904,1
Content|Infrastructure|Web Hosting,14008001.0,USA,4,5,1200,14768,15968,0
Apps|Energy|Oil,350432.0,DNK,2,2,1515,14880,16395,0
E-Commerce|Marketplaces,6500000.0,USA,2,8,546,13149,13695,0
Biotechnology,4845795.0,USA,2,1,1604,14952,16556,0
Analytics|Big Data|Business Intelligence,12700000.0,USA,2,3,1051,14791,15842,1
Hardware + Software,11780000.0,SWE,3,5,1146,13174,14320,0
Software,21445695.0,USA,6,4,1594,14827,16421,0
Enterprises|Internet|Social Media,161081.0,USA,2,2,779,15768,16547,0
Information Technology|Security|Services,2006760.0,FRA,1,1,0,16020,16020,0
Biotechnology,10000000.0,USA,1,1,0,16268,16268,0
Photo Editing|Public Relations|Web Design|Web Development|Web Hosting,100000.0,EST,1,2,0,13910,13910,0
Apps|Music Education,118000.0,USA,1,1,0,16600,16600,0
SaaS|Services|Technology,150000.0,USA,1,1,0,16344,16344,0
Biotechnology,18000000.0,USA,1,1,0,15916,15916,0
Photography,6061005.0,GBR,1,2,0,16110,16110,0
Hardware + Software,587000.0,GBR,2,4,457,13180,13637,0
Clean Technology,1454259.0,USA,3,2,315,16072,16387,0
Biotechnology,84378582.0,USA,7,2,2460,13696,16156,0
Hospitality,102000000.0,EGY,1,1,0,15880,15880,0
Biotechnology|Health Care,210000000.0,USA,3,20,623,16034,16657,0
Analytics|Big Data|Fashion,6000000.0,GBR,3,5,1244,14868,16112,0
Collaboration|Curated Web|File Sharing|Office Space|Publishing,1250000.0,HKG,2,1,525,13149,13674,0
Apps|Brand Marketing|Content Creators|Content Delivery|Media|Publishing|SaaS|Software,1200000.0,GBR,1,1,0,16436,16436,0
Software,600000.0,GBR,1,1,0,13750,13750,0
Curated Web|Marketplaces,257000.0,USA,2,2,222,16165,16387,0
Software,200000.0,HUN,1,1,0,15989,15989,0
All Students|EdTech|Education|MicroBlogging|Social Media|Teachers|Technology,87500000.0,USA,5,24,1339,14949,16288,0
Advertising|Discounts|Mobile|Payments,93500100.0,USA,11,20,3061,13514,16575,0
Education|Social Network Media,200000.0,USA,3,3,550,15400,15950,0
Software,5067737.0,USA,2,1,455,14998,15453,0
Software,2000000.0,IND,1,2,0,15854,15854,0
Education,2058302.74466754,USA,1,2,0,16566,16566,0
EdTech|Education,964000.0,IND,1,1,0,13965,13965,0
Digital Media|Kids,50000.0,IND,2,5,722,15886,16608,0
Curated Web|EdTech|Education|Email Newsletters|K-12 Education|Market Research|Reviews and Recommendations|Search,2860000.0,USA,3,15,639,15581,16220,0
Education|Online Reservations|Travel,4100000.0,USA,4,4,785,15706,16491,0
Education,210155.0,IND,1,1,0,16664,16664,0
E-Commerce|Education|Marketplaces,166695.975247525,ARG,3,3,303,15584,15887,0
EdTech|Education,18000.0,USA,1,1,0,15857,15857,0
Education|Parenting|Publishing,40010000.0,USA,6,7,2253,13361,15614,0
EdTech|Education,8100000.0,USA,2,5,399,15006,15405,0
Education,18000.0,USA,1,1,0,16467,16467,0
Nonprofits,29000000.0,USA,2,2,716,16043,16759,0
E-Commerce|Education|Startups,3050000.0,USA,2,16,822,15708,16530,0
Education|Social Network Media,600000.0,USA,1,1,0,15613,15613,0
Education|iPad|Mobile,2200000.0,USA,2,3,326,15240,15566,0
EdTech|Education|Private Social Networking|SaaS|Sports,1570000.0,USA,2,6,861,15461,16322,0
Education|Teachers,1700000.0,USA,2,2,517,13978,14495,1
EdTech|Education,10000000.0,BRA,1,3,0,16567,16567,0
Education|Marketplaces,2000000.0,IND,3,5,1544,15065,16609,0
Mobile,128660.0,POL,1,1,0,15854,15854,0
Career Management|Education,20385.0,RUS,1,1,0,16040,16040,0
Colleges|Corporate Training|EdTech|Education|K-12 Education,530000.0,USA,1,1,0,15999,15999,0
Corporate Training|Education,1500000.0,IND,1,1,0,16168,16168,0
Education,40000.0,CHL,1,1,0,15772,15772,0
EdTech|Education,40000.0,CHL,1,1,0,15659,15659,0
All Students|Analytics|Big Data|Education|K-12 Education,126615.0,USA,2,2,67,16292,16359,0
EdTech|Education,1000000.0,ISR,1,3,0,11719,11719,1
Corporate Training|Education|Enterprise Software|SaaS,1000000.0,USA,1,1,0,15806,15806,0
Colleges|Enterprise Software,1025000.0,USA,3,3,1027,15492,16519,0
Education,250000.0,POL,3,3,884,14853,15737,0
EdTech|Education,400000.0,IND,1,1,0,15425,15425,0
Advertising,1040000.0,USA,1,1,0,13710,13710,0
Software,2630000.0,FRA,1,2,0,12916,12916,0
Agriculture|Hardware + Software|Organic Food,970000.0,USA,3,8,663,16085,16748,0
Craft Beer|E-Commerce|Marketplaces|Wine And Spirits,648709.0,GBR,5,4,821,15706,16527,0
Games|Social Media,200000.0,USA,1,1,0,14716,14716,0
Photography,225000.0,USA,1,1,0,13454,13454,0
Apps|Software|Technology,4300000.0,GBR,1,1,0,15538,15538,0
Events|Photography|Social Media|Social Network Media|Video,2097100.0,USA,3,6,372,14809,15181,0
Consumer Electronics|Internet|Internet of Things|Wireless,40000000.0,USA,2,9,273,16469,16742,0
Curated Web|Event Management|Events,350000.0,USA,2,1,499,14909,15408,0
Security,24000000.0,MYS,2,3,548,12022,12570,1
Curated Web,20400000.0,USA,2,4,1379,13339,14718,0
Delivery|Optical Communications|Startups|Telecommunications,250000.0,USA,1,1,0,14761,14761,0
Advertising,4000000.0,AUS,1,1,0,14657,14657,0
Biotechnology,45000000.0,USA,1,7,0,15845,15845,0
Biotechnology,7884325.0,USA,2,3,1785,12528,14313,0
Analytics|Big Data|Energy Management,600000.0,USA,1,3,0,15364,15364,0
Clean Technology,4125000.0,USA,2,3,1141,15141,16282,0
Advertising,6000000.0,USA,1,3,0,13391,13391,1
Real Estate,5332740.0,FRA,1,2,0,14860,14860,0
Software,602000.0,SWE,1,3,0,13264,13264,0
Accounting|Electronics|Software,26048093.0,USA,3,4,2525,14070,16595,0
Farming|Manufacturing|Technology,1200000.0,IDN,2,2,290,16396,16686,0
Clean Technology,40000.0,CHL,1,1,0,15336,15336,0
Entertainment|Entertainment Industry|Video on Demand,200000.0,USA,1,1,0,15196,15196,0
Enterprise Software,649000.0,GBR,1,1,0,14026,14026,0
Enterprise Software,6000000.0,BEL,1,3,0,16609,16609,0
Curated Web,295000.0,USA,3,3,608,15225,15833,0
Automotive,4002098.0,DEU,1,1,0,14975,14975,0
Services|Technology|Video,24150000.0,USA,11,21,2753,11673,14426,1
Biotechnology|Health Care,27600000.0,DNK,3,10,2507,13605,16112,1
Cloud Management|Design|Enterprise Software|Software,118000000.0,JPN,5,12,4361,11866,16227,0
E-Commerce,1000000.0,USA,2,5,300,14853,15153,0
Advertising|App Marketing|Internet Marketing|Mobile Advertising|Video,880000.0,USA,1,1,0,14619,14619,0
Consulting,2500000.0,USA,1,1,0,14446,14446,0
E-Commerce|Mobile Commerce|Social Commerce|Social Media|Social Network Media|Software,12485633.0,USA,8,11,1575,15016,16591,0
Enterprises|Enterprise Software,8864292.0,USA,2,1,911,13906,14817,1
Software,27000000.0,GBR,3,8,652,13331,13983,1
Cloud Computing|Collaboration|Enterprise Software|File Sharing|iPhone|Mobile|Small and Medium Businesses|Storage,62500000.0,USA,5,14,2536,13514,16050,0
Browser Extensions|Search,21189.0,AUT,2,2,241,15222,15463,0
E-Commerce,40000.0,FRA,1,1,0,15538,15538,0
Mobile|Productivity Software|Sensors,2100000.0,USA,3,23,1193,15261,16454,0
Apps|Business Services|Charity|Curated Web|iPad|Loyalty Programs|Nonprofits|Online Reservations|Payments,3000000.0,USA,1,1,0,15952,15952,0
Cloud Data Services|File Sharing|Security,3333553.0,GBR,1,1,0,16135,16135,0
Software,20500000.0,USA,1,4,0,13206,13206,0
Manufacturing,8100000.0,CAN,2,2,1325,14376,15701,0
Fitness,15000000.0,DEU,1,3,0,16272,16272,0
Drones,52000000.0,USA,2,11,237,16434,16671,0
Curated Web,113000000.0,USA,2,5,1614,11109,12723,0
Health and Wellness,40000.0,CHL,1,1,0,15495,15495,0
Enterprise Software|Health and Wellness,8595974.0,USA,4,3,1112,14617,15729,0
Health and Wellness|Health Care,10176.0,GBR,1,1,0,14245,14245,0
E-Commerce,420000000.0,CHN,5,13,2642,13939,16581,1
Curated Web|Search,1000000.0,TUR,1,1,0,15792,15792,0
Health Care,3500000.0,USA,1,3,0,11533,11533,0
Enterprise Software,52792.0,GBR,1,1,0,15826,15826,0
Curated Web,4018200.0,TUR,2,2,1069,14245,15314,0
Search,19713.0,NLD,1,1,0,15434,15434,0
Biotechnology,23040630.0,USA,4,4,2462,14300,16762,1
Game,2400000.0,KOR,1,2,0,16450,16450,0
Semiconductors,7032007.0,GBR,1,2,0,14870,14870,0
Advertising,19862991.0,USA,6,19,2163,14035,16198,0
Hardware + Software,68800000.0,USA,3,10,3447,10347,13794,1
Hardware + Software,49600000.0,USA,2,2,182,13787,13969,1
Clean Technology,14000000.0,USA,2,1,256,14487,14743,0
Enterprise Software,16499999.0,USA,5,1,2253,14265,16518,0
Biotechnology,180000.0,IRL,1,1,0,12879,12879,0
Innovation Management|Intelligent Systems|Retail Technology,7000000.0,USA,1,1,0,11631,11631,0
Music,1840000.0,USA,2,3,974,13058,14032,0
Games,26220000.0,CHN,2,2,19,15918,15937,0
Analytics|Logistics|Software|Storage|Supply Chain Management|Trading,16000000.0,IND,3,3,3209,12784,15993,0
Clean Technology,52500000.0,USA,3,6,912,13149,14061,1
Software,22000000.0,USA,2,1,2467,13452,15919,0
Internet,127800.0,ZAF,2,13,257,16330,16587,0
Analytics|Big Data|Cloud Computing|Social Media|Visualization,1250000.0,USA,2,2,223,16344,16567,0
Medical,300000.0,IND,1,2,0,16451,16451,0
Hardware + Software,49463731.0,FRA,6,22,3653,12143,15796,1
Messaging|Mobile Social,6700000.0,USA,2,4,504,16169,16673,0
Health Care|mHealth|Mobile|Mobile Health,2800000.0,USA,3,5,540,15966,16506,0
Finance|FinTech,5500000.0,IND,1,2,0,15166,15166,0
Agriculture|Chemicals|Design|Energy Efficiency,14583776.0,NLD,1,4,0,15770,15770,0
Health Care,49000000.0,USA,3,13,1133,12832,13965,1
Biotechnology,13000000.0,USA,1,5,0,13740,13740,1
Enterprise Software,4500000.0,USA,2,2,302,15868,16170,0
Design|Digital Media|Graphics|Networking,75000.0,VEN,1,3,0,16322,16322,0
Games,40000.0,USA,1,1,0,15140,15140,0
Entertainment,400000.0,CHL,1,1,0,16314,16314,0
Hardware + Software,5000000.0,TWN,1,1,0,15344,15344,0
Career Management|Curated Web|Employment|Freelancers|Human Resources|Outsourcing,94800000.0,USA,5,14,4375,10988,15363,0
Mobile,40000.0,ARG,1,1,0,16052,16052,0
Software,5500000.0,USA,1,3,0,14028,14028,0
Biotechnology,2000000.0,USA,1,1,0,15908,15908,0
Cloud Computing|E-Commerce|PaaS|SaaS|Software,350000.0,GBR,1,1,0,16217,16217,0
Enterprise Software,3400000.0,USA,1,2,0,14944,14944,1
Developer APIs|Digital Media|E-Commerce|Software,21817790.9809172,CAN,4,6,829,15908,16737,0
Cloud Security|SaaS|Software|Technology,36300000.0,USA,2,5,386,16119,16505,1
Cloud Computing|Enterprise Software,13600000.0,USA,3,9,692,15470,16162,0
Blogging Platforms|Cloud Computing|PaaS|Web Hosting,262934.0,ITA,3,1,363,15745,16108,0
Internet|Mobile|Real Time|Social Media,110000.0,ISR,1,1,0,16709,16709,0
Cloud Computing|Open Source|Real Time|Search|Software,104000000.0,USA,3,9,574,15652,16226,0
Software|Storage,8000000.0,ISR,1,2,0,16084,16084,0
Hardware + Software,425130.0,USA,2,1,469,13994,14463,1
Enterprise Software,14449995.0,USA,2,4,356,13740,14096,0
Software,1604597.0,USA,3,3,201,16192,16393,0
Consumers|Lifestyle|Media|News,150000.0,USA,2,1,77,16528,16605,0
Biotechnology,96845109.0,USA,6,13,2024,14685,16709,0
Consulting,6444500.0,ITA,1,1,0,15337,15337,0
Apps|Art|Education|Kids|Messaging|Mobile Games|Parenting|Senior Citizens,90000.0,GBR,1,1,0,16594,16594,0
E-Commerce,1800000.0,USA,1,1,0,11250,11250,0
B2B Express Delivery|E-Commerce,1085000000.0,CHN,6,16,1700,14975,16675,0
Software,2000000.0,RUS,1,1,0,13426,13426,0
Clean Technology,8000000.0,USA,2,1,355,14194,14549,0
Software,45842999.0,GBR,7,19,4014,12611,16625,0
Entertainment|Film Production|Media|TV Production,50000000.0,USA,1,1,0,16209,16209,0
Home Automation|Internet of Things,23000000.0,USA,2,6,819,15476,16295,0
Electronics,6699994.0,USA,2,14,496,16190,16686,0
Clean Technology,3000000.0,USA,1,1,0,14103,14103,0
Electronics|Energy|Manufacturing|Storage,6695083.57695999,ITA,1,1,0,13683,13683,0
Clean Technology,250000.0,DEU,2,5,1193,15187,16380,0
Health Care,50500000.0,USA,2,3,581,15670,16251,0
Apps|Cloud Computing|Databases|Enterprises|Software,250000.0,USA,1,1,0,14586,14586,0
Software,40000000.0,USA,1,1,0,16590,16590,0
Hardware + Software,11000000.0,IND,2,2,113,15943,16056,0
Electronic Health Records|Enterprise Software|Health Care|Medical|SaaS|Software,520000.0,USA,2,4,194,15777,15971,0
Software,300000.0,GBR,1,1,0,16226,16226,0
Electronics|Security,21500000.0,USA,1,1,0,16566,16566,0
Batteries|Fuel Cells|Marketplaces,170000.0,USA,1,4,0,16595,16595,0
Software,10000000.0,USA,1,1,0,12093,12093,0
Manufacturing,50000.0,USA,1,1,0,15366,15366,0
Curated Web,14750000.0,USA,2,3,529,13867,14396,0
Electronics|Energy Efficiency|Solar,40000.0,CHL,1,1,0,16222,16222,0
Security,11000000.0,USA,1,4,0,12954,12954,0
Design|Manufacturing|Mechanical Solutions,300000.0,USA,1,1,0,15706,15706,0
Enterprises|Enterprise Software|Video,45650000.0,USA,5,17,2578,13848,16426,1
Enterprise Software|Logistics|Mobile|Risk Management|Software|Supply Chain Management,67000000.0,USA,2,9,491,15614,16105,0
Consulting,5000000.0,KEN,1,2,0,15728,15728,0
Health Care,27329746.0,USA,2,3,881,15013,15894,0
Apps|Photo Editing|Software,25000.0,USA,2,2,1266,15303,16569,0
Brand Marketing|Consumers|Curated Web|Lifestyle|Media|Retail|Shopping|Social Media,4500000.0,SGP,1,1,0,16065,16065,0
Android|Apps|Crowdsourcing|Email|iPhone|Mobile Emergency&Health|Software,450000.0,USA,2,1,243,14791,15034,0
EdTech|Education,10000000.0,USA,1,1,0,14658,14658,0
E-Commerce|Fmcg|Retail|Retail Technology,2450000.0,GBR,3,3,462,16191,16653,0
Clean Technology,294000000.0,USA,4,7,1567,13964,15531,0
Financial Services,70000000.0,USA,1,1,0,16706,16706,0
Software,12150000.0,USA,5,5,891,15490,16381,0
Apps,7700000.0,USA,2,2,513,15042,15555,0
Software,500000.0,USA,1,4,0,16273,16273,0
Biotechnology,89400001.0,USA,4,13,713,14630,15343,1
Public Relations,20000000.0,USA,1,1,0,15197,15197,0
Biotechnology|Health Care,75000000.0,USA,3,5,1722,14677,16399,1
Hardware + Software,8123791.0,USA,2,7,658,16042,16700,0
Consumers|Dietary Supplements|Health and Wellness,130000.0,USA,2,3,579,16101,16680,0
Consulting,14400000.0,USA,1,1,0,15106,15106,0
Search|Technology,2025000.0,USA,3,13,977,15208,16185,0
Developer APIs|Health and Wellness|Payments,2550000.0,USA,1,12,0,16449,16449,0
Biotechnology,2209342.0,FRA,1,1,0,16625,16625,0
Media|News|Peer-to-Peer|Social Media,1500000.0,USA,1,4,0,16235,16235,1
Sports,1000000.0,USA,1,1,0,15614,15614,0
Education,24000000.0,CHN,1,1,0,14518,14518,0
Biotechnology,2005038.0,USA,3,1,1768,14407,16175,1
Software,10300000.0,IND,1,1,0,13683,13683,1
Consumers|Games|Nutrition|Specialty Foods,900620.0,IRL,1,1,0,16115,16115,0
Semiconductors,25000000.0,GBR,2,8,638,12241,12879,0
Health Care,5299700.0,USA,1,1,0,12860,12860,0
Biotechnology|Diabetes|Pharmaceuticals,58000000.0,USA,2,12,910,13481,14391,0
Technology,7000000.0,USA,1,1,0,12614,12614,0
Health and Wellness,105769230.0,USA,1,1,0,15154,15154,0
Web Hosting,51500000.0,USA,3,14,1998,11631,13629,0
Software,5850000.0,USA,3,22,522,15738,16260,0
E-Commerce,2000000.0,USA,1,4,0,15737,15737,0
Hardware + Software,32407715.0,USA,4,4,1998,14617,16615,0
Automotive,10822832.0,DEU,1,2,0,12459,12459,0
Bitcoin|Finance|Virtual Currency,2000000.0,GBR,2,3,156,16111,16267,0
Security,5710000.0,CAN,2,5,2939,13082,16021,0
Networking|Social Media,10935000.0,USA,3,7,440,16087,16527,0
Beauty|Health Care|Personal Health,1200000.0,ISR,1,1,0,15979,15979,0
Education,41347.0,GBR,1,1,0,16071,16071,0
Blogging Platforms|Content Creators|Curated Web|Education|Media|News|Online Education|Social News,100000.0,ARG,2,3,608,15706,16314,0
Diagnostics,28000000.0,ISR,1,6,0,16755,16755,0
Electrical Distribution|Energy|Manufacturing|Service Providers,16393442.0,BRA,1,1,0,15321,15321,0
E-Commerce,11000000.0,BRA,3,3,1091,15258,16349,0
Design|E-Commerce|E-Commerce Platforms|Fashion|Textiles,42446.9665578542,SWE,1,1,0,16698,16698,0
Transportation|Travel,15000000.0,CHN,1,2,0,12293,12293,1
Semiconductors,13500000.0,GBR,2,3,936,13922,14858,0
B2B|Enterprise Software|Marketing Automation|Sales and Marketing,35800000.0,USA,2,5,395,13392,13787,1
Health Care|Hospitals,1686275.0,USA,2,1,749,15796,16545,0
Designers|Fashion|Retail,6000000.0,USA,2,6,610,15796,16406,0
Finance|FinTech|SaaS,54587.5365736495,GRC,1,1,0,16532,16532,0
Electronics|Health and Wellness|Medical Devices,25000.0,USA,1,1,0,16040,16040,0
Manufacturing,100000000.0,JPN,1,1,0,12206,12206,1
Biotechnology,2702490.0,FRA,1,2,0,15842,15842,0
Finance Technology|FinTech|Hedge Funds|Investment Management,500000.0,USA,1,3,0,16449,16449,0
Information Technology|Software|Virtualization,2100000.0,RUS,2,2,460,15490,15950,0
Nonprofits,250000.0,USA,1,1,0,16113,16113,0
Event Management,100000.0,EGY,1,1,0,16375,16375,0
Advertising|Business Intelligence|Market Research,2052167.0,USA,2,1,841,14368,15209,0
Fraud Detection|Real Time|Software,3800000.0,USA,1,8,0,16492,16492,0
Advertising,10000000.0,CHN,1,3,0,13930,13930,0
Advertising|Business Intelligence|E-Commerce|Market Research|Media|Mobile|Social Media,25000000.0,USA,1,1,0,15350,15350,0
Auctions|E-Commerce|Marketing Automation,33000000.0,AUT,1,1,0,16693,16693,0
Consulting|CRM|Databases|Data Integration|Email Marketing|Marketing Automation|SaaS,1275000.0,SGP,2,3,1059,15712,16771,0
Design|Internet|Presentations|Software|Technology,2800000.0,ISR,2,2,532,15845,16377,0
Curated Web|Local|Social Commerce|Social Media,225000.0,USA,1,2,0,15720,15720,0
Public Transportation,1000000.0,USA,2,10,293,15364,15657,1
Big Data|Business Analytics|Email|Predictive Analytics,1500000.0,USA,3,6,939,15614,16553,0
Curated Web,1020000.0,USA,4,11,811,14610,15421,0
Software,36640000.0,CHN,1,2,0,14248,14248,0
E-Commerce,40000.0,CHL,1,1,0,15790,15790,0
Facebook Applications|Gift Card|Mobile,280000.0,USA,2,3,73,14902,14975,0
Mobile|Real Time|Video,121000000.0,USA,5,19,3087,11540,14627,1
Biotechnology,34000000.0,USA,1,1,0,15323,15323,0
Biotechnology,6990000.0,USA,4,4,1857,14678,16535,0
Education|Tutoring,4000000.0,IND,1,2,0,16195,16195,0
Health Care|Medical Devices|Physicians,3753730.0,IRL,1,4,0,16349,16349,0
Software|Virtualization,12400000.0,CAN,3,4,2017,13486,15503,0
Insurance|Personal Finance|Pets|Price Comparison,5300000.0,USA,5,4,2925,13270,16195,0
Software,32000000.0,USA,2,7,943,15211,16154,1
Health Care,6700000.0,USA,2,2,87,14431,14518,0
Data Security|Identity|Privacy|Security|Trusted Networks,450000.0,POL,2,5,1273,14383,15656,0
Big Data Analytics|Energy Efficiency|Hardware + Software|Sensors,1750000.0,USA,4,3,1407,14572,15979,0
Enterprise Software,40000.0,CHL,1,1,0,16051,16051,0
Agriculture,6200000.0,USA,1,2,0,12081,12081,0
Technology,1500000.0,USA,1,2,0,16420,16420,0
Software,1450000.0,USA,3,2,412,15098,15510,0
Games,49450000.0,USA,5,16,2089,12499,14588,1
Games,50000.0,USA,1,1,0,15918,15918,0
Games|Monetization|Virtual Goods,43100000.0,USA,5,9,2039,13848,15887,0
Consulting,10040000.0,IND,1,1,0,13975,13975,0
Startups|Technology|Virtual Worlds,2200000.0,USA,1,3,0,16723,16723,0
Fitness|Hardware + Software|Personal Health|Technology|Wearables,277900.0,USA,2,2,0,14610,14610,0
Software,194000.0,CAN,1,1,0,14881,14881,0
Security,2400000.0,USA,3,2,554,15665,16219,1
Investment Management,30000.0,AUT,1,1,0,16127,16127,0
Travel,15800000.0,USA,1,1,0,15140,15140,0
Biotechnology,30000000.0,USA,2,2,1687,14992,16679,0
Clean Technology,71900834.0,USA,6,9,2340,12458,14798,1
Networking,7500000.0,USA,1,3,0,12524,12524,0
Software,12500000.0,USA,2,5,847,12557,13404,0
Software,13300000.0,USA,1,2,0,16045,16045,0
Software,5000000.0,USA,2,6,798,13361,14159,0
Advice|Consulting|Marketplaces|Publishing,2000000.0,USA,1,8,0,16050,16050,0
Clean Technology|Environmental Innovation|GreenTech,40000.0,CHL,1,1,0,16222,16222,0
Health Care,2982624.0,USA,2,1,467,14680,15147,0
Design|Email|Email Marketing|Email Newsletters|Information Technology|Internet|Marketing Automation|Social Media Marketing|Surveys,5000000.0,USA,1,2,0,16624,16624,0
Clean Technology,5600000.0,USA,2,3,148,15476,15624,0
Computers|Cyber Security|Information Technology|Software,2000000.0,USA,1,1,0,14895,14895,0
Enterprise Software|Mobile Commerce|Mobile Payments,100300177.0,USA,10,5,3596,12286,15882,0
Health and Wellness|Health Care Information Technology|Mobile Health,150000.0,USA,2,2,194,16080,16274,0
B2B|Fashion|Marketplaces|Wholesale,250000.0,BRA,1,6,0,16222,16222,0
Software,1000000.0,ISR,1,1,0,11313,11313,0
E-Commerce|Internet|Real Estate|Rental Housing,5731436.51194541,GBR,3,4,378,16331,16709,0
Education,133087.686518478,GBR,1,2,0,15540,15540,0
Education,90100000.0,USA,12,4,778,15929,16707,0
Software,1100000.0,FRA,1,1,0,12871,12871,0
Business Intelligence|Enterprise Software,490512.0,USA,6,5,1184,15279,16463,0
Games,7994814.0,GBR,1,1,0,13773,13773,0
Apps|Messaging|Services,1200000.0,GBR,1,4,0,16741,16741,0
Software,6000000.0,USA,1,2,0,16135,16135,0
Curated Web|Semantic Web|Social Media,57312.0,TUR,1,1,0,14245,14245,0
Software,2500000.0,USA,1,5,0,12234,12234,1
Marketplaces|Subscription Businesses|Weddings,355000.0,BRA,4,2,1004,15340,16344,0
Crowdsourcing,120000.0,USA,1,1,0,16622,16622,0
Enterprise Software,13950000.0,USA,2,5,602,13621,14223,0
Manufacturing,7767995.0,CHN,1,1,0,15187,15187,0
Career Management|Curated Web|Employment|Facebook Applications|Human Resources|Identity|Recruiting|Social Network Media,70000.0,USA,1,3,0,15034,15034,0
Enterprise Software|Services|Technology,10000000.0,USA,1,1,0,11697,11697,0
E-Books,1500000.0,USA,1,2,0,16552,16552,0
Software,14000000.0,CAN,3,3,2715,13263,15978,0
Advertising,4651033.0,IRL,1,1,0,13437,13437,0
Medical|Medical Devices|Therapeutics,49000000.0,USA,2,6,541,12053,12594,0
Advertising|Curated Web|Social Media|Stock Exchanges,1400000.0,CAN,2,7,369,14833,15202,1
Biotechnology|Health Care,1000000.0,USA,1,1,0,16253,16253,0
Industrial Automation|Robotics,1796000.0,USA,7,1,577,15706,16283,0
Education,131037.0,GBR,2,2,19,16212,16231,0
Internet,500000.0,USA,1,7,0,11533,11533,0
Software,10000000.0,USA,1,5,0,11621,11621,0
Information Technology,12000000.0,USA,2,3,1007,15720,16727,0
Curated Web,1000000.0,USA,1,5,0,15398,15398,1
Human Resources|Recruiting|Social Recruiting,750000.0,USA,1,1,0,16771,16771,0
Human Resources|Recruiting,1500000.0,USA,2,1,0,16105,16105,0
EdTech|Education|Educational Games,18000.0,USA,1,1,0,15857,15857,0
Clean Technology,7500000.0,USA,1,1,0,15183,15183,0
Software,40000.0,USA,1,1,0,15706,15706,0
Apps|Employment|Mobile|SMS,7000000.0,BRA,2,6,644,15671,16315,0
Finance|Software,12000000.0,USA,1,3,0,12740,12740,1
Curated Web,51185512.0,USA,2,1,772,15763,16535,0
Hardware + Software,13000000.0,USA,2,2,402,14551,14953,0
Curated Web,750000.0,USA,1,1,0,12570,12570,1
Reviews and Recommendations|Services|Software|Trading,817542.0,ESP,7,6,821,15309,16130,0
Android|Chat|Messaging|Mobile|Productivity Software|SMS,1500000.0,USA,1,4,0,15733,15733,1
Big Data|Data Centers|Technology,2300000.0,USA,1,1,0,16170,16170,0
Semiconductors,9650000.0,USA,2,6,2161,12593,14754,1
Real Estate,4350000.0,FRA,1,1,0,13920,13920,0
Health Care,2000000.0,USA,2,1,1356,14975,16331,0
Marketplaces,22000000.0,USA,1,2,0,11386,11386,0
Software,15000000.0,USA,1,1,0,15147,15147,0
Biotechnology|Health Care,21200000.0,USA,2,8,3520,12431,15951,1
Clean Technology,29581347.0,CAN,4,10,1813,14880,16693,0
Clean Technology,1500000.0,CAN,1,1,0,16100,16100,1
Service Providers|Software,824175.0,HUN,1,3,0,16554,16554,0
Mobile,8273244.0,NOR,3,2,1832,14644,16476,0
Hardware + Software,11000000.0,USA,1,2,0,14963,14963,1
Clean Energy|Clean Technology|Energy Efficiency|Incentives|Utilities,725000.0,USA,5,3,2274,14245,16519,0
Enterprise Software,16000000.0,USA,1,3,0,12864,12864,1
Apps|Software|Systems,14000000.0,USA,1,6,0,13157,13157,0
Health and Wellness|Health Care|Information Technology,15500000.0,USA,2,3,790,13523,14313,1
Biotechnology,5100000.0,NZL,1,1,0,13718,13718,0
Bio-Pharm|Biotechnology|Pharmaceuticals,120000.0,USA,1,1,0,16358,16358,0
Data Security|Software,8250000.0,USA,4,8,1729,14650,16379,0
EdTech|Education,19391496.0,USA,2,2,743,15148,15891,1
Web Hosting,500000.0,CAN,1,1,0,14587,14587,0
Biotechnology,7500000.0,USA,2,1,614,16058,16672,0
Renewable Energies,38100000.0,USA,1,8,0,11620,11620,0
Software,24102319.0,USA,3,5,1783,12552,14335,1
Content|Digital Media|Software,4750000.0,USA,1,2,0,13299,13299,0
Biotechnology,4630156.28620331,CAN,2,4,323,16385,16708,0
Biotechnology,88950000.0,USA,2,3,305,13440,13745,1
Automotive|Cars,147486.489859358,ESP,1,2,0,16728,16728,0
Software,1500000.0,USA,2,1,3440,12935,16375,0
Clean Technology,100000000.0,USA,1,1,0,15874,15874,0
E-Commerce|Enterprises|Enterprise Software|Search,65000000.0,USA,5,19,2556,11323,13879,1
Web Hosting,6100000.0,USA,2,2,249,15308,15557,0
Enterprise Software|iOS|SaaS,1500000.0,USA,1,3,0,16349,16349,0
Games,1500000.0,USA,1,3,0,15279,15279,0
Security,86250000.0,USA,3,16,1483,14910,16393,0
Biofuels,40000000.0,USA,1,1,0,13767,13767,0
Biotechnology|Health Care|Health Diagnostics,115489918.0,USA,6,7,2481,14018,16499,0
Biotechnology|Health Care,94100000.0,USA,5,19,1505,13465,14970,1
Hardware + Software|Real Time,128660.0,IRL,1,1,0,16171,16171,0
Health Care,8300000.0,USA,2,2,539,15266,15805,0
Health Care,247545839.0,USA,17,57,4563,12207,16770,0
Biotechnology,15000000.0,USA,1,1,0,14909,14909,1
Biotechnology,2500000.0,AUS,1,1,0,15908,15908,0
Gps|Health and Wellness|Social Media|Tracking,8175000.0,DNK,7,4,1917,14123,16040,1
Data Mining|Enterprise Software|Social Search,250000.0,USA,1,1,0,15590,15590,0
Brand Marketing|Coupons|Loyalty Programs|Mobile|Shopping,4250000.0,USA,1,2,0,15364,15364,1
Biotechnology|Health Care,80600000.0,CHE,3,15,1226,14544,15770,1
Biotechnology,10000000.0,ISR,1,1,0,16734,16734,0
Health Care,8148584.0,USA,3,7,1478,15126,16604,0
Biotechnology,44972579.0,USA,8,7,2128,14438,16566,0
Life Sciences,500000.0,USA,1,1,0,13346,13346,0
Biotechnology,7535473.0,USA,6,1,1727,14890,16617,0
Health Care|Medical Devices|Services,8000000.0,USA,1,2,0,13570,13570,0
Biotechnology,1500000.0,USA,1,2,0,13678,13678,0
Advertising|SaaS|Web CMS,21500000.0,USA,1,2,0,15443,15443,0
Crowdfunding|Finance|Finance Technology|FinTech|Peer-to-Peer,1500000.0,USA,1,5,0,15461,15461,1
Hardware + Software,17000000.0,CAN,3,4,463,15855,16318,0
Clean Technology,55100000.0,GBR,3,7,678,14419,15097,0
Clean Energy|Clean Technology|Consumer Electronics|Energy,1218632.0,ESP,1,1,0,14948,14948,0
Clean Technology,625000000.0,RUS,1,1,0,15415,15415,0
Clean Technology,2550000.0,USA,4,2,1277,15139,16416,0
Manufacturing,20000000.0,USA,1,1,0,14599,14599,0
Consumer Electronics,2638689.0,FRA,1,4,0,16507,16507,0
Clean Technology,2954475.0,DEU,2,3,959,15453,16412,0
Clean Technology,12000000.0,USA,2,2,539,14187,14726,0
Hardware + Software,7200000.0,CAN,2,3,371,14385,14756,0
Bio-Pharm|Biotechnology|Life Sciences,50000.0,USA,1,1,0,14903,14903,0
Software,500000.0,USA,2,1,67,15327,15394,0
Skill Assessment|Software|Wind,87396.0,ITA,3,3,213,15371,15584,0
Clean Technology,8380000.0,NOR,1,1,0,14117,14117,0
Hardware + Software,2000000.0,USA,1,1,0,14628,14628,0
Gas|Natural Resources|Oil,14116228.904961301,CAN,1,2,0,12928,12928,0
Clean Technology,50000000.0,USA,2,5,498,13859,14357,0
Clean Technology|Internet of Things,3300000.0,CAN,3,1,154,16404,16558,0
Energy|Energy Efficiency|Energy Management|Home Automation|Internet of Things,2250000.0,USA,2,2,845,15869,16714,0
Clean Technology|Energy|Entrepreneur|Startups,30000000.0,USA,1,1,0,15954,15954,0
Clean Technology|Consumer Electronics|DOD/Military,100000.0,USA,1,1,0,15856,15856,0
Energy Efficiency|Innovation Management|Solar,16500000.0,USA,1,2,0,12956,12956,0
Semiconductors,13000000.0,NOR,1,2,0,14686,14686,1
Clean Technology,3000000.0,USA,1,1,0,15383,15383,0
Clean Technology,9500000.0,USA,1,1,0,14775,14775,0
Services|Software,2000000.0,USA,1,1,0,12628,12628,0
Energy,3200000.0,USA,2,2,559,16156,16715,0
E-Commerce,100000.0,USA,1,2,0,16040,16040,0
Clean Technology,215674.0,GBR,2,1,609,15796,16405,0
Clean Technology,33052663.0,USA,5,4,4841,10836,15677,1
Clean Technology|Commercial Solar|Comparison Shopping|Marketplaces|Renewable Energies|Residential Solar|Solar|Sustainability,3454626.0,USA,3,4,595,15979,16574,0
Software,17793058.0,USA,7,10,2234,14426,16660,0
Clean Technology,160000.0,USA,1,1,0,13920,13920,0
E-Commerce|Internet Marketing|Web Design,100000.0,USA,1,1,0,13314,13314,0
Clean Technology,316714020.0,CAN,7,24,3145,13542,16687,0
Clean Technology,250000.0,CAN,1,1,0,16125,16125,0
Clean Energy|Clean Technology|Energy Efficiency|Software,7750000.0,USA,1,3,0,12810,12810,1
Clean Technology,12750000.0,USA,3,5,1527,12465,13992,0
Manufacturing,2800000.0,ISR,2,1,86,16021,16107,0
Clean Technology,42000000.0,USA,1,2,0,13879,13879,0
Energy Efficiency|Energy Storage|Renewable Energies,5993800.22242723,FRA,3,3,1649,15050,16699,0
Manufacturing,5200000.0,USA,3,4,673,15231,15904,0
Clean Technology,26000000.0,USA,3,9,737,14656,15393,0
Analytics|Clean Energy|E-Commerce|Energy Efficiency,5400000.0,USA,4,3,1790,14791,16581,0
Clean Technology,40000000.0,USA,2,4,1496,15197,16693,0
Clean Technology|Fleet Management|Internet of Things|Waste Management,26750591.0,FIN,4,16,1260,15356,16616,0
Biotechnology,1794845.0,USA,1,1,0,16142,16142,0
Mobile,1000000.0,CAN,1,4,0,15266,15266,0
Digital Media|Information Technology,7500000.0,USA,1,1,0,16276,16276,0
Mobile,19000000.0,USA,1,2,0,13444,13444,1
Messaging,750000.0,USA,2,1,565,14986,15551,0
Internet|Mobile|Service Providers|Telecommunications|Wireless,40000000.0,RUS,3,7,1095,12784,13879,0
Match-Making|Online Dating|Private Social Networking|Social Media,5000000.0,USA,1,3,0,13341,13341,0
Software,2900000.0,USA,1,2,0,16462,16462,0
Curated Web,540000.0,CAN,1,6,0,15385,15385,0
Accounting|Marketing Automation,10000000.0,USA,1,1,0,16533,16533,0
Curated Web|Customer Service|Reputation|Social Media Management|Social Media Monitoring|Social Media Platforms,2600000.0,BEL,1,2,0,15923,15923,1
Hardware + Software,6100000.0,USA,1,4,0,13052,13052,0
Biotechnology,31150000.0,CAN,3,6,2506,13955,16461,0
Biotechnology,20927691.0,AUS,4,2,1463,15182,16645,0
Technology,31420000.0,USA,2,4,960,11323,12283,0
Clean Technology,150000.0,USA,1,2,0,15957,15957,0
Apps|Infrastructure|PaaS|Software|Web Development|Web Hosting,37500000.0,USA,4,11,1339,13879,15218,0
Nonprofits,40000.0,USA,1,1,0,15180,15180,0
Education|Video Conferencing,41250.0,HKG,1,1,0,16071,16071,0
EdTech|Education,13954577.0,USA,4,9,1187,14519,15706,0
Colleges|Education|High Schools|Software|Teachers|Universities,8000000.0,USA,3,13,641,15248,15889,1
Clean Technology,100000.0,USA,1,1,0,15915,15915,0
Analytics|Apps|File Sharing|iPad|Mobile|Presentations|Sales and Marketing,300000.0,USA,1,1,0,15796,15796,0
Recruiting,241270.539952577,BGR,3,3,518,16191,16709,0
CRM|Mobile|Sales and Marketing|Software,250000.0,USA,3,3,749,15540,16289,0
Semiconductor Manufacturing Equipment,12500000.0,USA,1,5,0,12501,12501,0
Games,1410000.0,ESP,1,1,0,13781,13781,0
Analytics,34615000.0,USA,4,20,1161,15447,16608,0
Enterprise Software,32500000.0,GBR,3,11,1416,12681,14097,0
Advertising|Content Syndication|Facebook Applications|iPhone|Software|Video|Web Tools,1100000.0,AUS,2,2,0,13879,13879,0
Clean Technology,7424000.0,FIN,1,1,0,13931,13931,0
Energy Management,568013.0,GBR,1,1,0,16161,16161,0
Sports|Video Games,738899.0,ITA,2,1,784,15768,16552,0
Technology,80000000.0,USA,2,6,286,16367,16653,0
Analytics|Business Intelligence|Business Productivity|Sales and Marketing,17280000.0,USA,3,8,1833,13417,15250,0
Big Data|Consulting,1400000.0,USA,1,1,0,16505,16505,0
Analytics|Clean Technology|Internet of Things|Lighting|Networking|Sensors|Smart Building,55625000.0,USA,5,13,1846,14456,16302,0
Clean Technology,33000000.0,USA,2,3,1001,14018,15019,0
Health and Wellness|Health Diagnostics|Machine Learning,15000000.0,USA,3,1,364,16371,16735,0
Advertising|Analytics|Curated Web|Social Media|Web Design|Web Development,12310000.0,USA,2,5,814,12990,13804,0
Health Care Information Technology|Medical Devices|Therapeutics,7000000.0,ISR,1,1,0,16208,16208,0
Apps|Content|Enterprises|Search|Semantic Search,750000.0,USA,2,4,151,15614,15765,0
Software,3735202.0,USA,2,2,861,15117,15978,0
Hardware + Software|Home Automation,4109209.0,GBR,3,3,1327,14791,16118,0
Chemicals,200000.0,IND,1,1,0,14616,14616,0
Events|Marketplaces|Ticketing,10000.0,IDN,1,1,0,16415,16415,0
Biotechnology|Health Care|Medical|Pharmaceuticals,158261598.746082,CAN,5,13,2393,12801,15194,1
Mobile|Wireless,40693678.93238329,DEU,5,18,2862,11731,14593,0
Lifestyle Products|Manufacturing|Product Design,270862.0,ESP,1,1,0,16233,16233,0
Wine And Spirits,67986.0,SVN,2,1,237,16258,16495,0
Enterprise Software|Productivity Software|Software,4300000.0,USA,1,3,0,16360,16360,0
Chemicals|Databases|Search,18192.0,USA,1,1,0,16436,16436,0
Cloud Computing|Open Source|Software,8798987.0,FRA,2,5,614,15281,15895,1
Clean Technology,1100000.0,TUR,1,1,0,15364,15364,0
Energy|Energy Storage|Renewable Energies,17250003.0,USA,2,3,1828,13578,15406,0
Clean Technology|Semiconductors,76500000.0,USA,3,10,767,14382,15149,1
Semiconductors,59000000.0,USA,4,18,2291,12773,15064,1
Advertising|Digital Signage|Enterprise Software|Local Advertising|SaaS|Social Media|Software,3700000.0,USA,3,17,573,15604,16177,0
Advertising|Mobile,2000000.0,USA,1,1,0,13454,13454,1
Software,1000000.0,NZL,1,3,0,13195,13195,0
Enterprise Software,28000000.0,USA,2,4,357,13795,14152,0
Search,750000.0,CAN,1,1,0,12370,12370,1
Advertising,661563.0,FIN,1,1,0,16681,16681,0
Games,3470000.0,GBR,1,1,0,14539,14539,0
E-Commerce|Enterprises|Fashion,150000.0,USA,1,2,0,16364,16364,0
Software,2642814.0,USA,4,4,1162,14561,15723,0
Biotechnology,30000000.0,USA,2,10,1279,12550,13829,0
Cloud Computing|Enterprise Software|Logistics|SaaS|Transportation,12100900.0,USA,2,6,1431,13909,15340,0
Advertising,86000000.0,USA,3,2,1856,13614,15470,0
Customer Service|Oil|Oil and Gas|Services,40000000.0,USA,1,1,0,16287,16287,0
Finance|Insurance|Software,16100000.0,USA,1,2,0,14245,14245,0
Financial Services|Rural Energy|Software,20000.0,UGA,1,1,0,16495,16495,0
Mobile,1783500.0,KOR,1,2,0,15400,15400,0
E-Commerce|Enterprise Software,108500000.0,USA,3,10,1133,15595,16728,0
Information Security,12000000.0,USA,2,3,288,16314,16602,0
Algorithms|Casual Games|Content Discovery|Ediscovery|Entertainment|iOS|Mobile|Music,27838.403634582002,BGR,1,2,0,16617,16617,0
E-Commerce,41600000.0,THA,4,3,1754,14791,16545,1
Semiconductors,4000000.0,USA,1,1,0,14539,14539,0
Clean Technology,17950000.0,ISR,6,9,2192,13908,16100,0
Cloud Computing|Cloud Management|Enterprise Software|Security,3500000.0,USA,1,2,0,15285,15285,1
Cloud Computing|Hardware + Software|Information Services|Information Technology,10652300.6863596,KOR,7,7,2581,13604,16185,0
E-Commerce|Identity|Mobile|Mobile Commerce|NFC|Payments|Retail|Security,6617015.0,GBR,7,16,700,15340,16040,0
Nanotechnology,2500000.0,USA,2,2,727,14770,15497,0
Synchronization|Web Hosting,11675000.0,USA,3,9,1933,14838,16771,0
Enterprise Software,50000.0,USA,1,1,0,15418,15418,0
Clean Technology,7950000.0,USA,2,1,70,14824,14894,0
Software,1020000.0,BEL,1,1,0,13133,13133,0
Android|B2B|iOS|iPad|iPhone|Mobile Software Tools|Renewable Energies|SaaS,94151.0,NLD,1,1,0,16375,16375,0
CRM|Enterprise Software,66000000.0,USA,2,4,344,13535,13879,0
Health Care,92000000.0,USA,5,15,1964,13239,15203,0
Career Management|Human Resources|Recruiting|SaaS|Software,8675487.0,USA,4,6,810,15522,16332,0
Advertising|Games,1000000.0,RUS,1,2,0,14021,14021,0
Health Care|Health Diagnostics,20494987.0,FRA,2,5,773,15422,16195,0
Biotechnology,31896351.0,USA,3,1,4024,12600,16624,1
Enterprise Software|Security,9542.0,GBR,1,1,0,13453,13453,1
Diagnostics|Health and Wellness|Therapeutics,6199150.0,GBR,2,3,94,16482,16576,0
Big Data Analytics|Business Intelligence|Databases|Enterprise Software|Hardware + Software|Open Source,64921718.0,USA,6,13,1976,13033,15009,0
Charter Schools|EdTech|Education|English-Speaking|Language Learning|Training,1007631.0,FRA,1,7,0,16591,16591,0
Software,4000000.0,USA,1,1,0,13570,13570,0
Developer Tools|Development Platforms|Internet of Things|M2M|Predictive Analytics,150000.0,POL,1,1,0,16040,16040,0
Information Technology,1300000.0,CAN,1,1,0,16290,16290,0
Sports,2600000.0,USA,3,8,246,15431,15677,0
Enterprises|Enterprise Software|Human Resources|Recruiting,3300000.0,USA,2,7,786,13726,14512,1
Automotive,1671750.0,USA,4,1,675,15917,16592,0
Health Services Industry|Manufacturing|Medical Devices,17915742.0,SWE,1,2,0,11309,11309,0
Software,14569092.0,USA,3,3,4272,12114,16386,0
Hardware + Software|Television,24000000.0,USA,2,5,1918,12174,14092,0
Biotechnology,1375000.0,USA,2,1,30,16483,16513,0
Clean Technology,16750000.0,USA,4,8,1365,15299,16664,0
Biotechnology,4751000.0,USA,2,2,1108,14636,15744,0
Software,6800301.0,USA,6,10,1618,14642,16260,0
Advertising,70000.0,USA,2,2,304,13514,13818,1
Biotechnology,10000000.0,USA,1,2,0,15362,15362,0
Sports,233702.126689353,ESP,2,5,662,16062,16724,0
E-Commerce,40000.0,CHL,1,1,0,16222,16222,0
Enterprise Software,9646746.0,GBR,2,2,546,15949,16495,0
Biotechnology,24350007.0,USA,4,2,1593,13706,15299,1
Web Hosting,108000000.0,USA,2,14,971,11941,12912,1
Cloud Computing|Data Integration|Enterprises|Software|Synchronization|Web CMS,3500000.0,FRA,1,1,0,15049,15049,1
Curated Web,40000.0,USA,1,1,0,14945,14945,0
Services|Technology,3200000.0,USA,1,2,0,12527,12527,0
Semiconductors,13000000.0,USA,1,3,0,13160,13160,0
Biotechnology,29941703.0,USA,6,2,1169,15117,16286,1
Software,13000000.0,ISR,2,4,423,13409,13832,0
Finance|Online Travel|Price Comparison,539450.0,TUR,2,6,489,14241,14730,0
Software,6000000.0,USA,2,10,142,16594,16736,0
Software,13400000.0,USA,1,6,0,11640,11640,0
Enterprise Software,235000.0,USA,2,2,209,15512,15721,0
Clean Technology,1335000.0,USA,1,1,0,15993,15993,0
Semiconductors,27400000.0,USA,2,9,826,15327,16153,1
Games,40000.0,BRA,1,1,0,15665,15665,0
Clean Technology,27300000.0,USA,3,7,825,14175,15000,0
Software,10000022.0,USA,2,2,3279,12430,15709,1
Fashion,1672580.0,FRA,1,2,0,15953,15953,0
E-Commerce,17000000.0,USA,2,2,671,13321,13992,1
Energy Efficiency|Energy Management|Energy Storage|Internet of Things|Property Management|Technology,416691.456570685,CAN,2,2,605,16022,16627,0
Biotechnology,2941893.0,GBR,1,1,0,13598,13598,0
Farmers Market|Home & Garden|Manufacturing|Renewable Tech,150000.0,USA,1,1,0,16421,16421,0
Clean Technology,29800000.0,AUS,1,1,0,14987,14987,0
Software,15000000.0,GBR,1,2,0,13213,13213,0
Software,6000000.0,USA,1,1,0,13149,13149,0
Software,2500000.0,USA,1,1,0,16357,16357,0
Biotechnology,29600000.0,USA,2,5,706,16021,16727,0
Enterprise Software,16100000.0,USA,5,15,1283,13661,14944,0
Broadcasting|Software|Technology,42500000.0,USA,5,24,2658,12682,15340,1
Curated Web,3329300.0,FRA,1,1,0,15811,15811,0
Public Relations,5280000.0,USA,2,3,587,12478,13065,1
Business Productivity|Software,16150000.0,USA,2,15,568,16041,16609,0
Elder Care|Internet|Marketplaces,3000002.0,USA,1,12,0,16694,16694,0
Biotechnology,1200000.0,USA,1,1,0,15468,15468,0
Business Services,16000000.0,USA,2,4,965,10988,11953,1
SaaS|Software|Video,14269616.0,USA,5,7,2171,13564,15735,0
Energy|Optimization|Technology,115422.913574476,NLD,2,2,151,16436,16587,0
Biotechnology,14000000.0,USA,1,1,0,14027,14027,0
Biotechnology,11000000.0,ISR,1,4,0,14277,14277,1
Senior Citizens|Social Media|Social Network Media,32000000.0,USA,2,7,334,13239,13573,0
Hardware + Software,16100000.0,USA,3,10,2007,12571,14578,0
E-Commerce,8848619.0,USA,2,3,3871,10917,14788,0
Clean Technology|Environmental Innovation|Mobile Software Tools|Technology,10000000.0,USA,3,4,1737,14244,15981,0
Clean Technology,40100000.0,USA,3,4,729,15845,16574,0
Medical Devices,18000000.0,FRA,1,4,0,13844,13844,0
Semiconductors,4490000.0,GBR,2,5,183,14602,14785,0
Software,46000000.0,USA,2,2,1488,13328,14816,0
Software,20000000.0,USA,1,3,0,13969,13969,0
SaaS|Social Media|Software,1982219.0,CAN,4,8,450,15670,16120,0
Mobile Commerce|Mobile Payments|Mobile Software Tools,1650000.0,IND,2,3,67,15648,15715,0
Education|Enterprise Software,56309183.0,USA,4,4,1698,13483,15181,1
Outsourcing|Software|Technology,50000000.0,USA,1,3,0,14060,14060,1
E-Commerce|Internet|Retail|Sustainability,1400000.0,USA,2,2,348,16164,16512,0
Business Intelligence|Consulting|CRM|Finance|Infrastructure|Software,25000000.0,USA,1,8,0,13017,13017,0
Health and Wellness,3155000.0,USA,2,1,356,16120,16476,0
Internet,11000000.0,USA,1,1,0,11943,11943,0
Network Security,637757.0,DEU,1,1,0,16359,16359,0
Information Technology|Services,7500000.0,IND,1,2,0,12563,12563,0
Biotechnology,120000.0,USA,1,1,0,16358,16358,0
Digital Media|E-Books|Education|Kids|Publishing|Subscription Businesses|Textbooks,1400000.0,USA,2,9,353,16071,16424,0
Analytics|Audio|Finance|Video|Weddings,585000.0,USA,2,2,31,15309,15340,0
Biotechnology|Health Diagnostics,58000000.0,USA,3,9,930,15657,16587,0
Computers|Internet|Software Compliance,8000000.0,USA,2,2,632,10847,11479,1
Pharmaceuticals,13000000.0,USA,1,6,0,11332,11332,0
E-Commerce,5750129.0,BRA,2,1,318,15857,16175,0
Social Media,40000.0,USA,2,2,273,15379,15652,0
Health Care|Hospitals|Virtualization,92420.0,ARG,2,2,731,15309,16040,0
Semiconductors,7670000.0,FIN,1,2,0,14291,14291,0
Film|Music|Television,5000000.0,SWE,1,1,0,16209,16209,0
Games,40000.0,CHL,1,1,0,15329,15329,0
Clean Technology,5680800.0,BEL,1,3,0,15169,15169,0
Education|SaaS,993661.269153856,USA,1,1,0,15491,15491,0
Analytics|Cloud Computing|SaaS,50809.0,CAN,1,1,0,15461,15461,0
Curated Web,12000000.0,USA,1,4,0,11376,11376,0
Cloud Data Services|Medical|Mobile Commerce,6813355.0,USA,2,2,498,15797,16295,0
Biotechnology,36000000.0,USA,1,2,0,13588,13588,0
Software,500000.0,USA,1,1,0,16317,16317,0
Banking,20352.0,USA,1,1,0,16272,16272,0
Biotechnology,49083000.0,USA,3,12,745,15431,16176,0
E-Commerce|Personal Health,1944669.0,USA,2,1,328,15189,15517,0
Energy Management|Enterprise Software,1816440.0,IRL,2,2,881,14444,15325,0
Internet|Testing|Web Hosting,2000000.0,GBR,1,1,0,14031,14031,0
Analytics,3671000.0,USA,8,8,5418,10227,15645,0
Biotechnology|Health and Wellness,61500000.0,USA,5,9,1589,14524,16113,1
Entertainment|Games|Internet TV|iPad|Mobile|Photography|Social Media|Video,2271450.0,USA,2,1,1113,14669,15782,0
Health and Wellness|Health Care|Mobile|Software,35000000.0,USA,3,11,2700,11186,13886,1
General Public Worldwide|SaaS|Technology,500000.0,IND,2,2,147,16520,16667,0
Advertising|Advertising Platforms,7000000.0,UKR,1,1,0,16160,16160,0
E-Commerce,1000000.0,USA,1,5,0,15340,15340,0
Hardware + Software,15500000.0,ISR,2,4,583,12884,13467,0
Digital Media|SaaS|Social Media|Social Network Media|Software|Video,8500000.0,USA,2,11,476,15769,16245,0
Project Management|Services|Software,23700000.0,USA,3,6,1807,11840,13647,0
Clean Technology,20000000.0,USA,1,2,0,13860,13860,1
Software,11185748.0,FRA,2,4,2424,13025,15449,0
Advertising|Apps|Distribution|Publishing|SaaS,1700000.0,IRL,1,1,0,15317,15317,0
Clean Technology,10040000.0,LUX,1,1,0,15553,15553,0
Clean Technology,4800000.0,USA,1,1,0,14231,14231,1
Analytics|Big Data|Health and Wellness|News|Simulation|Web Development,120000.0,USA,1,2,0,15949,15949,0
Curated Web|Entertainment|Media|Television|Video,6875000.0,USA,2,8,1132,13985,15117,1
Health Care,75000.0,USA,2,1,588,15202,15790,0
Analytics|Big Data|Infrastructure|Risk Management,425000.0,LBN,1,1,0,16191,16191,0
Messaging|Mobile|Software|VoIP,12500000.0,CAN,2,5,479,13149,13628,0
Health Care|Hospitals,435475.0,CAN,1,2,0,16485,16485,0
Software,170000.0,BGR,1,1,0,16091,16091,0
Apps|Mobile|Software,78259.0,GBR,1,1,0,15553,15553,0
Enterprise Software,47000000.0,USA,3,7,1282,11323,12605,1
Social Media,250000.0,CAN,1,1,0,15470,15470,0
FinTech,100000.0,USA,1,1,0,16072,16072,0
Health Care|Medical Devices|Pharmaceuticals,685166.0,IRL,1,1,0,16400,16400,0
Web Hosting,280000000.0,USA,2,17,0,10928,10928,1
Design|Optical Communications|Wireless,20130789.0,GBR,1,1,0,12439,12439,0
Gas|Oil|Services,30000.0,USA,1,1,0,16130,16130,0
Fashion,31885858.0,GBR,1,1,0,15271,15271,0
Health Care,12500000.0,NLD,1,1,0,16742,16742,0
E-Commerce,161080.0,GBR,1,1,0,15047,15047,0
Online Rental,2220000.0,USA,2,8,156,16405,16561,0
Biotechnology|Business Services|Industrial|Pharmaceuticals,3600000.0,USA,1,5,0,11409,11409,0
Construction|Databases|Service Providers,1000000.0,USA,1,2,0,15048,15048,0
Content|Games|Hardware|Hardware + Software|Technology|Television|Video|Video Streaming,2141557.0,USA,3,1,397,15371,15768,0
Finance,16000000.0,IND,1,1,0,16059,16059,0
Finance|Real Estate|Service Providers,10500000.0,USA,3,4,1857,14669,16526,0
Curated Web,20000.0,USA,1,4,0,15595,15595,0
Big Data|Big Data Analytics|Oil & Gas,5000000.0,USA,1,1,0,16085,16085,0
Business Development|Crowdfunding|Entrepreneur|Finance|Software,2100000.0,USA,2,2,2515,13653,16168,0
Finance|Finance Technology|Financial Services|FinTech|Marketplaces,3499994.0,USA,2,7,581,16114,16695,0
Biotechnology,13326421.678749,ESP,3,13,1021,13482,14503,0
Biotechnology,12000000.0,USA,1,4,0,13157,13157,1
Security,16640000.0,FRA,1,4,0,14370,14370,0
Enterprise Software,2329144.0,GBR,2,2,401,15306,15707,0
Software,25000000.0,USA,1,1,0,16261,16261,0
Clean Technology,311453228.0,USA,4,10,1822,14184,16006,0
Hospitality,3500000.0,USA,3,1,449,16252,16701,0
Analytics|Consumer Electronics|Distribution|E-Commerce|Professional Services|Recycling,400000.0,USA,1,1,0,15918,15918,0
Business Services|Content|Game|Games|Social Network Media|Virtual Worlds,3884570.0,ESP,3,12,849,13563,14412,0
Bio-Pharm|Technology,208712.349161846,NOR,1,1,0,15800,15800,0
Drones|Education|Open Source|Robotics|Technology,213922.04680614398,ESP,1,1,0,16541,16541,0
Software,3500000.0,CAN,1,1,0,15960,15960,0
Accounting|CRM|Enterprise Software|Information Services|Information Technology|Point of Sale|Sales and Marketing|Software|Startups,4223350.0,GBR,3,13,1337,14512,15849,0
Software,8100000.0,USA,2,3,647,15765,16412,0
Education|Software|Tutoring,859704.1324921391,CAN,5,5,253,16495,16748,0
Curated Web,16000000.0,RUS,3,6,995,14955,15950,0
Games,1000000.0,CAN,1,3,0,15530,15530,0
Biotechnology,85919109.0,FRA,6,10,3276,13090,16366,1
Biotechnology,63000000.0,GBR,2,14,736,13362,14098,1
Software,38100000.0,USA,1,5,0,11386,11386,0
E-Commerce,256000.0,ESP,1,1,0,14217,14217,0
Online Travel,476166.0,COL,4,8,815,15737,16552,0
Curated Web|Recruiting,930208.0,GBR,1,1,0,15503,15503,0
E-Commerce|Social Commerce,40000.0,CHL,1,1,0,15340,15340,0
Software,3600000.0,USA,2,3,994,13425,14419,1
Hospitality,209000.0,GBR,1,1,0,13819,13819,0
SaaS|Technology|Web Design,3000000.0,USA,1,2,0,12769,12769,0
Communications Hardware|Communications Infrastructure|Wireless,42000000.0,USA,1,1,0,12261,12261,0
Biotechnology,6650000.0,USA,1,1,0,13887,13887,0
Networking|Web Hosting,4000000.0,IND,1,1,0,16478,16478,0
Manufacturing|Outdoors|Sporting Goods,20000.0,USA,1,1,0,15971,15971,0
Social Media,587000.0,GBR,1,1,0,13403,13403,0
CRM|E-Commerce|Retail|Software,4757461.0,GBR,2,2,507,14882,15389,0
Cyber Security|Data Security|Information Security|Network Security,19639999.0,CAN,2,7,426,15903,16329,0
Internet of Things|M2M|Mobile,13403254.0,GBR,2,2,372,16280,16652,0
Design|Designers|E-Commerce|Fashion,18500000.0,USA,2,3,1228,15095,16323,0
Enterprise Software|Internet,25800000.0,USA,3,26,730,15930,16660,0
Retail,8170676.0,ESP,1,4,0,16224,16224,0
Data Visualization|E-Commerce|Language Learning|Mobile|Mobile Commerce|Mobile Shopping|NFC|QR Codes,237000.0,EGY,2,2,167,15371,15538,0
Hardware + Software|Wearables,3142071.0,CAN,4,3,2195,14364,16559,0
Semiconductors,73615481.0,USA,7,18,3798,11724,15522,0
Marketing Automation|Real Time|Web Hosting,132975.0,FRA,1,1,0,15961,15961,0
Electrical Distribution|Energy Efficiency|Utilities,339000000.0,ZAF,1,1,0,16533,16533,0
Online Shopping,6000000.0,RUS,1,1,0,15584,15584,0
Leisure|Travel & Tourism,15579067.0,POL,1,1,0,16268,16268,0
E-Commerce|Service Providers,893514.0,ESP,3,6,491,15869,16360,0
Development Platforms,26717468.0,CHE,1,8,0,12369,12369,0
File Sharing|Media|Social Media|Storage|Web Hosting,5000000.0,ISR,3,5,546,13118,13664,1
Software,4000000.0,USA,1,1,0,15510,15510,0
Health and Wellness,726000.0,USA,2,4,1442,14516,15958,0
Agriculture|Apps|Information Technology|Internet|Mobile|Social Entrepreneurship|Telecommunications,1500000.0,MUS,1,1,0,16217,16217,0
Clean Technology|Green,192000000.0,USA,3,5,1975,13990,15965,0
Communities|Non Profit|Social Media,975000.0,PRT,4,1,1193,15450,16643,0
Bio-Pharm|Health and Wellness|Health Care|Pharmaceuticals,20000000.0,USA,1,4,0,12159,12159,1
Fashion,12144055.0,FRA,1,3,0,14880,14880,0
Biotechnology,20200245.0,USA,3,4,394,14732,15126,0
Biotechnology|Health and Wellness|Health Care|Medical|Pharmaceuticals,245650000.0,USA,3,10,2518,14000,16518,1
Security,1370000.0,NZL,1,2,0,13149,13149,0
Software,21000000.0,CAN,2,8,4656,11589,16245,1
Fashion,270862.0,ESP,1,1,0,16233,16233,0
Entertainment|SaaS|Social Media|Sports,53090.5476233508,ESP,2,2,800,15667,16467,0
Software,1600000.0,USA,2,8,78,16016,16094,0
Health and Wellness,141032301.0,USA,3,7,1029,15174,16203,0
Semiconductors,7183800.0,BEL,1,1,0,13186,13186,0
Health and Wellness|Health Care|Hospitals,80000000.0,USA,1,2,0,12423,12423,0
Health Care Information Technology|Medical|Medical Devices,325000.0,USA,2,2,266,16155,16421,0
Enterprise Software,2180175.0,GBR,1,1,0,11637,11637,1
Big Data|Clean Energy|Clean Technology,16750000.0,USA,2,2,948,15446,16394,0
Manufacturing|Medical Devices|Women,20000000.0,USA,1,2,0,16695,16695,0
Information Services|Portals|Weddings,540422.0,VEN,3,3,487,15796,16283,0
Consumers,2300000.0,USA,1,8,0,16344,16344,0
Real Estate,1250000.0,USA,2,6,923,13993,14916,0
Real Estate,845313.0,GBR,1,1,0,16196,16196,0
Health Care,39122000.0,USA,4,12,1292,14230,15522,1
Automotive,2300000.0,USA,3,8,527,15819,16346,0
Crowdsourcing|Finance,6175000.0,USA,4,17,1506,15125,16631,0
Analytics|Big Data|Indoor Positioning|Location Based Services|M2M|Mobile|Mobile Software Tools|Navigation|Proximity Internet|Retail|Sensors|Wireless,3100000.0,USA,2,8,284,15765,16049,0
File Sharing|Mobile|Peer-to-Peer|Productivity Software,1000000.0,KOR,1,1,0,16202,16202,0
Browser Extensions|E-Commerce|Mobile Commerce,25000.0,USA,2,2,180,15950,16130,0
Analytics,4500000.0,USA,1,3,0,13265,13265,0
Consulting|Information Technology|Networking|Telecommunications,1210000.0,ESP,1,2,0,13608,13608,0
Advertising|App Marketing|Games|Mobile|Social Media,1000000.0,BRA,1,1,0,15340,15340,0
Clinical Trials,6000000.0,USA,1,2,0,13524,13524,0
Clean Technology,51000000.0,CHN,2,8,19,14061,14080,0
Curated Web,740000.0,USA,1,3,0,14743,14743,1
Electronics|Software,17071.0,GBR,1,1,0,16252,16252,0
Delivery|Hospitality,30000000.0,CHN,2,2,296,16036,16332,0
Advertising,1793100.0,CZE,1,1,0,13208,13208,0
Enterprise Software,1320000.0,AUS,2,2,685,15826,16511,0
Clean Technology,8000000.0,USA,1,1,0,14487,14487,0
Curated Web|Internet|Services,1227720.0,ESP,2,6,209,15645,15854,0
Technology,2003257.0,IND,1,1,0,15279,15279,0
Web Hosting,5527780.0,USA,4,1,1268,13417,14685,0
CRM|Enterprise Software|Services|Web Development,4662500.0,USA,4,1,1265,14224,15489,0
Biotechnology|Healthcare Services|Medical,9485427.0,USA,5,1,1415,15340,16755,0
Security,10000000.0,GBR,2,2,1521,13544,15065,0
Manufacturing,2000000.0,CHN,4,6,1157,12753,13910,0
Software,750000.0,USA,1,1,0,15362,15362,0
Hardware + Software,4000000.0,USA,1,3,0,14342,14342,0
All Markets|Clean Technology|E-Commerce|Environmental Innovation|Finance|Marketplaces|Natural Resources|Organic|Startups,1028855.0,GBR,4,12,882,14883,15765,0
Clean Energy|Clean Technology|Energy|Renewable Energies,13400000.0,USA,2,10,389,15688,16077,0
Financial Services,45000000.0,CAN,1,1,0,16632,16632,0
Nonprofits,40000.0,USA,1,1,0,15175,15175,0
Public Relations,12000000.0,ISR,1,3,0,13241,13241,0
Clean Technology,115000.0,USA,1,1,0,15930,15930,0
Enterprise Software,6500000.0,USA,1,3,0,13213,13213,1
Software,405002.0,GBR,1,1,0,16345,16345,0
E-Commerce|Events|Music Venues|Sports|Ticketing,1000000.0,USA,1,1,0,13990,13990,0
Data Centers,16988889.0,LUX,1,2,0,16477,16477,0
Doctors|Health and Wellness|Health Care|Health Care Information Technology|Medical|Social Network Media,326500.0,LBN,3,5,795,15580,16375,0
Clean Technology,7500000.0,DEU,1,1,0,15617,15617,0
Entrepreneur|Finance|Investment Management|Startups|Venture Capital,1200000.0,TUR,1,1,0,15853,15853,0
Advertising,4000000.0,USA,1,3,0,13466,13466,0
Finance|FinTech|Trading,72900000.0,CYP,7,21,3032,13514,16546,0
Event Management|Events|Software,35999998.0,USA,5,6,1875,14769,16644,0
Software,8300000.0,USA,1,2,0,16107,16107,0
Biotechnology|Information Technology|Pharmaceuticals|Services,5000000.0,USA,1,3,0,12431,12431,1
E-Commerce|Peer-to-Peer,97256127.0,USA,8,23,3277,12935,16212,1
Bio-Pharm|Biotechnology|Health and Wellness|Health Care,4400000.0,USA,1,1,0,16190,16190,0
Mobility|Sustainability|Travel,330118.0,DEU,1,2,0,15706,15706,0
Education,40000.0,CHL,1,1,0,15420,15420,0
Cloud Computing|Cloud Management|Enterprise Software|Infrastructure|Open Source,55500000.0,USA,3,9,1085,14363,15448,1
Analytics|B2B|Big Data|Retail|Software,23600000.0,USA,3,17,996,14761,15757,0
Business Services,8000000.0,USA,1,2,0,12335,12335,0
Information Technology,4500000.0,USA,1,3,0,12443,12443,0
Biotechnology,4026248.0,USA,4,9,1252,15461,16713,0
Biotechnology,8610000.0,AUT,2,7,848,13837,14685,0
Automotive|Cars|Direct Sales,50190.0,BRA,1,1,0,15400,15400,0
Enterprises|Financial Services|Health and Wellness|Mobile|Web Hosting|Wholesale,88205645.0,DEU,1,2,0,16346,16346,1
Technology,20000000.0,USA,1,5,0,11533,11533,0
Biotechnology,21000000.0,USA,1,5,0,16336,16336,0
Social Media,6850000.0,USA,2,3,832,12753,13585,0
E-Commerce,1500000.0,UKR,1,1,0,16020,16020,0
Web Hosting,9300000.0,BGR,1,1,0,13144,13144,0
Search,1020965.0,SWE,1,1,0,15249,15249,0
Manufacturing,18503220.0,FIN,1,3,0,14993,14993,0
Pharmaceuticals,17888587.640104,BEL,1,5,0,16710,16710,0
E-Commerce Platforms|Logistics|Postal and Courier Services|Shipping,404250.0,SVN,4,2,387,16314,16701,0
Clean Technology,266400000.0,JPN,1,2,0,14638,14638,0
Biotechnology,54200000.0,GBR,4,30,709,12983,13692,1
Games,8800000.0,GBR,1,1,0,14742,14742,0
Biotechnology,38500543.0,USA,3,6,1349,14812,16161,1
Clean Technology,5350000.0,USA,3,6,1049,15706,16755,0
Analytics|Business Intelligence|SEO|Social Media|Social Media Management|Test and Measurement,40000.0,CHL,1,1,0,15169,15169,0
Communications Infrastructure|Information Technology|User Experience Design,455665.0,KOR,1,2,0,16423,16423,0
Customer Service|Enterprise Software|SaaS,383037.0,GBR,2,1,136,15675,15811,0
Health Care,95000000.0,USA,2,12,1281,12563,13844,1
Curated Web,7000000.0,FRA,2,3,742,15340,16082,0
Consumer Goods,15000000.0,USA,1,2,0,12571,12571,1
Business Services|Health Care|Hospitals|Medical,70035167.0,USA,5,8,1463,15299,16762,0
Automotive|Electric Vehicles,1600000.0,USA,1,1,0,16615,16615,0
Data Security|Homeland Security|Software|Storage,6000000.0,USA,1,4,0,12115,12115,1
Furniture,4730314.70796613,GBR,2,8,191,16566,16757,0
Biotechnology,7669424.0,USA,2,2,263,15431,15694,0
Application Platforms|Games|Gamification,14312550.0,ISL,4,14,3982,10876,14858,0
Curated Web,11201619.0,USA,2,2,393,15343,15736,0
Biotechnology,35000000.0,USA,1,1,0,16743,16743,0
Financial Services|Marketplaces|Technology,2800000.0,USA,1,6,0,16506,16506,0
Enterprise Software,35000.0,USA,1,1,0,14202,14202,0
E-Commerce|Hotels,500000.0,IND,1,1,0,16577,16577,0
Unmanned Air Systems,40000.0,USA,1,1,0,15665,15665,0
Event Management,19000000.0,USA,1,4,0,11120,11120,0
Advertising|Big Data|Events,68000.0,USA,2,2,421,16019,16440,0
Event Management|Events|Mobile,2000000.0,CAN,1,1,0,16387,16387,0
Business Analytics|Collaboration|Enterprise Software|Meeting Software|Mobile Software Tools|SaaS,8000000.0,USA,2,11,407,16343,16750,0
Event Management|Events|Online Reservations|Ticketing,199575000.0,USA,10,25,2689,13453,16142,0
Location Based Services|Messaging|Social Commerce,40000.0,CHL,1,1,0,16222,16222,0
Audio|Software|Video Conferencing,2200000.0,USA,1,3,0,15720,15720,0
Crowdfunding|Crowdsourcing|E-Commerce|Events|Ticketing,135077.0,ARG,2,2,181,15584,15765,0
Cloud Data Services|Events|Marketplaces|SaaS,335110.0,CHE,1,2,0,16283,16283,0
Curated Web|Events|Local|Search|Social Media,19600000.0,USA,3,8,1324,12843,14167,1
Curated Web|Events|Internet,90000.0,BRA,2,2,1073,14579,15652,0
Curated Web,2500000.0,IND,2,2,436,16041,16477,1
Events|Software|Ticketing,1500000.0,ARG,2,2,645,15236,15881,1
Enterprise Software|Entertainment|Facebook Applications|Mobile|Mobile Commerce|Sports|Ticketing,750000.0,ISR,2,1,244,15340,15584,0
Events,1600000.0,JPN,2,2,210,16161,16371,0
Apps|Cloud Computing|Design|Events,17000000.0,USA,4,6,1837,14802,16639,0
Internet Marketing|Software,15230.0,GBR,1,1,0,15859,15859,1
Events|Photography|Photo Sharing|Social Media,303980.0,GBR,2,3,411,15792,16203,0
Events|Guides|Meeting Software|Mobile|Music|Networking|Social Media|Software|Technology,175000.0,EGY,1,1,0,15973,15973,0
Curated Web|Events|Internet Marketing|Marketplaces,1800000.0,USA,1,5,0,15495,15495,0
Events|Photo Sharing|Video,4345000.0,USA,2,1,294,16276,16570,1
Curated Web|Events|Finance|FinTech,455000.0,USA,2,9,31,13726,13757,0
Curated Web|Event Management|Events|Internet|Mobile,143431.0,BGR,3,3,273,15584,15857,0
Advertising,9161897.0,USA,1,1,0,15385,15385,0
Accounting|Billing|Enterprise Software|Software,50000.0,USA,1,1,0,15584,15584,0
App Stores|Developer APIs|Developer Tools|Development Platforms|Software|Video,1034294.0,IRL,3,3,611,15764,16375,0
Clean Technology|Transportation,1850000.0,USA,4,1,1070,15619,16689,0
Cyber Security|FinTech|Fraud Detection|Security,3500000.0,ISR,1,3,0,16582,16582,0
Messaging|Social Media|Social Network Media,200000.0,JPN,1,3,0,15370,15370,0
Databases|Software|Technology,32000000.0,USA,2,12,984,12062,13046,1
Mobile|Software,2399992.0,USA,4,9,698,15340,16038,0
Software,16000000.0,USA,2,6,827,12359,13186,1
Entertainment|Events|Media|Social Travel|Travel,1500000.0,USA,1,2,0,16528,16528,0
EdTech|Education|Internet,21000000.0,USA,2,8,712,14854,15566,0
Analytics|CRM|Personalization|SaaS|Software,6250000.0,USA,3,13,1077,15134,16211,0
Artificial Intelligence|Curated Web|Music|Photography|Social Network Media,1350000.0,FRA,1,2,0,15877,15877,0
Digital Media|Gift Card|Messaging|Mobile|Video,2432000.0,USA,1,3,0,15898,15898,0
Design,55000000.0,USA,1,1,0,16086,16086,0
E-Commerce|Fashion,1100000.0,USA,1,12,0,15065,15065,0
Finance|FinTech|Travel,750000.0,USA,3,2,787,14462,15249,1
Analytics|Big Data|Cloud Computing|Document Management|Ediscovery|Enterprise Software|Legal,1504995.0,USA,2,5,692,15022,15714,0
Social Media,3100000.0,USA,1,7,0,15138,15138,0
Consumer Goods,685000.0,USA,2,3,67,16374,16441,0
Hardware + Software|Health Care,8815114.0,USA,4,5,1384,15344,16728,0
Business Productivity|Productivity Software|Software,290000000.0,USA,11,23,3175,13208,16383,0
Photography,2425000.0,USA,3,11,244,15296,15540,0
Curated Web|Local|Maps|Mobile|Restaurants|Reviews and Recommendations|Social Media|Travel,530098.0,DNK,2,1,99,15522,15621,0
Business Information Systems|Event Management|Information Services,5975000.0,USA,3,7,570,15857,16427,0
Clean Technology,110000000.0,USA,2,2,693,13789,14482,0
Internet of Things|Mobile,1025000.0,USA,4,4,787,15706,16493,0
Consumer Goods|Innovation Management|Retail,9700000.0,USA,1,1,0,16350,16350,0
Manufacturing,55786221.0,USA,6,13,2470,13991,16461,0
Local Search|Online Reservations|Sports,1118000.0,AUT,2,4,136,16601,16737,0
Sports,4200000.0,USA,2,6,800,15918,16718,0
EdTech|Education,27000000.0,USA,3,6,1165,15248,16413,0
Information Technology,50000000.0,USA,1,2,0,16688,16688,0
Consumers,78700000.0,USA,3,10,1381,15340,16721,0
Alumni|Mobile|Nonprofits|Predictive Analytics|SaaS,14568000.0,USA,4,9,1324,15034,16358,0
Human Resources|SaaS|Software,3450000.0,USA,2,1,414,15461,15875,0
Local Businesses,25000.0,USA,1,1,0,15908,15908,0
Brand Marketing|Discounts|Social Media|Social Network Media,409715.0,ESP,4,5,488,15126,15614,0
Search,738000.0,GBR,1,1,0,14721,14721,0
Business Services|Health and Wellness,84728588.0,USA,8,20,3865,12114,15979,1
Mobile,2809010.0,USA,1,3,0,14778,14778,0
Corporate Wellness|Finance|Fitness|Health and Wellness,6143000.0,USA,5,15,821,14975,15796,0
Software,29957650.0,USA,6,3,2140,14560,16700,0
Software,14300000.0,USA,1,11,0,12335,12335,0
Mobile,14000000.0,USA,2,5,258,12964,13222,0
Internet|Mobile|Social Media,1175000.0,USA,3,4,744,15584,16328,0
Curated Web,17500000.0,USA,3,11,1874,12784,14658,0
E-Commerce,3500000.0,USA,1,1,0,15558,15558,1
Auctions|E-Commerce|Online Auctions,43000000.0,USA,4,7,1210,15461,16671,0
Mobile|Web Development,35500000.0,ISR,3,9,555,15117,15672,0
Groceries|Manufacturing,20000000.0,USA,1,1,0,16287,16287,1
Games|Software,2250000.0,FIN,2,5,157,16521,16678,0
Analytics,19000000.0,USA,1,1,0,14931,14931,0
Biotechnology,712671.0,GBR,2,2,309,15237,15546,0
Mobile|Search,5190128.0,GBR,2,2,332,13757,14089,1
Biotechnology,1764230.0,FRA,1,2,0,14998,14998,0
Software,5165160.0,DEU,1,3,0,15553,15553,0
Health and Wellness,6000000.0,USA,1,4,0,16435,16435,0
E-Commerce,5000000.0,TUR,2,2,731,15846,16577,0
Cloud Security|Security|Web Tools,11400000.0,USA,2,5,433,15952,16385,0
Databases|Software,6800000.0,USA,2,5,1862,12261,14123,0
Messaging,3350000.0,GBR,2,3,784,15211,15995,0
Enterprise Software,48919968.0,GBR,1,1,0,15071,15071,0
Hardware + Software,123000.0,EST,1,1,0,13340,13340,0
E-Commerce,5000000.0,TUR,1,3,0,15889,15889,0
Health and Wellness|Health Care|Personal Health,19615.0,CAN,1,1,0,15762,15762,0
Green|Wine And Spirits,16773.0,SVN,1,1,0,16703,16703,0
Cloud Infrastructure|E-Commerce|SaaS,350000.0,ISR,1,1,0,15126,15126,0
Health Care|Health Care Information Technology|Mobile Health|SaaS,1075000.0,USA,2,3,202,16442,16644,0
Advice|Career Management|EdTech|Education|Recruiting|SaaS,3200000.0,USA,2,9,930,15681,16611,0
E-Commerce,2551020.0,TUR,1,1,0,15894,15894,0
Music,2300000.0,USA,1,8,0,15743,15743,1
Events|Fashion|Retail|Skate Wear|Sporting Goods|Sports,6000000.0,USA,1,4,0,14944,14944,0
Domains|Finance|FinTech|Publishing,1500000.0,USA,3,5,754,13818,14572,0
Analytics|Business Intelligence|Customer Service|Enterprise Software,3352194.0,USA,3,19,553,14897,15450,0
Education|Educational Games|K-12 Education|Online Education,4000000.0,BRA,2,1,487,15400,15887,0
Advertising|Sales and Marketing|Social Media,3500000.0,USA,2,1,424,15662,16086,0
Biotechnology,7018900.0,DEU,4,12,2123,13757,15880,0
Fashion,45697.0,GBR,1,1,0,15842,15842,0
Biotechnology,613106.0,GBR,1,1,0,15352,15352,0
Security,4893742.0,USA,3,2,1920,14200,16120,0
Biotechnology|Health Care,13790001.0,USA,3,1,2532,13686,16218,1
Hardware + Software,64330.0,USA,1,1,0,15936,15936,0
Health and Wellness,700000.0,USA,2,2,122,15949,16071,0
Event Management|Events|Networking|Social Media Marketing,900000.0,ISR,2,5,617,15475,16092,0
Analytics,550000.0,ISR,1,1,0,16062,16062,0
Events|Mobile|Networking|Social Media,13751.0,GBR,1,1,0,16159,16159,0
Employer Benefits Programs|Employment|Human Resources,5500000.0,USA,1,1,0,12191,12191,0
Energy Efficiency|Public Relations,22500000.0,ISR,1,2,0,16574,16574,0
Software,13880000.0,USA,1,3,0,14193,14193,1
Analytics|Career Management|Enterprise Software,42497374.0,USA,4,8,1869,13907,15776,1
Algorithms|Physical Security|Public Safety,11819107.0,USA,1,4,0,15946,15946,0
Biotechnology,27500000.0,CHE,1,8,0,14589,14589,0
Biotechnology,9000000.0,USA,1,2,0,16664,16664,0
Financial Services|Retail|Software,441277.70488523797,GBR,1,1,0,13062,13062,0
Cloud Computing|Cloud Data Services|Cloud Security|Contact Centers|Customer Service|VoIP|Web Hosting,55346471.0,USA,4,6,2306,13896,16202,0
Travel & Tourism|Vacation Rentals,2700000.0,USA,1,1,0,15813,15813,0
Biotechnology,40000.0,USA,1,1,0,15175,15175,0
Entertainment|Games|Virtual Worlds,800000.0,USA,1,1,0,14092,14092,1
Entertainment|Service Providers|Television,120719.0,ESP,2,2,76,15264,15340,0
Software|Storage,8000000.0,USA,2,6,503,14184,14687,1
Biotechnology,40759840.0,DEU,3,3,3533,12418,15951,0
E-Commerce|Social Commerce,50000.0,USA,1,3,0,15075,15075,0
Big Data|Cloud Computing|Data Mining|Hardware + Software|M2M,150000.0,USA,3,3,487,14669,15156,0
Business Services,20000.0,RUS,1,1,0,15765,15765,0
News|Semantic Web,11849203.0,USA,3,3,1626,13879,15505,0
Technology,1050000.0,USA,3,1,426,16130,16556,0
SaaS|Sales and Marketing|Software,497000.0,GBR,1,2,0,16165,16165,0
CRM|Local|Mobile|Mobile Advertising|Real Time|Social Media Marketing|Social Media Monitoring,2200000.0,USA,2,6,628,15609,16237,0
Software,833000.0,DEU,1,1,0,13401,13401,0
Search|Travel,1248675.0,DEU,2,5,524,16084,16608,0
Internet|Wireless,40500000.0,USA,3,4,438,10876,11314,0
Banking|Finance|Financial Services|FinTech|Software,26100000.0,CHE,2,5,314,14818,15132,0
Information Technology|Security,35000000.0,USA,2,7,476,16231,16707,0
Hardware + Software,52474999.0,USA,4,9,1279,15294,16573,0
Personalization|Reviews and Recommendations|Software,13460000.0,GBR,2,4,255,13745,14000,0
Analytics|B2B|Enterprises|Machine Learning|News|Predictive Analytics|Retail|Reviews and Recommendations|SaaS|Sales and Marketing|Technology|Telecommunications,530000.0,LTU,2,1,306,15065,15371,0
Email Marketing|Marketing Automation|Software,188210000.0,USA,5,10,2469,12620,15089,1
Financial Services|FinTech|Hardware + Software|Point of Sale,12000000.0,USA,1,3,0,13703,13703,0
Biotechnology|Health Diagnostics,138845088.0,USA,18,37,4191,12431,16622,0
Advertising Networks|Internet Radio Market|Mobile|Personalization,1323710.0,FIN,2,3,158,16311,16469,0
Enterprise Software,77717024.0,USA,6,14,2849,12172,15021,0
Software,4400000.0,FRA,1,3,0,14264,14264,0
Databases|Search,15600000.0,FRA,1,1,0,13533,13533,1
Mobile,16801250.0,USA,2,3,2058,14292,16350,0
Algorithms|Big Data|Education|Marketplaces,80000.0,IND,1,2,0,16300,16300,0
Software,22700000.0,USA,3,2,1646,14551,16197,0
Storage,35000000.0,ISR,2,10,2028,11661,13689,1
Security,7660000.0,USA,1,6,0,13339,13339,1
E-Commerce|Online Shopping|Security,3562380.0,FRA,1,1,0,15706,15706,0
Big Data|Cloud Infrastructure|Information Technology|Internet of Things|Software,2729951.0,USA,2,2,255,16054,16309,0
Software,10000000.0,AUS,1,1,0,13991,13991,0
Games,10000000.0,USA,2,8,485,12784,13269,0
Biotechnology,15500000.0,USA,1,3,0,13844,13844,0
Biotechnology|Hospitality,1000000.0,CHN,1,1,0,13848,13848,1
Internet of Things|Technology,184385.0,ESP,3,3,244,15796,16040,0
Enterprise Software,17000000.0,USA,1,4,0,10917,10917,1
Consulting,10000000.0,IND,1,1,0,15853,15853,0
EdTech|Education,8620000.0,IND,1,1,0,14139,14139,0
Finance|Financial Services,12796166.0,JPN,5,8,2630,13939,16569,0
Advertising,14000000.0,GBR,2,4,4516,11528,16044,0
Commodities|Enterprise Software|Startups,75000.0,USA,1,2,0,15126,15126,0
Security,4030000.0,FRA,1,1,0,13679,13679,0
Fashion,18800000.0,USA,2,6,207,14916,15123,1
Biotechnology,9691322.0,GBR,3,3,1169,15246,16415,0
Curated Web,3300000.0,USA,1,14,0,15485,15485,1
B2B|Enterprises|SaaS|Sales and Marketing|Social Network Media|Software,250000.0,CAN,1,1,0,15949,15949,0
Education,6926100.0,USA,4,7,827,15539,16366,0
Games|Incubators,6700000.0,CAN,2,7,732,15652,16384,0
iPhone|Software|Sports|Windows Phone 7,3000000.0,USA,1,1,0,12418,12418,0
Advertising|B2B|Business Services|Career Management|Consulting|EdTech|Education|Employment|Enterprises|Internet|Recruiting|Sales and Marketing|Search|Software|Startups|Technology|Venture Capital,6500000.0,USA,1,1,0,16225,16225,0
Hardware + Software,16787546.0,USA,3,1,1109,14638,15747,0
Ad Targeting|Advertising|Big Data Analytics|Internet Marketing,32000000.0,USA,3,8,1820,13787,15607,1
Software,2000000.0,USA,1,1,0,15935,15935,1
Games|Software|Video Games,3000000.0,USA,1,2,0,13215,13215,0
Clean Technology|Design|Technical Continuing Education,128660.0,IRL,1,1,0,16171,16171,0
Analytics,12000000.0,USA,1,3,0,13396,13396,1
Consumer Goods|Health and Wellness,600000.0,USA,2,2,365,15706,16071,0
Real Estate,33000000.0,USA,1,1,0,16057,16057,0
Web Hosting,6500000.0,CAN,1,6,0,12871,12871,0
Auctions|E-Commerce|Facebook Applications|Mobile Commerce|Online Auctions|Social Buying|Social Commerce|Social Media|Startups,1030000.0,USA,2,1,857,15426,16283,0
Software,2610000.0,NOR,1,3,0,13634,13634,0
FinTech|Online Education,27748.8983687348,ROM,1,1,0,16626,16626,0
Information Technology|Services,62000000.0,USA,1,5,0,11953,11953,0
Cloud Computing|Finance|Insurance,10000000.0,USA,1,1,0,14118,14118,0
Sports,665000.0,USA,2,1,608,15371,15979,0
Consulting,40000.0,CHL,1,1,0,14957,14957,0
Software,271472.0,ITA,1,1,0,16007,16007,0
Health Care,1600000.0,ISR,1,1,0,16645,16645,0
Software,14000000.0,IND,1,1,0,13529,13529,1
Optimization|Software,25000000.0,USA,4,3,3329,12560,15889,0
Biotechnology|Life Sciences|Medical,20000000.0,DNK,1,6,0,12937,12937,0
Games,4610000.0,DEU,2,3,2601,13573,16174,0
Software,38400000.0,USA,5,9,3135,11971,15106,0
Curated Web,1625000.0,USA,2,4,638,15857,16495,0
Software,1500000.0,CAN,1,2,0,12971,12971,0
Education|Hardware|Hardware + Software|iPad|iPhone,2982410.0,USA,3,2,485,15692,16177,0
Collaboration|Content|Enterprises|Enterprise Software|Networking|Open Source|Portals|Social Media,7242588.0,USA,3,4,2122,14061,16183,0
Agriculture|Consumer Goods|Hospitality,1200000.0,USA,1,5,0,16336,16336,0
Biotechnology,7753929.0,USA,2,3,113,14831,14944,0
Biotechnology|Medical|Therapeutics,113106.0,PRT,1,1,0,16693,16693,0
Hardware + Software,63000.0,SWE,1,1,0,13816,13816,0
Biotechnology,22162918.0,GBR,8,25,2521,13930,16451,0
Biotechnology|Health Diagnostics,66083973.0,USA,4,12,1940,14740,16680,0
Aerospace|Collaboration|Information Technology|Services,15000000.0,USA,1,1,0,16738,16738,0
Messaging,500000.0,IND,1,2,0,15426,15426,0
Curated Web,50000000.0,USA,1,16,0,16143,16143,0
Mobile|Software,16560000.0,USA,3,3,831,11402,12233,1
Hardware + Software,63500000.0,USA,4,8,2876,11241,14117,1
B2B|Enterprise Software|Finance|Financial Services|Software,1051000.0,USA,6,14,306,16016,16322,0
Enterprise Software|Finance Technology|FinTech|Freemium|Mobile Enterprise|SaaS|Small and Medium Businesses,27200000.0,USA,4,15,2278,14365,16643,0
Analytics|Big Data|Business Intelligence|Marketplaces,1500000.0,USA,1,1,0,16590,16590,0
Digital Media|E-Commerce|Entertainment|Music,85000.0,CAN,3,1,203,15957,16160,0
Curated Web,4400000.0,USA,1,1,0,14435,14435,0
Analytics|Enterprise Software|Surveys|Text Analytics,13523540.0,USA,6,11,2455,13559,16014,0
Education,335000.0,IND,2,3,296,16036,16332,0
Crowdfunding|Technology,1230000.0,USA,4,29,680,15741,16421,0
Internet|Internet of Things,1000000.0,USA,1,6,0,16399,16399,0
Software,450000.0,ISR,1,1,0,12911,12911,1
Education,400000.0,USA,1,1,0,15651,15651,0
Consulting|Enterprise Software,5099999.0,AUS,2,4,553,16083,16636,0
Computers|Software|Technology,30000000.0,USA,1,2,0,10927,10927,1
Advertising|B2B|Events|Lead Generation|Media|SaaS|Software,2975000.0,CAN,4,5,986,15218,16204,0
Travel,30000.0,USA,1,1,0,12478,12478,0
Corporate Training|Promotional|Retail|Retail Technology|Training,18700001.0,USA,2,3,2688,13635,16323,0
Technology,8350000.0,TTO,2,6,381,11611,11992,0
Cloud Computing|Cloud Data Services|Consulting|Information Services|Information Technology|IT Management|Outsourcing|Services,162000.0,JOR,2,2,208,15262,15470,0
Electronics|Social Media,40016.0,IND,2,2,487,15715,16202,0
Crowdsourcing|Education,1310000.0,USA,1,4,0,16325,16325,0
Software,2000000.0,USA,1,4,0,16566,16566,0
Event Management|Ticketing,486433.0,IND,4,14,997,15748,16745,0
Health Care,55499998.0,USA,4,4,2458,13998,16456,0
Search,233000.0,FRA,1,2,0,14050,14050,0
Automotive,596301.0,USA,2,6,277,16436,16713,0
Social Network Media|Travel|Vacation Rentals,250000.0,USA,1,1,0,14245,14245,0
Analytics|Enterprise Software|Health Care,14050000.0,USA,2,3,281,14823,15104,1
Curated Web|Events|Internet Marketing,1000000.0,GBR,1,1,0,14995,14995,0
Curated Web|Reviews and Recommendations,6000000.0,USA,2,5,223,13502,13725,0
iPhone|Mobile,100000.0,USA,1,1,0,14984,14984,0
Advertising|Brand Marketing|Media|Music|Personalization|Sales and Marketing,478048.780487805,SGP,1,1,0,15828,15828,0
Cloud Data Services|Collaboration|Communities|Hardware|Software,2000000.0,USA,1,2,0,13803,13803,0
Big Data Analytics|Data Integration|Software,29050000.0,USA,4,8,1632,13695,15327,1
Telecommunications,3300000.0,FRA,1,1,0,16701,16701,0
Biotechnology,50000.0,USA,2,2,225,16441,16666,0
Services|Telecommunications|Wireless,9500000.0,USA,1,4,0,12488,12488,0
Finance,15000000.0,USA,1,2,0,13734,13734,1
Software|Video,33200000.0,USA,3,8,991,13223,14214,1
Enterprises|Health Care,16000000.0,USA,3,3,425,10987,11412,1
Hospitality|Hotels,565000000.0,USA,1,4,0,16021,16021,1
Advertising Platforms|Local Advertising|Online Video Advertising,4424998.0,USA,1,2,0,16555,16555,0
Web Hosting|Wireless,155900000.0,USA,2,5,616,14018,14634,0
Curated Web|Music,2750000.0,USA,3,9,640,14745,15385,1
Enterprise Software,3091125.0,GBR,2,6,1030,13202,14232,0
Biotechnology,3890000.0,ITA,1,2,0,14035,14035,0
Internet Marketing,19000000.0,USA,2,5,363,16049,16412,0
Finance,18657000.0,ITA,1,1,0,15490,15490,0
Enterprise Software|Information Technology|Networking,60100000.0,USA,3,9,1871,14348,16219,0
Consulting,5100000.0,USA,1,8,0,13018,13018,0
Software,7380000.0,USA,1,4,0,13608,13608,1
Design|Enterprise Software|Internet|Media|Networking|Services|Software,1455000.0,USA,8,11,541,14008,14549,0
Advertising,204632382.0,USA,9,9,2334,14267,16601,0
Software|Startups|Venture Capital,8800000.0,CAN,2,10,367,15370,15737,0
3D|Games|Motion Capture,18000000.0,ISR,2,3,746,15289,16035,0
Mobile,20600000.0,USA,4,10,1567,12732,14299,0
Curated Web|E-Commerce|Email,150000.0,GBR,1,1,0,15156,15156,0
Software,7500000.0,IND,1,1,0,14798,14798,0
Cloud Computing|Digital Media|Hardware + Software|Wireless,36500000.0,USA,4,11,1724,13675,15399,0
Health and Wellness,14000000.0,IND,2,5,404,16100,16504,0
Information Services,1000000.0,CAN,1,1,0,16679,16679,0
Ad Targeting|Advertising Platforms|Data Integration,38000000.0,USA,2,3,1150,12443,13593,0
Design|Information Technology|Video,30000000.0,USA,1,1,0,11078,11078,0
Biotechnology,3000000.0,USA,1,1,0,14053,14053,0
Augmented Reality|Consumer Electronics|User Experience Design|Wearables,21600000.0,USA,2,5,371,16379,16750,0
Logistics|Shipping|Software|Supply Chain Management,12284118.0,USA,1,2,0,16085,16085,0
Biotechnology,58443814.0,USA,9,11,2825,13454,16279,1
Mobile|Music|Social Media|Video,3550000.0,USA,3,18,684,15795,16479,0
Health Care,797439.0,USA,3,1,679,14676,15355,0
Brand Marketing|Crowdsourcing|Messaging|Sales and Marketing|Social Media|Software,9340000.0,FRA,6,10,1475,13149,14624,0
Software,1300000.0,USA,1,2,0,16092,16092,0
Information Technology|Privacy|Security,3000000.0,USA,1,1,0,16209,16209,0
Biotechnology|Health Diagnostics,7000000.0,USA,3,2,732,15548,16280,0
Consumers|Curated Web|Mobile|Mobile Shopping|Price Comparison|Retail|Shopping,2000000.0,USA,1,1,0,15257,15257,0
Human Computer Interaction|Retail Technology|SaaS|Virtual Worlds,1200000.0,USA,2,5,441,16080,16521,0
Advertising|Analytics|Artificial Intelligence|SaaS|User Experience Design,643300.0,DEU,1,2,0,15983,15983,0
Software,40000.0,USA,1,1,0,16052,16052,0
Software,10900000.0,ISR,2,3,465,15300,15765,0
Health and Wellness|Technology,28000000.0,CHN,1,1,0,16364,16364,0
Software,3700000.0,USA,1,2,0,13422,13422,1
Art|E-Commerce,4628057.0,GBR,2,1,1096,13149,14245,0
Medical,10670000.0,USA,1,4,0,12499,12499,1
Hardware + Software,4720000.0,BEL,1,1,0,14372,14372,0
Biometrics|Fraud Detection|Identity Management|Mobile Security|Security,10424729.0,USA,4,12,817,15485,16302,0
Advertising|Online Video Advertising|Video,35350000.0,USA,5,20,2360,14031,16391,0
Hardware + Software,15000000.0,USA,2,1,1487,15186,16673,0
Health Care|Life Sciences|Pharmaceuticals,6600000.0,ISR,3,2,1571,14975,16546,0
Biotechnology,1870089.0,GBR,1,5,0,14876,14876,0
Ad Targeting|Advertising Platforms|Big Data Analytics|Broadcasting|Digital Signage|Media|SaaS,1150000.0,SGP,2,5,609,16100,16709,0
Apps|Enterprise Software|Mobile,650000.0,USA,1,2,0,13879,13879,0
Content|Enterprise Software|Open Source|Web CMS,15698768.0,NOR,3,4,1370,13606,14976,0
Innovation Engineering,5592632.0,FRA,1,3,0,16460,16460,0
Enterprise Software,450000.0,ISR,1,1,0,13359,13359,0
Internet|Portals|Services,10000000.0,USA,1,1,0,13000,13000,0
Software,40000.0,PRT,1,1,0,15205,15205,0
Ad Targeting|Advertising|Big Data,8576699.0,USA,2,2,845,15126,15971,0
Curated Web|Hospitality|Office Space|Restaurants|Startups,34790000.0,USA,5,16,1462,15252,16714,0
Semiconductors,12116716.0,USA,3,1,2450,12173,14623,1
Consumer Internet|Health and Wellness|Health Care|Health Care Information Technology|Healthcare Services|Medical|Software,2500000.0,USA,1,1,0,15810,15810,0
Internet|Mobile Devices,246691.0,HKG,2,2,141,16225,16366,0
Cloud Computing|Enterprise Software|Printing,675150.0,DEU,4,4,1066,15126,16192,0
Fuel Cells|GreenTech|Hardware + Software|Internet of Things,3536085.25894458,DEU,1,3,0,14588,14588,0
Mobile,35000000.0,IND,4,10,1009,15645,16654,0
E-Commerce,165000.0,IND,1,2,0,16304,16304,0
Mobile|Monetization|Optimization|Software|Usability|Web Design,5600000.0,USA,1,3,0,16022,16022,0
Health Care,10000000.0,DEU,1,1,0,15708,15708,0
Restaurants,5000000.0,TWN,1,3,0,16450,16450,0
Brand Marketing|Games|Mobile|Photography|Social Media|Startups,150000.0,USA,1,1,0,15825,15825,0
Software,13185060.0,USA,6,3,1523,13679,15202,0
Health and Wellness,37550006.0,USA,2,1,806,13678,14484,0
Biotechnology|Pharmaceuticals,57247405.7105523,GBR,6,19,2480,13521,16001,0
Biotechnology,41741755.920578495,GBR,2,10,1479,14109,15588,0
Games,99310.0,JPN,2,1,1031,14643,15674,0
Health and Wellness|Pharmaceuticals|Specialty Retail,452898.0,DNK,1,1,0,16028,16028,0
Food Processing,20000000.0,IND,2,2,0,16475,16475,0
Apps|Design|E-Commerce|Marketplaces,336325000.0,USA,11,61,1292,14637,15929,1
Semiconductor Manufacturing Equipment,1600000.0,JPN,1,1,0,11971,11971,0
3D Printing|3D Technology|Graphics,64758.0,DEU,1,1,0,15645,15645,0
Furniture,500000.0,IDN,1,5,0,16623,16623,0
Health Care|Medical|Public Safety,4128628.0,FRA,1,1,0,16206,16206,0
Curated Web|Digital Media|E-Commerce|Health and Wellness|Subscription Businesses|Women,3500000.0,USA,1,12,0,16721,16721,1
E-Commerce,2600000.0,USA,1,2,0,15554,15554,1
Apps|Social Buying,9150000.0,JPN,1,2,0,16337,16337,0
Health Care,2048418.0,NLD,2,8,1850,14620,16470,0
Software,1500000.0,USA,1,2,0,16485,16485,0
Web Hosting,32340000.0,USA,2,9,986,12144,13130,0
File Sharing|Flash Storage|Hardware + Software|Storage,51300000.0,USA,4,8,607,13027,13634,1
Games,7000000.0,RUS,1,1,0,15949,15949,0
Internet|Mobile|SaaS,20000.0,GBR,2,2,383,14092,14475,0
Biotechnology,2000000.0,USA,1,3,0,14917,14917,0
Collaborative Consumption|Curated Web|Internet|Peer-to-Peer|Task Management,10000.0,USA,1,1,0,16476,16476,0
EBooks,777293.355315682,LVA,3,4,666,16015,16681,0
Hardware + Software|Productivity Software|Supply Chain Management,175000.0,CAN,3,2,781,15736,16517,0
E-Commerce|Enterprises|Enterprise Software|Legal|Manufacturing|Security,12546.0,EST,1,1,0,15599,15599,0
Health and Wellness|Health Care|Health Care Information Technology|Internet of Things,80952.0,ESP,2,1,127,16308,16435,0
Games,1400000.0,FRA,2,6,387,16230,16617,0
Photography,5300000.0,ISR,3,4,949,14302,15251,1
Games|Graphics|Toys,50000.0,PER,1,1,0,15309,15309,0
All Students|Colleges|Communities|Identity|Social Media,2425700000.0,USA,11,21,2333,12662,14995,1
Internet,2000000.0,GBR,1,1,0,16495,16495,0
Health Care,26321710.0,USA,5,7,2303,12418,14721,0
Service Providers|Social Network Media|Unifed Communications,70000000.0,USA,2,6,546,10987,11533,1
Big Data|Career Management|Human Resources|Software,300000.0,USA,2,2,276,15187,15463,0
Enterprises|Enterprise Software,163000000.0,CHN,4,10,1033,15584,16617,0
Entertainment,500000.0,USA,2,1,488,15896,16384,0
Curated Web,1200000.0,USA,1,2,0,14497,14497,0
Gps|Location Based Services|Maps,20228.0,MEX,1,1,0,16314,16314,0
Information Technology,1540000.0,USA,3,1,196,16526,16722,0
Software,4376255.0,DEU,2,2,1441,13308,14749,0
Software,2072000.0,GBR,2,5,661,13368,14029,0
Software,145000.0,USA,2,1,219,15885,16104,0
Software,2960000.0,USA,1,1,0,13755,13755,1
Manufacturing|Robotics|Startups,10000000.0,USA,1,2,0,16212,16212,0
Software,8000000.0,USA,1,3,0,12937,12937,1
Databases,27000000.0,USA,3,20,309,14643,14952,0
Analytics,60000.0,USA,1,1,0,14822,14822,0
Search,3500000.0,CHN,1,1,0,15979,15979,0
Financial Services,4250000.0,IND,3,4,278,16442,16720,0
Energy|Hardware|Manufacturing|Oil|Wholesale,500000.0,USA,1,1,0,13293,13293,0
Online Travel,2000000.0,USA,2,2,145,16462,16607,0
Hardware + Software,10085811.547558501,NLD,2,1,1187,15522,16709,0
Mobile|Telecommunications,510000.0,USA,1,1,0,16283,16283,0
Medical Devices,185000.0,USA,1,1,0,14046,14046,0
Renewable Energies,800000.0,ZAF,1,1,0,16625,16625,0
Finance|Nonprofits,1100000.0,USA,2,5,539,15959,16498,0
Game,272553.0,KOR,1,1,0,16427,16427,0
Services|Systems|Visualization,4200000.0,CAN,1,4,0,11369,11369,0
Games,2100000.0,HKG,1,3,0,15400,15400,0
Enterprises|Enterprise Software|Social Media,23719600.0,DNK,2,5,585,15933,16518,0
Auto|Clean Technology|Industrial|Innovation Engineering|Technology,145287897.0,USA,8,7,2009,14256,16265,0
Advertising|Marketplaces,1500000.0,USA,2,7,292,15949,16241,0
Artists Globally|Consumer Goods|Games|Identity|Music|Social Media|Social Network Media|Video,9700000.0,USA,3,2,1033,13665,14698,0
Media|News|Publishing,19252.0,CZE,1,1,0,16159,16159,0
Mobile,2020000.0,USA,3,5,1835,14356,16191,0
Internet,4091429.0,FRA,1,1,0,16216,16216,0
Photography,1300000.0,USA,2,7,506,15095,15601,1
Education|Internet|Web Development,273272.0,USA,3,3,1004,15522,16526,0
Hospitality,64330.0,ITA,1,2,0,16028,16028,0
Publishing,1167106.0,GBR,1,2,0,16601,16601,0
Social Network Media|Software,1807716.0,USA,3,2,874,13930,14804,1
Curated Web|Flash Sales,5750000.0,USA,1,1,0,14944,14944,0
E-Commerce,1000000.0,USA,2,2,1509,14981,16490,0
Social Media,984000.0,USA,2,3,500,15340,15840,1
Networking|Social Media,3650000.0,USA,2,4,208,13726,13934,0
Android|iPad|iPhone|Mobile|Software|Web Development,30210000.0,USA,4,22,956,15339,16295,0
Hardware + Software|Loyalty Programs|NFC|Payments|Point of Sale,5445135.0,FRA,2,5,615,16006,16621,0
Consumer Goods|Wine And Spirits,4000000.0,USA,1,1,0,15796,15796,0
Mobile|Social Media|Social Media Marketing|Software,25000.0,USA,1,1,0,15796,15796,0
E-Commerce,695000000.0,USA,4,6,1174,15498,16672,1
Mobile|Networking|Sports|Video,3500000.0,GBR,4,1,944,15268,16212,0
Curated Web,5000000.0,USA,1,1,0,14480,14480,0
Advertising|Facebook Applications|Social Media,106778.0,JPN,1,1,0,15069,15069,0
Content Discovery|Mobile|Mobile Advertising|Social Commerce|Social Media|Video,2693006.0,USA,2,8,426,16191,16617,0
Brand Marketing|Entertainment|Film|Games|Music|Sports|Television,2350000.0,USA,2,12,610,14304,14914,0
Software,20000.0,USA,1,1,0,14396,14396,0
E-Commerce,94583.0,CHL,2,3,362,15180,15542,0
Location Based Services|Social Media|Sports,217000.0,USA,2,2,6,15291,15297,0
Brand Marketing|Social Media|Social Media Marketing,100000.0,USA,1,1,0,13665,13665,0
Apps|Internet|Mobile|Social Media|Social Network Media|Sports,5118000.0,USA,4,16,631,15672,16303,0
Curated Web|Online Shopping|Social Media,124400000.0,USA,7,20,2080,14396,16476,0
Beauty|Digital Media|E-Commerce|Marketplaces,2192936.0,CHL,3,12,573,15435,16008,0
E-Commerce|Hospitality|Internet|Mobile|Wine And Spirits,150000.0,CHN,3,2,795,15718,16513,0
Entertainment|Technology,15300000.0,USA,1,1,0,12059,12059,1
Analytics|Lead Generation|SaaS|Social Media,2200000.0,USA,4,15,1133,15400,16533,0
Sports|Ticketing,525000.0,USA,1,3,0,15553,15553,0
Entertainment|Film|Subscription Businesses|Video|Video on Demand,7000000.0,USA,1,1,0,16743,16743,0
Fantasy Sports|Sports,361200000.0,USA,7,31,2811,13818,16629,0
Music,113800.0,BRA,4,1,774,15372,16146,0
Enterprise Software,34085228.0,USA,4,5,1797,12784,14581,1
Mobile,1515151.0,CHN,1,1,0,14975,14975,0
Advertising|Brand Marketing|Direct Marketing|E-Commerce|Events|File Sharing|Incentives|Internet Marketing|Loyalty Programs|Promotional|Publishing|Sales and Marketing|Social Commerce,1125000.0,USA,3,3,444,15293,15737,0
Hotels|Travel,1620000.0,CHN,1,1,0,16274,16274,0
Internet|Real Estate|Transaction Processing,304000000.0,CHN,3,5,1178,15535,16713,0
Mobile|Software|Startups,1052870.0,USA,9,10,304,14761,15065,1
Manufacturing,26000000.0,USA,4,11,1223,12084,13307,0
Web Development,1000000.0,CHN,1,2,0,15522,15522,0
Games,25000.0,USA,1,1,0,15796,15796,0
Mobile|Sports|Twitter Applications,650000.0,USA,2,7,182,15340,15522,0
Curated Web|Market Research|Online Shopping|Shopping,30000000.0,CHN,3,4,1389,15156,16545,0
Internet|Shared Services|Social Media,3000000.0,USA,1,1,0,13458,13458,1
Advertising|App Marketing|Messaging|SaaS|Small and Medium Businesses|Social Media Marketing,1000000.0,USA,1,1,0,15279,15279,0
Collectibles|Marketplaces|Mobile,53000.0,ITA,2,2,252,15720,15972,0
Sports,1900000.0,CHE,1,1,0,16700,16700,0
Ad Targeting|Big Data|Coupons|E-Commerce|Real Time|Software,2500000.0,USA,3,2,431,15290,15721,0
Advertising|Apps|Facebook Applications|Location Based Services|Photo Sharing|Sales and Marketing|Social Media|Twitter Applications,161987.0,POL,1,1,0,15706,15706,0
Advertising|Enterprise Software|Facebook Applications|Incentives|Lead Generation,1500000.0,USA,4,6,592,15197,15789,0
Concerts|Curated Web|Search|Sports|Theatre|Ticketing|Vertical Search,15700000.0,USA,3,7,261,14207,14468,0
Mobile|Sports|Ticketing,60000.0,USA,2,5,62,16252,16314,0
Educational Games|Games|Mobile Games|Online Gaming,800000.0,FIN,1,2,0,16205,16205,0
E-Commerce,40000.0,CHL,1,1,0,15638,15638,0
Fantasy Sports|Sports,385000.0,USA,1,1,0,15888,15888,0
Fashion|Retail|Shopping|Social Media,3563271.0,GBR,2,5,410,14952,15362,0
Games|Social Fundraising|Social Games|Sports,278000.0,USA,4,1,599,15918,16517,0
Curated Web,1390750.0,USA,3,6,265,16176,16441,1
Brand Marketing|Entertainment|Music|Publishing|Social Games,640020.0,IRL,2,3,356,14975,15331,0
Email|Messaging|Networking|SaaS|Social Media|Software|Web Development,1606357.0,GBR,2,1,162,16036,16198,0
Android|iOS|iPhone|Mobile,500000.0,USA,1,1,0,15079,15079,0
E-Commerce|Technology,678750.0,USA,4,1,562,15340,15902,0
Internet|Taxis|Transportation,40000.0,CHL,1,1,0,15327,15327,0
Gamification|Sales and Marketing|Social Media|Software,65000.0,ARG,2,2,188,15218,15406,0
Apps|Blogging Platforms|Facebook Applications|Forums|Sales and Marketing|Social Media|Software|Video|Web Tools,1000000.0,ISR,2,1,2467,12784,15251,0
Games|Mobile|Social Media,1330000.0,USA,3,3,773,15797,16570,0
Entertainment|Social Network Media|Social Travel|Sports,5500000.0,ISR,2,6,356,16273,16629,0
Software,4000000.0,USA,2,7,427,13879,14306,0
E-Commerce,1052500.0,USA,2,4,50,15533,15583,0
Clean Energy|Energy Efficiency|Software|Solar,2630000.0,USA,3,5,326,16149,16475,0
Bicycles|Consumer Goods|Transportation,3077268.0,USA,4,3,881,15553,16434,0
Information Technology,552254.0,EST,1,2,0,16645,16645,0
Finance|Transportation|Travel,20600000.0,USA,3,11,822,12692,13514,1
Travel,6000000.0,USA,1,1,0,12844,12844,0
Internet|Robotics|Software|Tracking,329023.0,IND,1,4,0,16324,16324,0
E-Commerce|Fashion,194500000.0,GBR,5,19,1699,14799,16498,0
Fantasy Sports|Games|Mobile Games|Sports,82353.0,USA,1,1,0,16097,16097,0
Agriculture|Big Data|SaaS,1400000.0,CAN,2,1,236,15949,16185,0
Agriculture|Cloud Data Services|Farming|Internet of Things,750000.0,ISR,1,1,0,16617,16617,0
Restaurants,1000000.0,USA,1,5,0,16455,16455,0
E-Commerce,390360.0,ESP,1,1,0,15711,15711,0
Biotechnology,514640.0,ITA,1,1,0,16027,16027,0
Software,46599.0,AUS,1,1,0,16287,16287,0
Advertising|Real Estate,1600000.0,NOR,1,1,0,15943,15943,0
Collaboration|E-Commerce|Internet|Startups|Technology,1264179.0,GBR,2,1,366,15923,16289,0
Agriculture|Analytics|Enterprise Software|Farming|Organic Food|SaaS,4065000.0,USA,5,28,1330,14883,16213,0
Agriculture|Big Data Analytics|Farming|Social Media,23900000.0,USA,3,5,404,16170,16574,0
Collaborative Consumption|Crowdfunding|Curated Web|Environmental Innovation|Farmers Market|Farming|Marketplaces|Organic Food|Sustainability,201759.572088518,GBR,5,5,972,15584,16556,0
Agriculture|Marketplaces,253001.51442196898,BGR,4,4,546,16102,16648,0
Consumer Goods|Green Consumer Goods|Hospitality,26000000.0,USA,3,8,2251,14457,16708,0
E-Commerce|Organic Food|Subscription Businesses,40000.0,USA,1,1,0,16076,16076,0
Agriculture,40000000.0,USA,1,4,0,16301,16301,0
Agriculture|Big Data|Software,15000000.0,USA,4,13,1021,15400,16421,0
Farming,1700000.0,JPN,1,4,0,16674,16674,0
Beauty|Cosmetics|Manufacturing,14841000.0,ITA,1,1,0,15450,15450,0
Agriculture|E-Commerce|Peer-to-Peer,2650000.0,USA,2,1,8,16209,16217,0
Fashion|News,134101.0,CYP,2,1,487,14700,15187,0
E-Commerce|Fashion|Lifestyle|Shopping|Social Buying,500000.0,NLD,1,3,0,14986,14986,0
Software,4000000.0,GBR,1,3,0,15979,15979,0
Analytics|Big Data|E-Commerce|Fashion|SaaS,1418000.0,USA,2,11,129,16325,16454,0
E-Commerce,15031860.0,USA,5,9,1582,14470,16052,0
Fashion|Finance,19500000.0,USA,5,17,889,15575,16464,0
E-Commerce|Fashion|Internet|Lifestyle|Retail,58000000.0,IND,3,10,1275,14952,16227,0
E-Commerce,40000.0,FRA,1,1,0,15380,15380,0
E-Commerce|Fashion|Mobile Commerce|Retail,9786.0,POL,1,2,0,16270,16270,0
Design|E-Commerce|Fashion|Marketplaces,200000.0,GBR,1,1,0,15509,15509,0
E-Commerce|Fashion|Sales and Marketing,6433333.0,MYS,3,1,945,15553,16498,0
Fashion,1000000.0,USA,1,8,0,14932,14932,0
Hospitality,4503100.0,ESP,1,3,0,15981,15981,0
Finance,31000000.0,RUS,2,2,225,15455,15680,0
Electronics,3001477.0,JPN,2,5,861,15818,16679,0
Finance|FinTech,69000000.0,USA,4,8,1892,14502,16394,0
Messaging|Mobile|SMS,275000.0,USA,1,3,0,14914,14914,0
FinTech|Payments|Social Commerce,23500000.0,SGP,4,9,1290,15340,16630,0
Mobile,45000000.0,USA,3,11,626,15831,16457,0
Curated Web,49800796.812749,FRA,1,2,0,13787,13787,0
Hardware + Software,8975002.0,USA,2,1,1386,14774,16160,0
Advertising|Curated Web,75000000.0,USA,1,3,0,12859,12859,1
Customer Service|Enterprise Software|Mobile,750000.0,USA,1,7,0,15225,15225,0
Content Delivery,129000000.0,USA,5,16,1677,14975,16652,0
Mobile|Technology,12000000.0,USA,1,3,0,12919,12919,1
Games|Technology,10110000.0,USA,3,8,819,13691,14510,0
3D Technology|Computer Vision|Semiconductors,314940.0,CHE,2,6,627,15898,16525,0
Finance|FinTech,12000000.0,USA,2,7,748,13600,14348,1
E-Commerce|Mobile Payments|Online Shopping,100000.0,IND,1,1,0,16728,16728,0
Internet|Software,5575000.0,USA,4,1,1912,13675,15587,1
Technology,3118603.0,NLD,2,1,1173,15340,16513,0
Clean Technology,32630837.0,USA,4,7,1152,13437,14589,1
Local|Maps|Social Network Media|Web Hosting,5500000.0,USA,1,1,0,13831,13831,0
Biotechnology,86188360.0,USA,6,10,2724,13846,16570,1
E-Commerce|Media,2000000.0,USA,1,7,0,16533,16533,0
Advertising,6000000.0,USA,1,1,0,12600,12600,1
E-Commerce,8000000.0,USA,1,3,0,12831,12831,0
Data Integration|Internet Technology|Optimization,3000000.0,USA,1,3,0,12251,12251,0
Finance,3500000.0,USA,1,2,0,14167,14167,0
Financial Services,750000.0,USA,1,1,0,16603,16603,0
Entertainment,25000.0,ARG,1,1,0,16314,16314,0
Curated Web|Web Tools,1500000.0,USA,1,3,0,12418,12418,0
Real Estate,2000000.0,IND,1,1,0,15340,15340,0
Software,35687.0,KOR,1,1,0,15922,15922,0
Blogging Platforms|Curated Web,712000.0,GBR,1,1,0,14293,14293,0
Internet,1805100.0,ITA,2,3,411,16281,16692,0
Social Media Marketing,10000.0,IND,1,2,0,16587,16587,0
E-Commerce,15000000.0,CHN,3,6,457,15065,15522,0
Fashion,1814380.0,USA,1,1,0,15607,15607,0
Design,1303116.0,GBR,1,2,0,16079,16079,0
Software,989000.0,GBR,1,1,0,13895,13895,0
Biotechnology,8209458.0,USA,3,1,95,14880,14975,0
Education|Toys,493847.0,BEL,2,3,750,15340,16090,0
Hospitality|Internet,1250000.0,USA,1,1,0,16399,16399,0
Enterprise Software|Human Resources|Mobile|SaaS,28000.0,USA,1,1,0,16120,16120,0
Software,7372073.0,GBR,2,4,728,15503,16231,0
Commodities|E-Commerce|Finance|FinTech|Governments|Marketplaces|Procurement,2000000.0,USA,2,4,2226,13131,15357,0
Finance,3000000.0,RUS,2,2,486,15551,16037,0
Publishing,4500000.0,USA,1,2,0,13752,13752,0
Analytics,3199451.0,USA,2,2,1199,15286,16485,0
Advertising|Brand Marketing|Business Development|Content|Digital Media,57450000.0,USA,4,16,1020,12950,13970,0
EdTech|Education,2000000.0,USA,2,4,190,16295,16485,0
Software,1200000.0,USA,1,5,0,16405,16405,0
Analytics,40000.0,BRA,1,1,0,15670,15670,0
Curated Web,8000000.0,USA,2,4,309,12570,12879,1
Cloud Computing|Enterprise Software|Mobile|PaaS|SaaS|Web Development,9000000.0,USA,1,5,0,15827,15827,1
Nonprofits|Specialty Foods|Waste Management,20000.0,USA,1,1,0,16191,16191,0
Analytics|Curated Web|Real Time|Web Tools,450000.0,USA,1,2,0,13883,13883,0
Enterprise Software,500000.0,CHN,1,1,0,13392,13392,0
Curated Web|Real Time|Reviews and Recommendations|Twitter Applications,130000.0,USA,1,1,0,14669,14669,1
E-Commerce|SaaS,7700000.0,ISR,2,8,307,16001,16308,0
Software,26132243.0,USA,4,8,1473,15100,16573,0
Specialty Foods,263369.0,GBR,1,1,0,15979,15979,0
Social Media|Teenagers,300000.0,USA,1,3,0,16353,16353,0
E-Commerce|Musical Instruments,301000.0,JOR,3,1,912,15371,16283,0
3D Printing|Fashion|Manufacturing|Technology|Wearables,1200000.0,USA,2,2,132,16374,16506,0
Finance,12250000.0,USA,3,4,743,15944,16687,0
Finance,25000000.0,CHN,3,4,640,15675,16315,0
Content Discovery|Content Syndication|Media|Video|Video Streaming,3120000.0,USA,3,5,137,16513,16650,0
Curated Web|E-Commerce|Media,1000000.0,IDN,2,3,1066,15327,16393,0
Manufacturing,16606502.0,USA,7,3,2149,14405,16554,0
Beauty|Fashion|Social Commerce|Women,25000.0,USA,2,2,213,15552,15765,0
Biotechnology,23500000.0,USA,3,2,452,14442,14894,0
Banking|Software|Transaction Processing,80429594.0,IRL,2,4,644,15986,16630,0
Biotechnology|Technology,243000.0,ESP,1,1,0,14879,14879,0
Batteries|Clean Technology|Mobile|Solar|Wind,12600000.0,USA,3,2,2217,14245,16462,0
Automotive,17832426.0,DEU,1,1,0,12431,12431,0
Computers|Medical Devices|Simulation,1505457.0,BEL,1,1,0,16456,16456,0
Advertising,135000.0,USA,3,1,492,15796,16288,0
Mobile|Semiconductors|Technology,2233120.0,IRL,1,2,0,14972,14972,0
Biotechnology,25501830.0,FRA,3,13,1661,14304,15965,0
Social Network Media|Software|Sports,20000.0,BRA,1,1,0,16495,16495,0
Apps|Mobile|Video|Video on Demand,2000000.0,USA,1,6,0,16548,16548,0
Biotechnology,30000000.0,USA,3,5,816,14564,15380,0
Health and Wellness|Health Care|Social Network Media,1700000.0,USA,2,1,1584,14418,16002,0
E-Commerce|Music|Online Travel,3760000.0,GBR,3,9,797,15527,16324,0
Health and Wellness|Health Care|Lead Generation,25000.0,USA,1,1,0,15863,15863,0
Apps,8500000.0,USA,3,3,510,16071,16581,0
Industrial Automation,23000000.0,USA,2,5,128,16475,16603,0
Ad Targeting|Advertising|Sales and Marketing,1000000.0,USA,1,3,0,13879,13879,1
Pets,4933907.0,USA,2,2,505,14286,14791,0
Social Network Media|Software,580000.0,SGP,1,2,0,15531,15531,0
Apps|Collaboration|Mobile|Productivity Software,443000.0,USA,4,3,516,15555,16071,0
Logistics,11000000.0,ARE,2,6,83,16595,16678,0
Enterprise Software,160922.0,GBR,1,1,0,15474,15474,0
Android|Curated Web|Entertainment|iPhone|Mobile Commerce|Social Media|Startups|Ticketing,22350902.0,USA,3,12,566,16197,16763,0
Innovation Engineering|Mining Technologies|Software,28753.0,AUS,1,2,0,15870,15870,0
Internet|Technology,365000.0,USA,7,6,1566,15096,16662,0
Banking|Finance,7730502.0,GBR,3,7,319,16048,16367,0
Curated Web,1700000.0,USA,1,1,0,13726,13726,0
Software,5425110.0,DEU,2,8,371,13007,13378,0
Technology|Wireless,8300000.0,USA,1,4,0,12090,12090,0
Apps|Personal Health,300000.0,USA,1,2,0,16240,16240,0
Nanotechnology,19910515.0,USA,4,8,1765,14822,16587,0
Internet|Service Providers|Telecommunications|Wireless,97200000.0,USA,1,1,0,15981,15981,0
Apps|Enterprises|Mobile|Security|Software,50000000.0,USA,1,5,0,12251,12251,1
Hardware + Software,3110000.0,PRT,1,1,0,13523,13523,0
Manufacturing,50000000.0,USA,1,1,0,14880,14880,0
Biotechnology,11210000.0,USA,3,2,753,15904,16657,0
Communications Infrastructure|Telecommunications|Wireless,150000000.0,USA,1,5,0,12978,12978,0
Analytics,42786202.0,USA,5,5,3618,12143,15761,0
Business Services|Entrepreneur|Trading,40000.0,CHL,1,1,0,15307,15307,0
Doctors|Enterprise Software|Health Care|Health Care Information Technology|Medical|Online Scheduling|Startups,875000.0,USA,2,2,495,15492,15987,0
Biotechnology,126023000.0,USA,3,15,3583,12831,16414,0
Games|Networking|Systems,10000.0,IND,1,1,0,16375,16375,0
Colleges|EdTech|Education|SaaS,10250000.0,USA,3,8,761,15065,15826,0
Enterprise Software,28415704.0,USA,3,9,1793,12919,14712,1
Health and Wellness,58340499.0,USA,4,2,468,15615,16083,0
Software,3000000.0,USA,1,2,0,12240,12240,0
Analytics|Artificial Intelligence|Natural Language Processing|Social Media Monitoring,1863000.0,USA,1,8,0,15903,15903,0
Business Services|Crowdsourcing|Enterprises|Information Technology|Market Research|Mobile|Retail,4500000.0,USA,2,2,719,15772,16491,0
Software,925000.0,USA,1,2,0,16156,16156,0
Software,36000000.0,USA,3,7,1682,14641,16323,0
Home Automation|Services,8900000.0,USA,1,6,0,12513,12513,0
Software,185287501.0,USA,3,9,3004,11904,14908,1
Construction|Enterprises|Mobile|SaaS,12635000.0,USA,4,18,889,15309,16198,0
Software,20000.0,USA,1,1,0,16671,16671,0
Freelancers|Software,30150000.0,USA,2,1,1507,15181,16688,0
Internet|Marketplaces|Mobile|Professional Networking|Soccer|Social Network Media|Sports|Technology,665600.0,SVN,1,1,0,15400,15400,0
Hospitality,5000000.0,CHN,1,1,0,15995,15995,0
Hardware + Software,1500000.0,USA,1,1,0,14791,14791,1
Enterprise Software,4750000.0,USA,2,6,544,14595,15139,0
Construction|Mobile|Productivity Software|Project Management|SaaS,7700000.0,USA,3,14,421,16314,16735,0
Curated Web|Events|Sales and Marketing,40000.0,USA,2,2,61,16222,16283,0
Software,3310000.0,IND,1,1,0,14573,14573,0
Games|Technology,10550000.0,USA,2,7,426,13453,13879,0
Software,45100000.0,USA,3,14,1080,15431,16511,0
Trading,40000.0,CHL,1,1,0,16222,16222,0
Games|Kids|MMO Games,2100000.0,USA,1,6,0,15400,15400,0
Games|Private Social Networking|Video|Video Chat,1300000.0,GBR,1,2,0,16040,16040,0
Information Technology|Innovation Management,17874996.0,USA,2,9,892,15880,16772,0
Banking|Credit Cards|Developer APIs|Finance|Finance Technology|Personal Finance,778660.0,DEU,3,8,1058,15684,16742,0
Health Care|Health Care Information Technology|Mobile Health|Photography,13150006.0,TUR,4,12,675,16048,16723,0
Apps|Mobile|Mobile Advertising,16749993.0,USA,3,4,865,14658,15523,0
Big Data|Enterprise Software|Health Care|Mobile Health,4471751.0,USA,5,5,827,15922,16749,0
Software,10900000.0,FRA,3,5,1123,12843,13966,0
Databases|Storage,120000.0,USA,1,1,0,16267,16267,0
Software,400000.0,CAN,1,1,0,12784,12784,0
Software,7500000.0,ISR,1,3,0,12157,12157,1
FinTech|Lifestyle|Productivity,2500000.0,USA,2,3,779,15584,16363,0
Collaboration|Enterprise Software|File Sharing|Tracking,10000000.0,CAN,1,3,0,15385,15385,0
Hardware + Software,9195002.0,USA,2,3,8,16176,16184,0
Apps,3250000.0,USA,1,2,0,16736,16736,0
Crowdfunding|Film|Finance,40000.0,CHL,1,1,0,16222,16222,0
Games|Personalization|Predictive Analytics|Social Television,769548.331562066,POL,4,6,1034,14853,15887,1
Consumer Internet|Curated Web|Digital Media|Digital Rights Management|Entertainment|Film|Online Shopping,300000.0,USA,1,1,0,15765,15765,0
Recruiting,88000.0,ESP,4,2,346,15866,16212,0
Software,12600000.0,USA,2,6,454,12815,13269,0
Information Technology|Social Media|Sports|Video,1305622.0,FIN,3,2,365,14975,15340,0
Agriculture,59956.0,CAN,1,2,0,16475,16475,0
Film,25000000.0,USA,1,1,0,16733,16733,0
Cloud Computing|Content Delivery|Digital Rights Management|Intellectual Asset Management,40000000.0,USA,3,7,772,15943,16715,0
Advertising|Digital Media|Social Media|TV Production|Video|Video on Demand,50000.0,USA,1,1,0,15593,15593,0
Consumer Electronics,559018.3637532489,ITA,1,1,0,16709,16709,0
Clean Technology,23700000.0,CAN,2,4,1004,15226,16230,0
E-Commerce,5010000.0,USA,4,3,660,16111,16771,0
Apps|Ediscovery|Entertainment|Games|iOS|iPad|iPhone|Mac|Music,1344657.37416625,AUS,2,2,283,14990,15273,0
Advertising|Content Discovery|Social Media Marketing,50000.0,ISR,1,1,0,16010,16010,0
Content|Curated Web|Finance|FinTech,1915000.0,USA,3,6,566,13726,14292,1
Information Technology|Services|Software,1701394.00882456,FIN,1,3,0,16727,16727,0
Electronics|Gadget|Software,200000.0,USA,2,1,133,16006,16139,0
Analytics|Machine Learning,4500000.0,USA,1,1,0,14588,14588,0
Financial Services,5527508.0,FRA,1,1,0,16184,16184,0
Billing|Credit Cards|Finance Technology|FinTech|Fraud Detection|Mobile Payments|Payments|Personal Finance|Security,1000000.0,USA,1,6,0,16462,16462,0
Construction|Innovation Management|Mobile|Systems,2859321.0,FRA,1,1,0,16247,16247,0
Customer Service|E-Commerce|Services,25300000.0,USA,2,11,545,11380,11925,0
Consumers|Internet|Services,300000.0,USA,1,2,0,16436,16436,0
Enterprises|Finance|Finance Technology|Financial Services|FinTech|Software,4164244.0,USA,5,1,1000,15093,16093,0
Analytics|Finance,7000000.0,USA,2,2,710,13665,14375,0
Banking|Finance|Financial Services|Mobile|Payments,21400000.0,CAN,7,7,3097,13634,16731,0
Financial Services,148323.0,FRA,1,1,0,15095,15095,0
Technology,8000000.0,USA,1,3,0,11562,11562,0
Finance,32027.0,GBR,1,1,0,15635,15635,0
Financial Services|Investment Management|Personal Finance|Retirement,2000000.0,USA,1,1,0,15901,15901,0
Finance|FinTech,35000000.0,IND,2,13,1012,13575,14587,0
Software,57000000.0,IND,1,1,0,16357,16357,0
Accounting|Cloud Computing|Enterprise Resource Planning|Software,186300000.0,USA,6,7,2002,14518,16520,0
Finance|FinTech|Insurance,8109015.0,DEU,2,4,502,15722,16224,0
Health Care,2400000.0,USA,1,2,0,11913,11913,0
Exercise|Fitness|Nutrition,5300000.0,JPN,2,6,346,16325,16671,0
Real Estate,25107.0,NLD,1,1,0,16375,16375,0
Finance Technology|Financial Services|Information Technology,69461.0,GBR,1,1,0,16196,16196,0
Software,330000.0,KOR,1,1,0,15573,15573,0
Education|File Sharing|Search|Video,250000.0,USA,1,1,0,13879,13879,0
Consumer Electronics|Electronics|Fashion|Price Comparison|Retail|Services|Sunglasses|Travel,13568.0,IRL,1,1,0,16101,16101,0
Mobile,9500000.0,USA,2,9,365,15021,15386,0
Education|Language Learning|Search|Sports,288000.0,USA,3,2,1261,15340,16601,0
Productivity Software|Search|Software,1000000.0,RUS,1,1,0,15918,15918,0
Curated Web,250000.0,USA,2,1,150,15718,15868,0
Analytics|Internet Marketing|Market Research|Predictive Analytics|Real Time|Search|Social Media|Social Media Marketing|Technology,127784.74678740301,GBR,2,4,275,16161,16436,0
Education|Information Services|Search,250000.0,IND,1,3,0,16400,16400,0
Consumers|Curated Web|E-Commerce|Internet|Startups,100000.0,IND,1,1,0,15905,15905,0
Databases|Information Services|Marketplaces,2500000.0,USA,2,3,557,16102,16659,0
Service Providers|Software|Training,38638911.0,GBR,1,1,0,16021,16021,0
Finance,13800000.0,MEX,1,2,0,15224,15224,0
Finance|Financial Services|Small and Medium Businesses,23783512.0,FRA,3,3,480,15912,16392,0
Education|Games|Mobile|Online Gaming,20000000.0,USA,3,8,1181,15065,16246,0
Credit,150000.0,RUS,1,1,0,16102,16102,0
Enterprise Software|Intellectual Asset Management|Intellectual Property|Internet|Network Security|Security|Software,42000000.0,USA,4,11,3449,12585,16034,1
Semiconductors,12200000.0,USA,4,5,1489,15030,16519,0
Analytics|Identity Management|Mobile,33020000.0,USA,4,11,2022,14036,16058,0
Finance|FinTech|Personal Finance,1546920.0,ESP,2,5,399,15672,16071,0
Software,25000.0,BRA,1,1,0,15522,15522,0
Legal,6500000.0,USA,1,5,0,13017,13017,1
Finance|FinTech|Personal Finance,505000.0,USA,1,1,0,14783,14783,0
Biotechnology,1922561.0,FRA,1,2,0,15890,15890,0
Finance|FinTech,8750000.0,USA,1,2,0,14198,14198,0
Developer Tools|Enterprise Software|Internet Infrastructure|Real Time,7000000.0,USA,2,11,392,15484,15876,1
Computers|Cyber Security|Network Security|Security,5100000.0,ISR,3,7,1295,14700,15995,0
Semiconductors,17035520.0,IRL,2,9,992,13266,14258,1
Computers|Network Security|Security,840945776.0,USA,7,35,3296,12784,16080,1
Biotechnology,3395000.0,USA,4,2,1004,15268,16272,1
Batteries|Clean Technology,31000000.0,USA,4,7,1462,12705,14167,0
Guides|Mobile|Social Media|Tourism|Travel,1090678.0,GBR,3,3,429,16104,16533,0
Apps|Entertainment|Games|Mobile Games,8000000.0,USA,1,3,0,16483,16483,0
News,327545.0,USA,1,2,0,16009,16009,0
Mobile,43300000.0,USA,3,6,656,12784,13440,0
Finance|FinTech|Mobile|Networking|Security|Software,6400000.0,ZAF,1,1,0,14859,14859,0
Security,12000000.0,IND,1,1,0,13242,13242,0
Curated Web,18000000.0,USA,2,3,442,15098,15540,0
Enterprise Software,980000.0,USA,1,1,0,13151,13151,0
Mobile,25131611.0,USA,3,2,307,13208,13515,1
Mobile,39790000.0,USA,4,8,2311,12206,14517,1
Photography,2000000.0,CHN,2,2,396,15522,15918,0
Billing|Finance|FinTech|SaaS|Software,19200000.0,USA,3,5,1156,13607,14763,0
Mobile,1707784.0,DNK,2,2,856,14970,15826,0
Entrepreneur|Information Security|Information Services,200000.0,RUS,1,1,0,15492,15492,0
Big Data|Predictive Analytics|Real Estate|SaaS,750000.0,USA,1,1,0,16611,16611,0
Curated Web,609539.0,GBR,1,1,0,15460,15460,0
Biotechnology,24000000.0,USA,3,10,911,15846,16757,0
Animal Feed,4600000.0,USA,1,1,0,16239,16239,0
Finance,14503750.0,USA,3,5,1424,13480,14904,1
Payments|Trading,3500000000.0,USA,1,1,0,16254,16254,1
Insurance|Insurance Companies|Services,8883295.0,FIN,1,3,0,12696,12696,0
Analytics|Predictive Analytics|Retail|SaaS|Software,23379267.0,USA,4,1,1389,15110,16499,0
Energy|Simulation|Universities,35519253.0,GBR,1,2,0,16664,16664,0
News,50000000.0,USA,1,1,0,16058,16058,0
Games|MMO Games|Virtual Currency|Virtual Worlds,501000.0,SGP,2,2,1886,13514,15400,0
Medical,3000000.0,USA,2,1,1205,15392,16597,0
Software,10000000.0,USA,1,1,0,15215,15215,0
Software,3767701.0,USA,3,1,988,14606,15594,1
Publishing,450000.0,USA,1,1,0,13784,13784,0
Sports|Systems|Wearables,121057.0,ESP,2,2,123,16191,16314,0
Biotechnology|Predictive Analytics|SaaS,5585000.0,USA,5,1,789,15559,16348,0
Clean Technology|Energy|Renewable Energies,566000000.0,USA,4,3,1819,13600,15419,1
Advertising,5000000.0,USA,2,4,406,13514,13920,0
Software,30775001.0,USA,4,6,2256,13830,16086,0
E-Commerce,65000000.0,IND,4,12,1150,15383,16533,0
Analytics|Energy Efficiency|Energy Management,43900000.0,USA,4,15,1294,15239,16533,0
Finance,23960000.0,GBR,1,1,0,13151,13151,0
Enterprise Software,13000000.0,CAN,2,4,399,12893,13292,1
College Recruiting|Colleges|Employment|Human Resources|Marketplaces|Recruiting,234355.0,CHL,7,7,730,15857,16587,0
Mobile,12000000.0,NGA,1,1,0,16142,16142,0
Analytics,77034731.0,USA,7,18,4450,11611,16061,0
E-Commerce,4200000.0,USA,1,1,0,14985,14985,0
Data Visualization|Enterprises|Enterprise Software|Governments|Legal|Predictive Analytics,18231500.0,USA,6,20,611,15857,16468,0
Advertising,19000000.0,USA,2,3,342,13623,13965,0
Big Data|Big Data Analytics|Curated Web|Leisure|Social Media|Social Network Media,10550000.0,SWE,3,17,685,15953,16638,0
Adventure Travel|Leisure|Travel,250000.0,ESP,2,2,462,15614,16076,0
Security,12000000.0,USA,1,1,0,12788,12788,0
Artificial Intelligence|Collaboration|EdTech|Education|Internet|Personalization,3000000.0,USA,1,4,0,16346,16346,0
Automotive|Clean Technology,1471000000.0,USA,9,20,1540,13892,15432,1
Banking|Finance|Loyalty Programs,50990429.0,USA,7,13,1391,14770,16161,0
Health Care,6013920.0,FIN,1,2,0,13328,13328,0
E-Commerce|Fashion,530000.0,TUR,1,1,0,15915,15915,0
Apps|Fitness|Health and Wellness,339623.0,GBR,2,2,196,16384,16580,0
Cloud Computing|Enterprise Software|Finance Technology|FinTech|SaaS|Technology,4000000.0,TUR,1,1,0,16316,16316,0
Health Care,2803022.0,USA,1,3,0,16666,16666,0
Hardware + Software,125000.0,USA,1,1,0,16121,16121,0
E-Commerce|Fashion|Private Social Networking,2400000.0,USA,2,5,134,16098,16232,0
Biotechnology,2200000.0,USA,1,2,0,15925,15925,0
Fitness|Hardware|Health and Wellness|Personal Health|Wearables,66000000.0,USA,4,15,1768,14162,15930,1
Fitness|Health and Wellness|Technology,20000.0,USA,2,2,53,15887,15940,0
Fashion,2300000.0,USA,2,1,415,16283,16698,0
Fitness|iPhone|Software,400000.0,GBR,1,1,0,14975,14975,0
Computer Vision|E-Commerce|Machine Learning|Shoes,510000.0,ISR,3,4,500,16028,16528,0
Software,4775000.0,USA,3,5,2324,12145,14469,0
Health and Wellness|Health Care|Technology,585000.0,USA,4,6,696,15799,16495,0
E-Commerce,100000.0,IND,1,1,0,16690,16690,0
Entertainment|Exercise|Fitness|Health and Wellness,14850000.0,USA,4,21,382,16093,16475,1
Fitness,68357.0,LVA,1,1,0,16059,16059,0
Hardware + Software,4120000.0,USA,2,1,733,15919,16652,0
Fitness|Gps|Health and Wellness|iPhone|Recycling|Software|Sports,11510000.0,USA,3,8,721,14578,15299,0
Digital Media|Enterprise Software|Fitness|Health and Wellness|Mobile,1510000.0,USA,3,5,622,15965,16587,0
Curated Web|Fitness|Games|Health and Wellness|Social Games,250000.0,USA,2,28,120,15706,15826,0
Consumer Internet|Fitness|Health and Wellness|Mobile|Training,3200000.0,USA,2,2,561,14417,14978,0
Apps|Fitness|Mobile|Travel & Tourism,45160.0,VEN,1,1,0,16043,16043,0
E-Commerce|Fashion|Retail Technology|SaaS,14250000.0,GBR,3,8,1493,14874,16367,1
Health and Wellness,5000000.0,USA,2,9,182,15694,15876,1
Fitness,1000000.0,IND,1,1,0,16639,16639,0
Internet,100000.0,USA,1,2,0,16436,16436,0
Apps|Mobile|Online Scheduling,25000.0,USA,1,1,0,15340,15340,0
Games,5000000.0,CHN,3,3,503,14258,14761,0
Biotechnology|Health and Wellness|Health Care,145540487.0,USA,6,13,3333,12822,16155,1
Electrical Distribution|Electronics,17722860.0,USA,4,10,2237,12335,14572,0
Enterprise Software|Technology,114100000.0,USA,8,19,3603,12536,16139,1
Collaborative Consumption|Curated Web|Freelancers|Marketplaces|Outsourcing|Services|Task Management,111000000.0,ISR,5,14,1989,14761,16750,0
Curated Web|Web Development,9200000.0,USA,2,2,787,13027,13814,1
Advertising|Loyalty Programs,42650000.0,USA,4,18,1363,14975,16338,0
Entertainment|Messaging|Software|Video,5000000.0,USA,2,2,185,13787,13972,0
Software|Testing,25000.0,RUS,1,1,0,15400,15400,0
Apps|Internet|Legal|Mobile|Parking,1850000.0,USA,2,13,194,16275,16469,0
Home Renovation|Mobile|Networking|Social Commerce,25000.0,USA,1,1,0,16130,16130,0
Security,31000000.0,CAN,5,14,1086,14641,15727,1
Mobile|SaaS|Wireless,11035782.0,USA,7,2,1911,13973,15884,0
Network Security|Security,162510.0,IND,1,1,0,16086,16086,0
Collaborative Consumption|Events|Mobile|Nightlife|Peer-to-Peer|Ticketing,1000000.0,GBR,1,1,0,16405,16405,0
Big Data Analytics|Networking,10000000.0,USA,1,1,0,16226,16226,0
Crowdsourcing|Curated Web|Customer Service|DIY|Professional Services,8000000.0,USA,2,4,442,13514,13956,0
Curated Web,305000.0,GBR,1,2,0,15820,15820,0
Software,550000.0,FIN,1,1,0,16201,16201,0
Biotechnology|Medical Devices|Nanotechnology,338834.0,BRA,1,1,0,11231,11231,0
Analytics|Curated Web|Gamification|Incentives|Weddings,150000.0,USA,2,1,266,15679,15945,0
Non Profit|Project Management,40000.0,USA,1,1,0,15574,15574,0
3D|Games|Software,50000.0,ARG,2,2,31,15553,15584,0
Games|Mobile Games,22684800.0,DEU,3,4,854,15372,16226,0
Internet|Mobile,31295270.0,ISR,4,14,1834,12079,13913,0
Mobile,1250000.0,USA,1,2,0,15602,15602,0
Information Technology,641137.520436259,FIN,1,1,0,16757,16757,0
Education,14220012.0,USA,4,23,876,15638,16514,0
Cyber|Cyber Security|Security,5000000.0,USA,1,5,0,16542,16542,0
Networking|Software|Storage|Virtualization,3000000.0,USA,1,2,0,15153,15153,1
Automotive|Entrepreneur|Finance|Health and Wellness|Incubators|Software|Venture Capital,1250000.0,USA,1,1,0,15857,15857,0
Brand Marketing|Photography|SaaS,1600000.0,CAN,2,1,512,16092,16604,0
Games,442906.0,KOR,2,2,687,15187,15874,0
Hardware + Software,593873.0,GBR,1,1,0,14173,14173,0
Services,16390.0,NLD,1,1,0,16529,16529,0
Colleges|Education|SaaS|Textbooks,40700000.0,USA,7,16,2274,14173,16447,0
Property Management|Rental Housing|Vacation Rentals,43889.0,CAN,1,1,0,16405,16405,0
Software,6750000.0,USA,2,4,421,13235,13656,0
Real Estate,2500000.0,IND,1,1,0,16616,16616,0
E-Commerce|Education|Peer-to-Peer|Travel,1500000.0,GBR,3,7,868,15371,16239,0
Hardware + Software,1660999.0,CHE,2,1,176,16107,16283,0
Hardware + Software,53408000.0,SWE,3,9,1448,14629,16077,0
Health and Wellness|Health Care,139443000.0,USA,3,11,606,15722,16328,0
Education|Web Development,14500000.0,USA,2,6,372,16169,16541,0
Clean Energy|Developer APIs|Home Automation|Internet of Things,1000000.0,AUT,1,4,0,16304,16304,0
Photography,760000.0,USA,3,7,1208,15459,16667,0
Nonprofits,2077120.0,SWE,1,2,0,15386,15386,0
Hospitality,514640.0,GBR,2,3,451,15888,16339,0
Apps,1125000.0,USA,1,2,0,16190,16190,1
E-Commerce,955981.0,GBR,3,1,405,16113,16518,0
Curated Web|E-Commerce|Ediscovery|Social Buying,6100000.0,FRA,1,2,0,16029,16029,0
Apps|Photography|Video|Video on Demand,2450000.0,ISR,2,8,551,15618,16169,1
Curated Web,507760.0,ITA,1,1,0,15653,15653,0
Finance|Mobile,118000.0,USA,1,1,0,15922,15922,0
Communities|Curated Web|Interest Graph|Photo Sharing,60000.0,USA,2,2,233,15989,16222,0
Messaging,1693302.0,EST,3,9,649,15946,16595,0
Health Care|Mobile,55800000.0,CHN,2,1,2132,13970,16102,0
Data Security|Fleet Management|Gps,2400000.0,USA,1,1,0,13403,13403,1
Business Services|Finance|FinTech,175000000.0,USA,2,4,1371,12971,14342,1
Automotive,1260000.0,PRT,1,1,0,13353,13353,0
Gps|Software,93000000.0,USA,2,4,848,14101,14949,1
Collaborative Consumption|Mobility|Transportation,260000.0,BRA,3,5,273,16314,16587,0
Mobile,5900000.0,USA,3,16,727,15644,16371,0
All Students|Education|Training,24480000.0,JPN,2,2,483,15887,16370,0
Design,7400000.0,USA,1,2,0,16734,16734,0
Pharmaceuticals,40000000.0,USA,1,9,0,16321,16321,1
Manufacturing,11000000.0,KOR,1,1,0,13066,13066,0
Logistics,6300000.0,USA,2,4,787,15964,16751,0
Web Hosting,24000000.0,SWE,1,3,0,15854,15854,0
Clean Technology,23700000.0,USA,4,3,1830,14589,16419,0
Information Technology,4459861.0,GBR,1,1,0,16522,16522,0
Energy,25500000.0,USA,1,3,0,16650,16650,0
Enterprise Software,10497161.0,GBR,2,1,135,15667,15802,1
Medical Devices,754000.0,ISR,1,1,0,13537,13537,0
Consulting|Freelancers|Marketplaces|Professional Services|Project Management,500000.0,IND,1,2,0,16734,16734,0
Apps|Billing|Content|Digital Rights Management|Games|Mobile|Wireless,2500000.0,GBR,1,1,0,16226,16226,0
Biotechnology|Health Care,107000000.0,USA,3,4,1595,14518,16113,1
Software,4000000.0,RUS,1,1,0,15936,15936,0
Networking|Optical Communications,18500000.0,USA,2,6,354,11897,12251,0
Finance|FinTech|Health and Wellness|Health Care,2570000.0,USA,4,9,875,15279,16154,0
Enterprise 2.0|Enterprise Software|Insurance|Logistics|Shipping|Shipping Broker Industry|Software Compliance|Supply Chain Management,26900000.0,USA,2,52,582,16071,16653,0
Big Data Analytics|Cloud Data Services|Curated Web|Email Marketing|Retail Technology|SaaS,1400000.0,USA,2,7,180,15988,16168,0
E-Commerce,109350000.0,USA,2,1,0,16506,16506,1
Software,185000.0,DNK,1,1,0,16084,16084,0
Finance|FinTech|Tourism|Travel,350000.0,USA,2,1,92,15187,15279,1
Electronics|Engineering Firms|Manufacturing|Networking,200000000.0,SGP,1,1,0,12114,12114,1
Bio-Pharm|Biotechnology|Medical,53200000.0,USA,2,3,93,16421,16514,1
Retail,4800000.0,NZL,1,3,0,16562,16562,0
Chat|Messaging|Mobile,1600000.0,USA,1,2,0,13573,13573,0
Legal|Travel,110000.0,HUN,2,1,305,15340,15645,0
Travel,20000000.0,CHN,2,2,334,14975,15309,0
E-Commerce|Online Rental|Travel,40428608.0,USA,6,36,1187,15523,16710,0
Travel,1300000.0,USA,3,4,206,14365,14571,0
Curated Web|Travel,800000.0,CAN,1,4,0,15489,15489,0
Online Scheduling,25000000.0,USA,1,5,0,11479,11479,0
Algorithms|Apps|Big Data|Digital Entertainment|Machine Learning|Reviews and Recommendations|Search|Social Media,1339000.0,USA,6,6,644,15765,16409,0
Internet|Mobile|Online Dating|Real Time,350000.0,USA,1,1,0,16247,16247,0
Education,70519.0,PER,2,2,209,16317,16526,0
Social Media Marketing,150000.0,ARG,1,2,0,15964,15964,0
All Students|Freelancers|Services|Social Media,1200000.0,USA,2,8,100,15991,16091,0
Mobile,20400000.0,USA,4,13,896,15469,16365,0
E-Commerce,850000.0,USA,1,4,0,15634,15634,0
Games,2934921.0,KOR,1,1,0,16224,16224,0
E-Commerce|Kids|Textbooks,335000.0,IND,2,2,401,15944,16345,0
Consumer Electronics|Hardware + Software|Internet of Things|Sports,185000.0,IND,3,5,177,16502,16679,0
E-Commerce|Electronics|Gadget|Marketplaces,380910.0,DEU,2,3,513,14860,15373,0
Photography|Video,70000000.0,USA,1,3,0,16632,16632,0
Advertising|Internet|Marketplaces|Travel & Tourism,25000.0,ARG,1,1,0,15553,15553,0
News,210500000.0,USA,5,29,1829,14810,16639,0
Crowdfunding|E-Commerce|Enterprise Software|Event Management|Nonprofits|Payments|SaaS,320000.0,USA,2,1,30,16314,16344,0
Education,250000.0,IND,1,2,0,16296,16296,0
Brand Marketing|Crowdfunding|E-Commerce|Internet Marketing|Peer-to-Peer|Social Fundraising,2000000.0,CAN,1,2,0,15608,15608,0
Social Media,17000000.0,USA,1,2,0,16490,16490,0
E-Commerce|Online Shopping,3151140000.0,IND,12,39,2399,14245,16644,0
Reviews and Recommendations|Travel|Vacation Rentals,500000.0,USA,2,4,263,13848,14111,1
Digital Media|Mobile|Television|Video on Demand,5840835.0,USA,4,8,856,15691,16547,0
Apps|Photo Sharing,2000000.0,USA,1,8,0,16386,16386,0
Mobile|Recycling,14000000.0,USA,1,3,0,14195,14195,0
Big Data|Curated Web|Polling|Social Media,60000.0,CHL,2,3,564,15385,15949,1
Big Data|Enterprise Software|Predictive Analytics|Software,8500000.0,USA,3,10,612,15153,15765,1
Curated Web,40000.0,USA,1,1,0,15538,15538,0
Audio|Broadcasting|Games|Music,150000.0,ARG,1,1,0,15107,15107,0
Games,13200001.0,USA,4,6,1286,13149,14435,1
Curated Web|Online Dating|Social Media,50000.0,USA,2,1,142,15229,15371,0
Mobile|Networking|Online Dating|Social Media,12951579.973392699,GBR,3,4,1255,13682,14937,0
Manufacturing,10000000.0,CHE,1,1,0,16598,16598,0
Advertising|Brand Marketing|Mobile Advertising|Technology,40999990.0,USA,3,6,1109,15530,16639,0
Android|Crowdsourcing|iOS|Translation,705903.0,KOR,1,1,0,15576,15576,0
Photography,5226555.0,CAN,5,4,1440,15273,16713,0
Entertainment|Networking|Social Media|Social Network Media|Video Streaming,7175000.0,USA,3,8,793,13180,13973,1
Application Platforms|Apps,1119232.0,SWE,3,10,305,16240,16545,0
Consumer Goods|Sustainability|Water,900000.0,USA,2,3,111,15785,15896,0
Advertising|Internet|Media|Product Development Services|Sports|Video|Video Streaming,8000000.0,USA,1,1,0,16317,16317,0
Big Data|Consumers|Travel,623500.0,SGP,3,5,317,15371,15688,1
Browser Extensions|Social Media|Software,28300000.0,USA,5,10,1237,12784,14021,1
iOS|iPhone|Software|Twitter Applications,127527.0,DEU,1,1,0,14916,14916,0
Advertising|Incentives|Small and Medium Businesses,1250000.0,USA,2,1,548,15443,15991,0
E-Commerce,1700000.0,RUS,2,1,430,15431,15861,0
Manufacturing,10598871.0,USA,1,3,0,16177,16177,0
FinTech|NFC|RFID,543000.0,USA,2,6,208,15340,15548,0
Consulting,296019.0,GBR,1,1,0,16344,16344,0
Social Media,475000.0,USA,2,2,117,15049,15166,0
Mobile,1359000.0,CAN,5,2,569,15706,16275,0
3D|Enterprises|Hardware|Real Estate|Software,7360000.0,USA,3,12,383,15675,16058,0
Accounting|B2B|Enterprise Software|SaaS,1350000.0,USA,2,4,394,15985,16379,0
Education|Marketplaces|Video,1060000.0,ESP,5,25,689,15369,16058,0
E-Commerce|Flowers|Specialty Retail,175000.0,COL,1,1,0,16157,16157,0
Communications Infrastructure,35000000.0,USA,1,1,0,11915,11915,0
Crowdfunding|E-Commerce|Logistics Company|Shipping|Software|Supply Chain Management,1200000.0,HKG,1,4,0,16685,16685,0
Sports,3000000.0,USA,1,1,0,16589,16589,0
Biotechnology,193679.0,GBR,1,1,0,15860,15860,0
Enterprise Software,1400000.0,USA,2,10,309,15035,15344,0
Medical Devices,5700000.0,USA,1,1,0,16573,16573,0
Games,2000000.0,USA,3,3,355,16040,16395,0
Entertainment|Games|Mobile,250000.0,CZE,1,1,0,15919,15919,0
Software|Video|Video Processing|Visualization,45000.0,POL,1,1,0,16071,16071,0
Health Care,30000000.0,USA,1,9,0,13755,13755,1
Chat|Collaboration|Information Technology|Internet|Messaging|Productivity Software|Real Time|SaaS|Software,650000.0,FIN,1,5,0,15248,15248,1
Curated Web|Digital Media,1300000.0,USA,1,8,0,13909,13909,0
Internet|Software,500000.0,USA,1,2,0,16531,16531,0
Internet Marketing|Real Time|Social Media Marketing|Social Media Monitoring,1000000.0,ARG,1,1,0,15455,15455,0
Enterprise Software|Hospitality|Restaurants|Software,130532.0,GBR,2,2,303,15706,16009,0
Enterprise Software|Messaging|Outsourcing,64000.0,USA,1,1,0,15949,15949,0
Clean Technology,5104587.0,GBR,1,1,0,16248,16248,0
Health Care,20600000.0,USA,2,9,393,12702,13095,1
Health Care,65000000.0,USA,3,5,901,15484,16385,0
Gambling|Games|Messaging|MMO Games|Virtual Worlds,5039999.0,USA,4,3,1207,13634,14841,0
Medical Devices,46182.0,DNK,1,1,0,16156,16156,0
Analytics,750000.0,USA,1,9,0,14846,14846,1
Design|Presentations|Software,750000.0,USA,1,1,0,16160,16160,0
Social Media,300000.0,GBR,1,1,0,14944,14944,0
Discounts|E-Commerce|Internet|Marketplaces|Retail|Social Commerce,2750000.0,GBR,4,2,1147,15065,16212,0
Bridging Online and Offline|Collaborative Consumption|Crowdsourcing|Local|Local Businesses|Logistics|Marketplaces|Mobile|Restaurants|Small and Medium Businesses,2300000.0,USA,2,6,397,16001,16398,0
Enterprise Software|Mobile|News|Social Media,2100000.0,USA,3,8,507,15077,15584,0
Curated Web|Facebook Applications|Photo Sharing|Social Media|Twitter Applications,700000.0,USA,3,5,228,15737,15965,0
Digital Media|Education,207358.0,GBR,2,3,406,15887,16293,0
Speech Recognition|Technology,414016.0,CAN,1,1,0,16556,16556,0
Artificial Intelligence|Natural Language Processing|Software,2000000.0,USA,1,1,0,16038,16038,0
Education|Language Learning|Marketplaces,410000.0,GBR,1,1,0,16160,16160,0
Biotechnology,18505332.0,USA,3,4,1419,15253,16672,0
E-Commerce,24000000.0,USA,1,1,0,15391,15391,0
Games|Kids|Virtual Worlds,3200000.0,USA,1,1,0,13950,13950,0
Diagnostics|Nanotechnology|Technology|Testing,50000.0,USA,1,1,0,16007,16007,0
Biotechnology|Life Sciences,2443430.0,GBR,1,5,0,16422,16422,0
Biotechnology,98203214.0,USA,6,31,2572,12423,14995,1
Cloud Computing|Databases|Enterprise Software|Information Technology|Personalization|Search,2654239.0,USA,3,13,974,14488,15462,0
Health Care,1550000.0,PRT,1,1,0,13060,13060,0
Health Care,35772451.0,USA,3,5,498,14704,15202,0
Curated Web,767000.0,DEU,1,3,0,13361,13361,0
Curated Web|Photography|Photo Sharing,10000.0,GBR,1,1,0,14356,14356,0
Specialty Chemicals,3000000.0,USA,1,4,0,12233,12233,0
Advertising|Mobile,73255000.0,USA,8,30,2672,13580,16252,1
Curated Web,600000.0,USA,1,7,0,14508,14508,1
Apps|Software,1400000.0,USA,1,9,0,15498,15498,1
Advertising Platforms|Events,170000.0,GBR,1,1,0,16287,16287,0
Advertising|Facebook Applications|Internet Marketing|Marketplaces|Photo Sharing|Social Media Marketing|Twitter Applications|Video Streaming,3446683.0,COL,4,3,554,16211,16765,0
Construction|Design|Product Design|Software,8000000.0,USA,2,3,0,16196,16196,0
Messaging|Software|Unifed Communications,102548.0,DEU,2,5,239,15922,16161,0
Biotechnology,9000000.0,USA,2,5,1808,13806,15614,0
Health and Wellness,27739937.010859802,DNK,3,8,2210,13117,15327,1
Big Data|Information Services|Information Technology|Non Profit,10200000.0,USA,1,2,0,16673,16673,0
Manufacturing,400000.0,USA,1,1,0,13398,13398,0
Advertising|Big Data|Software,2651558.0,NLD,1,1,0,15424,15424,1
E-Commerce|Fashion,40000.0,USA,2,1,4,15949,15953,0
Aerospace,6000000.0,USA,1,6,0,16574,16574,0
E-Commerce,40000.0,USA,1,1,0,15518,15518,0
iPhone,750000.0,USA,1,2,0,16574,16574,1
Apps|Automotive|Mobile|Public Transportation,20000.0,HKG,1,1,0,16236,16236,0
Consumer Electronics|Drones|Robotics|Security,2487512.6863147,CHE,2,4,288,16464,16752,0
Enterprise Software|Mobile Analytics|Mobile Software Tools|SaaS,4299999.0,CAN,3,5,788,15765,16553,0
Computer Vision|Location Based Services|Mobile|Social Media|Video,19177200.0,USA,7,2,1731,14755,16486,0
iPhone|Mobile,2100000.0,USA,2,2,568,13879,14447,0
Apps|Delivery|Hospitality|Local Businesses,2000000.0,USA,1,4,0,16056,16056,0
Analytics|Big Data|Cloud Computing|Databases,3055000.0,USA,3,12,970,15247,16217,0
Mechanical Solutions,14754.0,EST,1,1,0,15599,15599,0
Real Estate,40000.0,USA,2,2,403,15819,16222,0
Android|Apps|Productivity Software,20000.0,IND,1,1,0,16375,16375,0
Software,6629950.0,USA,3,4,2103,13910,16013,1
Apps|Customer Service|Restaurants,12444347.0,GBR,3,3,748,15884,16632,0
Big Data|Predictive Analytics|Travel,5342686.0,USA,3,25,454,16071,16525,0
Adventure Travel|Collaborative Consumption|Transportation|Travel,25000.0,USA,3,3,123,16099,16222,0
Development Platforms,40000.0,CHL,1,1,0,16222,16222,0
Big Data Analytics|Mobile Advertising,11000000.0,NLD,1,6,0,16616,16616,0
Blogging Platforms|Web Design|Web Hosting,1200000.0,USA,1,5,0,16318,16318,0
Automotive|Mobile|Public Transportation|Real Time|Transportation,34855000.0,USA,5,7,1800,14594,16394,0
Sports,108800000.0,USA,1,3,0,16177,16177,0
Field Support Services,6500000.0,USA,1,1,0,14964,14964,0
Logistics,49000000.0,USA,1,2,0,12159,12159,0
Biotechnology,480000.0,USA,1,1,0,14713,14713,0
Mobile|Photography|Startups,4583085.0,SWE,8,8,1133,15279,16412,0
Web Hosting,44500000.0,USA,1,2,0,11207,11207,0
Software,655000.0,USA,1,3,0,16122,16122,0
Hardware + Software|Local|Marketplaces|Mobile,1600000.0,USA,2,20,553,15631,16184,1
Game Mechanics|New Technologies|Sporting Goods,25000.0,GBR,1,2,0,15756,15756,0
Health and Wellness|Medical Devices|Pharmaceuticals,150000.0,USA,1,1,0,15949,15949,0
Medical|Medical Devices|Therapeutics,3500000.0,USA,1,2,0,16304,16304,0
Finance|FinTech,12170000.0,USA,1,3,0,13944,13944,0
Semiconductors,3520000.0,SGP,3,10,213,12449,12662,1
Blogging Platforms|Freelancers|Service Providers,20000.0,USA,1,1,0,16191,16191,0
Communications Infrastructure|Telecommunications,1385003.0,POL,1,2,0,16174,16174,0
Fitness|Health and Wellness|Mobile Health|Quantified Self|Sports,170000.0,USA,3,5,677,15994,16671,0
Real Estate|Software,250000.0,USA,1,2,0,16587,16587,0
Internet of Things|Mobile,8837884.0,USA,2,1,236,15348,15584,0
Development Platforms|Embedded Hardware and Software|Software,150000.0,USA,1,1,0,16273,16273,0
Fashion,50000.0,USA,1,1,0,16555,16555,0
Enterprise Software,2450000.0,CAN,2,10,76,16344,16420,0
Biotechnology,29000000.0,USA,1,7,0,14775,14775,1
E-Commerce|Personal Health,60000.0,USA,2,1,1417,13514,14931,0
Finance|FinTech,27500000.0,USA,3,4,1376,14099,15475,1
Finance|Investment Management|Market Research,5000000.0,USA,1,1,0,16421,16421,0
Biotechnology,24134998.0,USA,4,9,1039,13882,14921,0
Biotechnology,649650.0,SWE,1,1,0,15685,15685,0
Apps|App Stores|Business Intelligence|Consumer Electronics|CRM|Data Visualization|Mobile|SaaS|SEO|Software|Web Development,13862490.0,USA,2,5,233,16490,16723,0
Messaging,20500000.0,GBR,3,12,617,12836,13453,1
Content|Enterprise Software|Productivity Software|Social Media,4300000.0,USA,3,4,418,16191,16609,0
Software,1000000.0,USA,1,3,0,16542,16542,0
File Sharing|Mobile|Wireless,71735800.0,ESP,5,15,2905,13185,16090,0
Enterprise Software,46020414.0,USA,7,9,3436,12935,16371,0
Creative Industries|Crowdfunding|Crowdsourcing|Internet|Social Fundraising,40000.0,MEX,1,1,0,16222,16222,0
Curated Web|Location Based Services|Reviews and Recommendations,575000.0,USA,1,6,0,15279,15279,1
CRM|Enterprise Software|Mobile Analytics|Productivity Software|SaaS|Sales and Marketing|Social CRM,13050001.0,USA,2,1,434,16162,16596,0
Advertising|Android|Audio|Brand Marketing|Mobile|Sales and Marketing|Software,68856.0,IRL,2,1,424,15706,16130,0
Mobile|Music|Video Streaming,2075000.0,USA,3,4,1026,13392,14418,0
Mobile,6975497.0,GBR,1,1,0,13248,13248,1
Mobile,1819458.0,GBR,1,1,0,13326,13326,0
Consulting,2200000.0,USA,1,1,0,13613,13613,0
Communications Hardware|Messaging|Telecommunications,30000.0,USA,2,4,169,15262,15431,0
E-Commerce,25000.0,USA,1,1,0,14247,14247,0
Hospitality,110000.0,BRA,1,1,0,14946,14946,0
Apps|Curated Web|E-Commerce,2241305.0,CAN,4,12,832,15482,16314,0
Analytics|Startups,2275000.0,USA,3,16,839,15126,15965,0
Hardware + Software,5600000.0,USA,1,3,0,13752,13752,0
Hospitality,60000.0,FRA,1,1,0,15034,15034,0
Hospitality,5000000.0,USA,1,1,0,15870,15870,0
Delivery|Internet|Specialty Foods,1500000.0,PHL,1,2,0,15645,15645,1
Consumer Goods|Cooking|Hospitality|Publishing,9000000.0,USA,3,10,1733,14610,16343,0
Enterprise Software|Technology,7800000.0,USA,2,3,915,15095,16010,0
Social Media,500000.0,USA,2,2,128,15224,15352,0
B2B|Consumer Goods|E-Commerce|Retail,5000000.0,RUS,1,1,0,15796,15796,0
Delivery|Hospitality|Restaurants,875000.0,USA,3,3,1229,14610,15839,0
Analytics|Databases|Health and Wellness|Nutrition,4497921.0,USA,7,13,1183,15492,16675,0
Delivery|E-Commerce|Hospitality,622731.0,KOR,1,1,0,15390,15390,0
Cooking|Hospitality|Recipes,7720000.0,USA,2,2,1011,14785,15796,1
E-Commerce|Hospitality|Subscription Businesses,225155.0,DEU,1,3,0,15853,15853,0
Cooking|Hospitality|Recipes|Web Tools,1300000.0,USA,2,1,357,14350,14707,0
Blogging Platforms|Health and Wellness|Social Media,221000.0,USA,3,4,308,15774,16082,0
Consumers|Delivery|Hospitality,218000000.0,DEU,6,11,753,15802,16555,0
Guides|Hospitality|Local|Location Based Services|Startups,3750000.0,USA,2,11,138,14846,14984,1
Cooking|E-Commerce|Restaurants,50000.0,IND,1,1,0,16210,16210,0
Curated Web,19299.0,PRT,1,1,0,15922,15922,0
E-Commerce|Finance|FinTech|Handmade|Local|Marketplaces|Organic Food,1015000.0,USA,2,22,229,14000,14229,1
Big Data Analytics|Curated Web|Soccer|Social Media|Sports,19791.0,ITA,1,1,0,15706,15706,0
Search,1000000.0,CAN,1,1,0,13955,13955,0
Games,9900000.0,USA,1,1,0,14230,14230,0
Games|Location Based Services|Mobile|Soccer|Social Media|Sports|Startups,500000.0,NLD,1,1,0,14975,14975,0
Sports,902226.0,BGR,3,3,426,15584,16010,0
Games,4500000.0,GBR,3,3,1141,13910,15051,0
App Marketing|Coupons|Data Visualization|Email Marketing|Promotional|Social Media Marketing|Software,2722767.0,GBR,1,2,0,15674,15674,0
Online Shopping,300000.0,SWE,1,1,0,16679,16679,0
Curated Web,10000000.0,USA,2,2,564,13315,13879,0
Education,672000.0,IND,1,2,0,16626,16626,0
E-Commerce,4094366.0,SWE,1,1,0,15364,15364,0
Curated Web|iOS|iPhone|Location Based Services|Mobile|Social Media,500000.0,SGP,1,3,0,14863,14863,0
Customer Service|Information Technology|Internet|Real Time|Search|Shared Services|Social Media|Web Tools,1032.0,USA,4,2,5247,11323,16570,0
Entertainment|Games|Internet Marketing|Sales and Marketing|Video,1300000.0,USA,1,1,0,14167,14167,0
Education,187000.0,DEU,3,1,303,15832,16135,0
Events|Photography|Politics|Video|Video Streaming,8000000.0,USA,2,2,213,13787,14000,0
Computers,5390913.0,NLD,1,1,0,16545,16545,0
Sports|Young Adults,310500.0,USA,7,1,770,15918,16688,0
E-Commerce,255067782.0,USA,6,25,2503,12084,14587,1
Business Development|Mobility|Productivity Software|Sales and Marketing,3550000.0,ESP,1,1,0,16191,16191,0
Services,10500000.0,USA,1,1,0,12209,12209,0
Pharmaceuticals,15305146.0,FIN,1,2,0,16365,16365,0
Software,3850000.0,USA,3,2,2022,14113,16135,0
Network Security,45630000.0,USA,6,17,4687,11657,16344,0
Analytics|Customer Service|E-Commerce|Loyalty Programs,20000000.0,USA,1,3,0,13607,13607,1
Biotechnology|Chemicals,2573200.0,ESP,1,1,0,15955,15955,0
Consumer Behavior|Coupons|Discounts|Fashion|Lifestyle|Machine Learning|Sales and Marketing|Social Media|Technology|Women,40347.0,GBR,3,1,349,15706,16055,0
Hardware + Software,180000.0,USA,1,1,0,15280,15280,0
Enterprise Software,52000000.0,USA,3,6,839,15401,16240,0
Health Care|Medical Devices|Technology,9000000.0,USA,1,4,0,13850,13850,1
Clean Technology|Development Platforms|Innovation Management,4300000.0,DNK,1,1,0,16373,16373,0
Employment|Hospitality|Restaurants|Social Network Media|Startups,350000.0,USA,2,1,231,15979,16210,0
Consumer Goods|Food Processing|Logistics,873400.0,GRC,1,7,0,16532,16532,0
Cooking|E-Commerce|Restaurants,57000.0,USA,1,1,0,16737,16737,0
Biotechnology,42500000.0,USA,4,7,1607,13983,15590,0
Pharmaceuticals,2487198.24433065,BEL,1,4,0,13825,13825,0
Design|E-Commerce|Lifestyle,2825050.0,ARG,8,19,1001,15400,16401,0
Advertising,8849665.0,USA,4,1,1017,14425,15442,0
Software,18200000.0,USA,2,6,445,15807,16252,0
Software,7300000.0,USA,2,3,369,13924,14293,0
Analytics|SaaS|Software|Startups,1172451.0,GBR,2,3,3,16220,16223,0
3D Printing|Hardware + Software,23700000.0,USA,3,11,701,15301,16002,0
Curated Web|MicroBlogging|SaaS|Sales and Marketing|Social Network Media,14255000.0,USA,3,13,361,14624,14985,1
Hardware + Software|Information Technology,16876.0,IRL,1,1,0,16493,16493,0
Health Care,5720880.0,ESP,1,3,0,15602,15602,0
Banking|Commercial Real Estate|Document Management|Enterprise Software|Real Estate,200000.0,USA,2,1,17,16182,16199,0
Energy|Natural Gas Uses|Oil,17151400.0,USA,2,2,1162,14543,15705,0
Curated Web|Design|Social Network Media,205000.0,USA,1,7,0,15057,15057,1
Consumers|E-Commerce|Fashion|Outdoors,250000.0,USA,1,1,0,15706,15706,0
Biotechnology,67000510.0,USA,10,9,3076,13606,16682,0
Hardware + Software,396450.0,FRA,1,1,0,15456,15456,0
Enterprise Software,2100000.0,PAN,1,1,0,15624,15624,0
Software,8100000.0,USA,2,6,1346,13502,14848,0
Security,5120000.0,FIN,1,1,0,13915,13915,0
Analytics|Fraud Detection|SaaS,18000000.0,USA,3,5,282,16154,16436,0
Software,1200000.0,USA,1,3,0,14403,14403,0
Sporting Goods,800000.0,USA,1,7,0,16270,16270,0
Software,10000000.0,USA,2,2,686,13132,13818,1
Communications Hardware|Computers|Data Security|Enterprise Security|Information Security|Mobile Security|Network Security|Wireless,80000000.0,USA,2,6,186,12293,12479,1
Software|Virtualization,10000000.0,USA,1,2,0,13836,13836,0
Analytics,11500000.0,USA,3,6,1882,12965,14847,1
Public Relations,4170000.0,USA,1,1,0,13595,13595,1
Android|Apps|Data Security|Hardware + Software|Mobile Devices|Mobile Enterprise|Mobile Security|SaaS,1000000.0,USA,1,3,0,15492,15492,0
Security,2500000.0,USA,1,1,0,13641,13641,0
Analytics|Big Data|Machine Learning|Security|Software,16000000.0,USA,3,6,1026,15737,16763,0
Mobile|Mobile Commerce|Mobile Payments|Payments,10000000.0,EST,1,2,0,15758,15758,0
Financial Services,1000000.0,IND,2,5,333,15893,16226,0
Biotechnology,24000000.0,CHN,1,1,0,16307,16307,0
Employer Benefits Programs|Retirement|Small and Medium Businesses,3340000.0,USA,1,1,0,16418,16418,0
Health Care,13400000.0,IND,2,5,622,15457,16079,0
Curated Web|Forums|Lead Generation|Networking,642000.0,USA,2,2,335,15522,15857,0
Health Care,6028000.0,USA,3,3,1917,14531,16448,0
Computers,11149993.0,USA,1,3,0,16399,16399,0
Manufacturing,2511108.0,DEU,3,7,1053,15467,16520,0
Consumer Electronics|Finance|iOS|Mobile|Mobile Coupons|Wireless,350000.0,USA,1,2,0,15922,15922,1
Clean Technology,17580037.3862243,GBR,2,4,1480,14056,15536,0
Curated Web,30000.0,USA,1,1,0,14760,14760,0
Drones|Photography|Robotics,1250000.0,CHE,2,2,150,16467,16617,0
Advertising|Photography,225000000.0,USA,2,2,1111,14365,15476,1
Networking|Photography|Photo Sharing|Social Media,4099999.0,USA,1,2,0,13425,13425,1
E-Commerce|Photography,1822922.0,USA,3,7,906,14214,15120,1
Advertising|Crowdsourcing|Curated Web|Mobile|News,12662722.0,USA,5,7,1826,14061,15887,0
Photography,3500000.0,RUS,1,1,0,15584,15584,0
Mobile|Shopping,80000.0,ZAF,2,7,243,15400,15643,0
Health Care,96500000.0,USA,4,13,999,14714,15713,1
Biotechnology,18500000.0,USA,3,4,1904,14347,16251,0
Human Resources|Project Management|SaaS,50000.0,USA,1,1,0,15584,15584,0
Analytics|Databases,22650000.0,USA,2,3,691,15330,16021,1
Finance|Internet|Startups,6000000.0,CAN,2,1,540,14914,15454,0
Curated Web|Employment|Freelancers,4750000.0,USA,2,1,214,12539,12753,0
Home & Garden|Internet|Software,4000000.0,USA,2,3,115,16251,16366,1
E-Commerce|Fashion|Gift Card,25000.0,USA,1,1,0,16273,16273,0
Curated Web|Retail,350000.0,PHL,1,3,0,16325,16325,0
EdTech|Education,3500000.0,USA,1,1,0,13956,13956,0
Curated Web,12000000.0,IND,2,4,212,13545,13757,0
Software,1250000.0,USA,1,4,0,16589,16589,0
Internet,452000.0,IND,1,2,0,16757,16757,0
Location Based Services|Mobile,162350000.0,USA,6,28,1614,14491,16105,0
Hospitality,757625.0,GBR,1,1,0,15867,15867,0
Recycling|Service Providers|Services,2000000.0,IND,1,2,0,16701,16701,0
Art|Games|Graphics,117112117.0,KOR,1,1,0,16405,16405,0
Bio-Pharm|Medical|Pharmaceuticals,82690509.12204441,FRA,2,6,280,13585,13865,1
Software,16000000.0,USA,1,1,0,13423,13423,0
Hardware + Software,11000000.0,CYM,1,1,0,14546,14546,0
Fashion,40000000.0,CHN,1,1,0,13879,13879,0
Home Decor|Interior Design|Technology,1660000.0,IND,2,2,36,16485,16521,0
Consumer Electronics,2980000.0,IND,1,1,0,16604,16604,1
Analytics|Big Data|Business Intelligence|Consulting,25000000.0,USA,2,2,414,15880,16294,0
Advertising|Analytics|Internet Marketing|Social Media,5000000.0,USA,1,1,0,16497,16497,0
Intellectual Asset Management|Internet of Things|M2M,40000.0,CHL,1,1,0,16416,16416,0
E-Commerce,2470000.0,USA,5,5,1857,14457,16314,0
Manufacturing,7974455.0,ESP,1,2,0,12025,12025,0
Health Care|Medical Devices,91112449.0,USA,3,9,973,15785,16758,0
Direct Sales|Mobile|Software|Video,9150000.0,USA,6,3,2085,14610,16695,0
Game,19889.0,MEX,1,1,0,15918,15918,0
Social Network Media|Video,2200000.0,USA,1,9,0,16713,16713,0
Hardware + Software|Photo Sharing,7100000.0,USA,4,5,910,13826,14736,0
Consumer Goods|E-Commerce|Home Decor,11450000.0,USA,3,11,315,16289,16604,0
Analytics|Data Mining|Machine Learning|Predictive Analytics,2000000.0,USA,2,14,344,16071,16415,0
Android|Cloud Computing|Enterprise Software|iPad|iPhone|Mobility|Software|Tablets,16500000.0,USA,2,7,38,15314,15352,1
E-Commerce|Fashion,750000.0,USA,2,3,15,16265,16280,0
Fashion,20000000.0,CAN,2,14,693,15624,16317,0
Construction|Services,3012255.0,GBR,1,1,0,14671,14671,0
Mobile,600000.0,USA,1,1,0,16441,16441,0
Messaging,22300000.0,USA,3,4,378,15972,16350,1
Apps,600000.0,IND,1,1,0,16448,16448,0
Film Production,4249291.78470255,CAN,1,1,0,13522,13522,0
Big Data Analytics|Hardware + Software|Healthcare Services|Internet of Things|Machine Learning|Software,760000.0,KOR,5,3,527,15949,16476,0
Security,11000000.0,USA,1,2,0,13787,13787,1
Security,40000000.0,CHN,2,7,566,16010,16576,0
Software,457000.0,ZAF,1,1,0,12965,12965,0
File Sharing|Games|Graphics|iOS|iPhone|Kinect|Messaging|Mobile|Photography|Public Relations|Social Media|Video|Video Games,1200000.0,USA,3,4,666,15615,16281,0
Advertising,5414717.0,JPN,2,2,430,15775,16205,1
Health and Wellness,10000000.0,USA,1,3,0,14610,14610,1
Employment|Freelancers|Moneymaking,5000000.0,RUS,1,2,0,15646,15646,0
Software,12113690.0,GBR,12,5,2253,14326,16579,0
Advertising,895000.0,USA,2,1,378,15832,16210,0
Government Innovation,3000000.0,CAN,1,2,0,12024,12024,0
Mobile,3000000.0,USA,1,1,0,15670,15670,0
Advertising,15000.0,USA,2,2,203,15918,16121,0
Consulting,20000000.0,USA,1,2,0,13083,13083,1
B2B|Peer-to-Peer|Sales and Marketing|Software|Storage,255000.0,RUS,3,1,1064,14610,15674,0
Internet|Payments,113000000.0,IND,2,8,157,16314,16471,1
Fashion|Marketplaces|Mens Specific|Textiles|Women,13000000.0,IND,2,2,351,15187,15538,0
Collaboration|Messaging|Productivity Software|Project Management,224000.0,USA,2,5,283,16120,16403,0
Finance Technology|FinTech|Local Businesses,235000000.0,USA,2,2,145,16050,16195,0
Health Care,14710004.0,USA,5,2,2221,14362,16583,0
Beauty,1500000.0,USA,1,3,0,13600,13600,0
Enterprise Software,8160000.0,USA,2,6,647,13585,14232,0
Mobile|Reviews and Recommendations,59300009.0,USA,7,16,1211,15531,16742,0
Storage,20000000.0,USA,1,2,0,11230,11230,1
Accounting|B2B|Enterprise Software|Finance|Network Security,47200000.0,JPN,5,13,978,15693,16671,0
Electric Vehicles|Technology|Transportation,617771.0,GBR,2,2,115,16290,16405,0
Advertising,45000000.0,USA,3,11,1096,14637,15733,0
Web Hosting,3000000.0,NLD,1,1,0,16055,16055,0
Advertising,6000000.0,USA,1,3,0,15922,15922,0
Curated Web,2500000.0,USA,1,2,0,15607,15607,0
Semiconductors,17600000000.0,USA,1,1,0,13442,13442,1
Advertising,6963460.0,GBR,3,3,1090,14532,15622,0
Advertising|Diving|Transportation,16691.0,DEU,1,1,0,16627,16627,0
Curated Web,12000000.0,USA,2,7,3095,10266,13361,1
Advertising|Enterprise Software|Television|Video,45139996.0,USA,4,10,1704,13910,15614,1
Agriculture|Internet of Things|Mobile|Mobile Commerce|Technology,4900000.0,USA,3,6,660,15761,16421,0
B2B|Logistics|Shipping|Software|Supply Chain Management|Transportation,23300000.0,ISR,4,13,994,15693,16687,0
Digital Media|Mobile Games|Photography,685000.0,USA,2,3,40,16071,16111,0
Social Media,8000000.0,USA,2,5,153,13483,13636,0
3D|Consumer Internet|Entertainment|Games|Internet|Social Games|Virtual Currency,2000000.0,HKG,2,8,1065,15470,16535,0
Semiconductors,48000000.0,CAN,4,7,2169,12984,15153,0
Crowdsourcing|Events|Media|News,1475000.0,USA,3,9,260,16439,16699,0
E-Commerce|Groceries|Online Shopping|Organic Food,90999999.0,USA,3,2,3836,12326,16162,0
Delivery|Hospitality,500000.0,USA,1,1,0,15672,15672,0
Audio|Games|Video,8900000.0,ESP,1,1,0,13851,13851,0
Communications Infrastructure|E-Commerce|Online Identity,1100000.0,USA,2,3,867,15357,16224,0
Billing|Curated Web|Payments|Tracking,30000000.0,CAN,1,3,0,16274,16274,0
Customer Service|Customer Support Tools|Software,95051568.0,USA,6,10,1237,15308,16545,0
EdTech|Education,4300000.0,CAN,1,4,0,16297,16297,0
Internet,9000000.0,USA,2,4,124,16507,16631,0
Business Analytics|Business Intelligence|Business Services|Cloud Data Services|CRM|Software,1200000.0,SGP,1,1,0,15993,15993,0
Mobile Payments|Payments,500000.0,USA,1,1,0,16107,16107,0
Games,2250521.0,USA,3,3,1370,14579,15949,0
Analytics|E-Commerce|Optimization,2484999.0,USA,3,21,988,15126,16114,1
Apps|Mobile Emergency&Health|Social Media,700000.0,ESP,1,1,0,15419,15419,0
Concerts|Curated Web|Databases|Events|Location Based Services|Mobile|Music|Social Media,68852.0,DEU,2,1,1160,14426,15586,0
Cloud Computing|Mobile,5787150.0,USA,2,1,302,16358,16660,0
E-Commerce|Internet|Services,81462.0,CHL,1,2,0,16344,16344,0
Cooking|Delivery|E-Commerce,1100000.0,FRA,1,2,0,16749,16749,0
Software,6200000.0,USA,1,4,0,12821,12821,0
Social Media,4796229.0,CHN,3,2,122,15857,15979,0
E-Commerce|Emerging Markets|Fashion|Lifestyle|Surfing Community,650000.0,BRA,1,3,0,15796,15796,0
Curated Web|MicroBlogging|Social Media|Social Network Media,5000000.0,USA,1,12,0,14975,14975,1
Social Commerce,1200000.0,JPN,1,1,0,16757,16757,0
Enterprise Software|SaaS|Social Media|Web Tools,1500000.0,USA,1,4,0,14928,14928,0
Advertising|Blogging Platforms|Internet|Internet Marketing|Sales and Marketing|Social Media,250000.0,USA,1,1,0,15796,15796,0
Social Media|Social Network Media,5000000.0,USA,1,3,0,13935,13935,1
Advertising Networks|Ediscovery|iPhone|Location Based Services|Mobile|Private Social Networking|Social Media,35000.0,USA,1,1,0,14965,14965,0
Information Technology,395352.0,GBR,2,2,266,16272,16538,0
Contact Management|Curated Web|Networking|Social Media,15000.0,USA,1,2,0,15368,15368,0
Networking|Private Social Networking|Social Media,48500000.0,MYS,5,16,2074,12022,14096,1
Apps,500000.0,USA,1,2,0,16671,16671,0
Outdoors|Sports|Travel,750000.0,KOR,4,2,553,16037,16590,0
E-Commerce,500000.0,IND,2,2,582,15708,16290,1
Developer APIs|Email|Facebook Applications|Messaging|Mobile|Search|Twitter Applications|VoIP|Wireless,30000000.0,ISR,4,13,1910,13208,15118,1
Advertising,3530000.0,JPN,1,5,0,16487,16487,0
Advertising|Postal and Courier Services|Startups,75000.0,IND,1,2,0,15492,15492,0
Education|Risk Management|Training,50000.0,USA,2,1,796,15706,16502,0
Customer Service|Fashion|Online Shopping|Retail,438862.0,IRL,5,5,730,15737,16467,0
Search,3109276.0,KOR,2,3,518,15484,16002,0
Mobile,2900000.0,USA,3,1,1914,14729,16643,0
Games|Social Games,1286600.0,ESP,1,2,0,16035,16035,0
Apps|B2B|Email|Software,3250000.0,USA,3,18,334,16010,16344,0
Mobile|Online Scheduling|Payments|SaaS,11200000.0,USA,3,17,469,15954,16423,0
Android|Entertainment|Incentives|iPhone|Loyalty Programs|Mobile|QR Codes|Sales and Marketing,7700000.0,USA,2,3,389,15340,15729,0
Data Centers|Educational Games,6600000.0,USA,2,8,575,16084,16659,0
Nonprofits,16000000.0,USA,1,4,0,13970,13970,0
Fashion,344853.0,GBR,2,2,396,15553,15949,0
Curated Web|Finance|Identity,3910000.0,USA,2,20,504,15503,16007,0
Finance Technology|Financial Services|FinTech|Hedge Funds|Wealth Management,1885043.0,NOR,3,1,1064,15584,16648,0
Business Intelligence|Business Services|Information Services,380133.0,GBR,1,1,0,15857,15857,0
Semiconductors,59360455.771957204,GBR,2,13,687,12842,13529,0
Analytics|Emerging Markets|Information Services|Market Research,11400000.0,USA,1,2,0,14944,14944,0
E-Commerce,40000.0,CHL,1,1,0,15301,15301,0
SaaS|Sales and Marketing|Software,478000.0,USA,2,1,197,15896,16093,1
Digital Media|Mobile|Mobile Coupons|News,18000000.0,USA,2,10,680,15902,16582,0
Internet|Software|Web Design,688629.0,LVA,1,2,0,16161,16161,0
Social Media,245000.0,IND,2,8,273,15908,16181,0
E-Commerce,97100000.0,USA,5,4,2227,13670,15897,0
E-Commerce|Health and Wellness|Organic Food|Specialty Foods,1618000.0,IND,3,5,417,16314,16731,0
Curated Web,140000.0,USA,1,1,0,15248,15248,1
Education|Mobile|Parenting|Tablets,330000.0,POL,2,1,320,15706,16026,0
E-Commerce,80000000.0,CHN,3,6,1605,14975,16580,0
Cloud Computing|Consulting|Enterprise Software|Information Technology|IT Management|Services,17484065.0,USA,3,1,570,15692,16262,0
Curated Web|Education|High Schools,20000.0,USA,1,1,0,15065,15065,0
Sports,1882200.0,FIN,1,2,0,12926,12926,1
Clean Technology,70475450.0,USA,6,19,1745,14452,16197,0
E-Commerce,5375000.0,USA,5,5,1224,14816,16040,0
Enterprise Software,517000.0,USA,1,1,0,15765,15765,0
Software,1775000.0,USA,2,2,516,15931,16447,0
Public Safety|Security,25000000.0,ISR,3,2,621,15945,16566,0
Curated Web|FinTech|Payments,6000000.0,USA,1,2,0,14305,14305,0
Clean Technology,52750000.0,USA,3,2,897,14035,14932,0
Software,14060000.0,USA,3,9,1893,14012,15905,0
Games,413612.0,ITA,3,4,1330,15034,16364,0
Sports|Subscription Service|Television,5575000.0,USA,3,8,246,16405,16651,0
Enterprises|Enterprise Software,5000000.0,USA,1,5,0,12740,12740,0
Social Media,1500000.0,USA,1,1,0,13949,13949,0
Consumers|Gas|Services,214527.0,GBR,1,1,0,16255,16255,0
3D|3D Technology|Hardware + Software,13249402.0,USA,5,5,770,15952,16722,0
Information Services,524260.0,NLD,2,1,152,15797,15949,0
E-Commerce,40000.0,CHL,1,1,0,15784,15784,0
Enterprise Software,66248970.0,USA,5,9,2271,13910,16181,0
Hardware + Software,80000000.0,CHN,1,1,0,14559,14559,0
Analytics|User Experience Design|Video,12100000.0,USA,2,21,392,16254,16646,0
Clean Technology,6000000.0,CHN,1,1,0,14201,14201,0
Farming|Food Processing,400000000.0,CHN,1,1,0,16308,16308,0
Clean Technology,119000000.0,USA,4,3,2620,13997,16617,0
Semiconductors,81017493.0,USA,4,17,1771,12912,14683,1
Health Care|Medical|Pharmaceuticals,8000000.0,USA,1,2,0,12593,12593,0
Software,12000000.0,USA,2,3,801,12615,13416,0
Software,3800000.0,USA,1,3,0,16314,16314,0
Education,5500000.0,USA,1,2,0,16545,16545,0
Machine Learning,10000000.0,USA,1,1,0,16386,16386,0
Digital Media|Services|Technology,1125000.0,USA,2,4,487,15949,16436,0
Education,27900048.0,USA,4,3,1526,15077,16603,0
Business Services|Finance|Small and Medium Businesses,1500000.0,USA,1,1,0,16080,16080,0
Location Based Services|Social Media|Social Search,3500000.0,USA,2,1,524,15034,15558,0
Contact Management|Databases|Developer APIs|Enterprise Software|Search,18868000.0,USA,4,26,1277,15187,16464,0
Big Data Analytics|Mobile Analytics,3100000.0,JPN,2,9,801,15692,16493,0
Digital Media|News,30000000.0,USA,2,4,593,15280,15873,1
Internet,11897854.0,USA,2,4,321,16267,16588,0
Building Products|Manufacturing|Service Providers,30000000.0,TWN,1,1,0,14109,14109,0
Semiconductors,12350000.0,USA,1,5,0,13209,13209,0
Cloud Data Services|Mobile|Synchronization|Wireless,42850000.0,USA,3,9,2176,13530,15706,0
Health Care,10400000.0,CAN,1,2,0,15264,15264,0
Finance Technology|FinTech|SaaS,178941.0,IRL,3,5,176,16199,16375,0
Real Estate,40000.0,USA,1,1,0,16594,16594,0
Education,38964.0,ZAF,1,1,0,16631,16631,0
E-Commerce,3000000.0,USA,1,1,0,13879,13879,0
Finance,5150000.0,ZAF,1,1,0,13704,13704,1
Finance|Finance Technology|FinTech,2728967.0,USA,2,4,246,15792,16038,0
Business Analytics|Enterprise Software|Payments|Software,107500000.0,USA,3,22,518,16170,16688,0
Crowdfunding|Crowdsourcing|Finance|Finance Technology,540000.0,SWE,2,1,172,16149,16321,0
Finance,14900000.0,USA,3,17,624,16071,16695,0
Big Data Analytics|Business Intelligence|Market Research|Startups|Trading,2147583.66907468,EST,5,7,822,15901,16723,0
Software,67868.0,LVA,1,1,0,16042,16042,0
Finance,6500000.0,USA,1,27,0,15632,15632,0
Finance|Financial Services|Personal Finance,273237070.0,USA,6,16,1895,14652,16547,0
B2B|Enterprises|Finance|FinTech|Small and Medium Businesses,4734777.0,GBR,3,6,1141,15435,16576,0
Colleges|Crowdfunding|Education|Health and Wellness|Nonprofits|Payments|Politics|Social Fundraising|Social Media|Software,7800000.0,USA,4,18,454,14791,15245,1
Curated Web|Finance|Nonprofits,1450000.0,USA,2,2,212,14975,15187,0
Crowdfunding|Finance|Finance Technology|FinTech|Investment Management|Real Estate,40985000.0,USA,5,11,1364,14975,16339,0
Finance|Financial Services,15412000.0,IND,3,6,1813,14791,16604,0
Financial Services,5000000.0,USA,1,2,0,11971,11971,0
Financial Services|Small and Medium Businesses,2200000.0,USA,1,5,0,16490,16490,0
Application Platforms|Education|Language Learning,38221.0,AUS,1,3,0,16405,16405,0
Games,217320.0,ITA,1,1,0,15156,15156,0
Customer Service|E-Commerce|Fashion|Sales and Marketing,300000.0,ESP,1,2,0,15870,15870,0
Mobile,719734.0,DNK,3,2,576,15950,16526,0
Development Platforms|Gamification|Services,2850000.0,CAN,2,6,294,15779,16073,0
Photography,2000000.0,CHN,2,3,700,12600,13300,0
Games,3050000.0,USA,3,1,526,15033,15559,0
Sporting Goods,40898.0,IRL,1,1,0,16111,16111,0
SaaS|Sales and Marketing|Software,800000.0,USA,1,1,0,15706,15706,0
Advertising|E-Commerce|Performance Marketing|SaaS|Sales and Marketing|Software,555000.0,USA,2,4,91,16283,16374,0
Celebrity|Entertainment|Games|Video,18000000.0,USA,4,5,632,13604,14236,0
Games|Social Media,87000000.0,CHN,2,5,807,15340,16147,0
Mobile,40000.0,CHL,1,1,0,15561,15561,0
Games,6000000.0,USA,1,2,0,13514,13514,0
Photography,4000000.0,USA,1,2,0,13318,13318,0
Biotechnology,12200000.0,GBR,1,3,0,14756,14756,0
Communities|Entertainment|Leisure|Social Media,1500000.0,ISR,1,1,0,16622,16622,0
Games,20000000.0,USA,1,3,0,15099,15099,1
Internet,400000.0,IND,1,1,0,16700,16700,0
Manufacturing|Natural Resources|Oil & Gas,160000000.0,USA,1,1,0,16272,16272,0
Advertising|Enterprise Software|Online Video Advertising,550000.0,USA,1,4,0,16283,16283,0
Publishing|Television|Video,1126000.0,ISR,1,12,0,16575,16575,0
Consumers,6000000.0,IND,1,1,0,16517,16517,0
Curated Web|E-Commerce|Online Reservations|Online Travel,1450000.0,USA,2,1,618,16075,16693,0
E-Commerce|Furniture|Home & Garden|Lighting,250000.0,USA,1,1,0,15248,15248,0
Consumer Electronics|Embedded Hardware and Software|Sporting Goods|Wearables,1300000.0,USA,2,5,280,16343,16623,0
Software,6300000.0,NOR,2,4,229,16233,16462,0
Advertising Platforms|Mobile|Mobile Advertising|Mobile Games,13000000.0,USA,3,6,1370,14791,16161,0
Education|Internet|Social Media,10000000.0,GBR,1,1,0,16604,16604,0
Billing|Finance|Payments,4324801.95299834,CAN,3,3,1238,15416,16654,0
Software,19000000.0,CAN,2,2,630,12536,13166,1
Sports,290000.0,USA,1,1,0,16156,16156,0
Biotechnology,2500000.0,GBR,1,5,0,13720,13720,0
Clean Technology,1151209.0,USA,2,4,28,15693,15721,0
Enterprise Software|Software,111500000.0,USA,3,14,751,13969,14720,1
Design|Graphic Design|User Experience Design,7500000.0,USA,1,1,0,13829,13829,0
Finance,12800000.0,IND,2,4,905,15706,16611,0
Telecommunications,100000.0,USA,1,1,0,13342,13342,0
Media|Mobile|Software|Video,213900.0,POL,1,1,0,15186,15186,0
Mobile,50000.0,SGP,1,2,0,13514,13514,0
Mobile,6000000.0,USA,1,3,0,13935,13935,0
Analytics|SaaS|Subscription Businesses,18656544.0,USA,5,3,5197,11323,16520,0
Software,15000000.0,USA,1,1,0,13423,13423,0
Banking|Financial Services|Internet,300000.0,RUS,1,2,0,16062,16062,0
Blogging Platforms|Service Providers|Social Media,500000.0,RUS,1,1,0,15340,15340,0
Discounts|Hardware + Software|Technology,1350000.0,ESP,1,2,0,13647,13647,0
News,2630000.0,FRA,1,1,0,14825,14825,0
Advertising|Mobile Advertising,1953659.0,GBR,3,8,583,15675,16258,0
Design|Governments|Technology,1653913.0,GBR,1,1,0,16071,16071,0
Home Decor|Home Renovation|Lifestyle|Smart Building,2713339.0,NOR,4,3,762,15885,16647,0
CRM|Tracking,8259410.0,USA,2,5,458,15012,15470,0
Finance|Financial Services|Investment Management|Software,21500000.0,USA,4,12,1601,14610,16211,1
Beauty|Cosmetics|E-Commerce|Social Media,165778.0,USA,5,4,579,15638,16217,0
Mobile|Navigation|Real Time,1500000.0,CHN,1,1,0,15614,15614,0
Software,3000000.0,FIN,1,6,0,16689,16689,0
Enterprise Software,865216.0,USA,3,5,387,15633,16020,0
Game,429190.68942331104,FIN,1,6,0,16749,16749,0
Tourism|Travel|Vacation Rentals,324999.0,USA,1,1,0,16400,16400,0
Advertising,3827385.0,KOR,2,2,199,14914,15113,0
App Marketing|Augmented Reality|Digital Signage|Internet Marketing|Mobile,7624000.0,ESP,2,4,805,13032,13837,0
Collaboration|Enterprise Application|Enterprise Software|SaaS|Software|Video Conferencing,68500000.0,USA,4,9,1042,15533,16575,1
Game,60000000.0,JPN,1,4,0,16723,16723,0
Finance|FinTech|Mobile Payments|Payments,3700000.0,USA,2,6,584,15027,15611,1
Pets,96850.0,GBR,2,2,135,16130,16265,0
Career Management|Consulting|Services,858385.728146491,FIN,4,5,610,16071,16681,0
Consulting|Graphics|Venture Capital,15000.0,USA,1,1,0,13665,13665,0
Software,5500000.0,USA,1,1,0,16742,16742,0
Advertising|Sales and Marketing|Social Media,72360.0,FRA,2,3,191,14766,14957,0
Health and Wellness,7500.0,USA,1,1,0,15857,15857,0
E-Commerce,2000000.0,IND,1,2,0,16519,16519,0
Travel,80000000.0,CHN,1,1,0,16266,16266,0
E-Commerce|Retail,25000000.0,SWE,2,2,1437,14944,16381,0
Messaging,1000000.0,USA,1,2,0,13848,13848,0
3D|3D Printing|3D Technology,16350000.0,USA,2,8,309,16218,16527,0
Gold|Internet|Trading,17000000.0,CHN,1,1,0,16702,16702,0
Biotechnology|Manufacturing|Pharmaceuticals,5000000.0,USA,1,1,0,16245,16245,0
Cloud Computing|Web Hosting,3000000.0,ISR,1,1,0,14028,14028,0
Automotive|Customer Service|Sporting Goods,11500000.0,USA,1,1,0,12741,12741,0
Design|Innovation Management|Product Search,41250.0,HKG,1,1,0,16252,16252,0
Diagnostics|Health Care|Health Diagnostics,4167323.0,GBR,5,7,1105,12598,13703,0
Big Data Analytics|SaaS|Sales and Marketing,2980545.0,DEU,2,1,400,16071,16471,0
Travel,2000000.0,USA,2,1,490,16283,16773,0
Clinical Trials|Diagnostics|Health Diagnostics|Medical Devices,600000.0,USA,2,1,19,16233,16252,0
Biotechnology,45500000.0,USA,2,9,477,15994,16471,0
Enterprise Software|Internet|Reviews and Recommendations,11500000.0,USA,3,12,891,15754,16645,0
Hardware + Software,23150000.0,USA,4,9,1973,12551,14524,0
Software,5000000.0,USA,1,2,0,12844,12844,0
Industrial,481894.0,PRT,1,1,0,15922,15922,0
Internet Marketing|Local Search|Software,91000000.0,USA,2,2,1828,14831,16659,0
Automotive|E-Commerce|Enterprise Software|SaaS,575000.0,USA,2,2,57,16212,16269,0
Electronics|Gadget|Hardware + Software|iPad|iPhone|Mobile,100000.0,USA,1,1,0,15832,15832,0
Enterprise Software|Networking|SaaS,6400000.0,USA,2,3,909,15266,16175,0
Games,31930000.0,USA,4,7,774,13300,14074,0
Biotechnology,1700000.0,USA,2,1,271,14704,14975,0
Hardware + Software,5150000.0,USA,2,4,504,13080,13584,0
Apps|Cable|Mobile,500000.0,IRL,1,1,0,10932,10932,0
Apps|Internet|Social Network Media,53750.0,HKG,2,2,243,16405,16648,0
Games,45039999.0,USA,3,11,561,14614,15175,1
Fitness|Health and Wellness,2790000.0,USA,2,11,698,15317,16015,0
Enterprise Software|Sales Automation,104250000.0,USA,6,11,1432,15319,16751,0
Semiconductors,118188900.0,USA,9,31,3043,13392,16435,0
Biotechnology,5700000.0,DEU,1,4,0,14739,14739,0
Biotechnology,8858230.0,BEL,3,1,4760,11323,16083,1
Hotels|Tourism|Travel,4790345.0,USA,2,3,1425,15156,16581,0
Semiconductors,6600000.0,CAN,1,8,0,13234,13234,1
Finance,2120000.0,CAN,1,3,0,13263,13263,1
Biotechnology,13500000.0,USA,3,1,693,14896,15589,0
Health and Wellness,40000.0,CHL,1,1,0,16052,16052,0
Biotechnology,58610000.0,USA,6,13,1747,14975,16722,0
Cloud Computing|Developer Tools|Health Care|Information Technology|Life Sciences,1152531.81030545,ESP,2,1,493,16252,16745,0
Health Care,52000000.0,USA,1,3,0,13493,13493,0
Content|Photography,100000.0,JOR,1,1,0,16283,16283,0
Photography,2500000.0,USA,1,1,0,13784,13784,0
Advertising|Analytics|Sales and Marketing,2000000.0,CAN,1,5,0,16414,16414,0
Communities|Education|Venture Capital,24000000.0,USA,2,1,442,16239,16681,0
Biotechnology,3988460.0,FRA,1,1,0,15978,15978,0
Games,12000000.0,USA,1,1,0,16157,16157,0
Games|Software|Web Development,12000000.0,USA,2,11,176,15217,15393,0
Android|Entertainment|Games|iOS|iPad|iPhone|Mobile,400000.0,LBN,1,1,0,15340,15340,0
Consulting|Gamification|Software,29651.0,BGR,2,2,167,15307,15474,0
Facebook Applications|Games|Networking,25000000.0,LTU,1,1,0,15741,15741,0
Advertising Platforms|Apps|Brand Marketing|Mobile Games|Retail,1600000.0,USA,1,1,0,16558,16558,0
Games,3900000.0,USA,1,1,0,14666,14666,0
Games,9000000.0,USA,2,8,167,12935,13102,1
Games|Social Games|Virtual Worlds,620000.0,SGP,1,3,0,15306,15306,1
Games,8000000.0,DNK,2,7,665,15757,16422,0
Games|Mobile,22500.0,USA,1,1,0,15070,15070,0
Apps|Digital Media|iPhone|Local|Mobile|Software|Sports,10632657.0,USA,7,5,1874,14275,16149,0
Games,700000.0,USA,2,9,235,14610,14845,0
Entertainment|Games|Social Media,17000000.0,USA,3,5,2010,12053,14063,0
Digital Media|Photography|Social Media Marketing|Software|Sports,6500000.0,USA,2,2,348,16289,16637,0
Enterprise Software,3000000.0,ISR,2,2,412,16054,16466,0
Games,10748830.0,USA,2,2,275,12143,12418,0
Fashion|Games|Gamification|Internet|Online Gaming,11400000.0,USA,3,2,1051,13879,14930,0
Games|Social Media|Social Network Media,25000.0,USA,1,1,0,14031,14031,0
Casual Games|Games|Messaging|Mobile|Mobile Games|Mobile Social|Social + Mobile + Local,1000000.0,ISR,1,1,0,16498,16498,0
Browser Extensions|Games|Web Browsers,2000000.0,USA,2,5,244,13787,14031,0
Games|Public Relations|Social Media,65853.0,BEL,2,2,120,15706,15826,0
Games,28600000.0,USA,2,6,919,13187,14106,1
Ediscovery|Fashion|File Sharing|Gamification|Internet|iPhone|Lifestyle|Location Based Services|Mobile|Networking|Photography|Social Media|Startups|Travel,100000.0,SGP,1,1,0,15400,15400,0
Chat|Digital Media|Social Media|Sports,1500000.0,USA,1,6,0,16653,16653,0
Career Planning|Corporate Training|EdTech|Skill Assessment,398995.79501566396,GBR,2,1,0,16631,16631,0
Software,3050000.0,USA,2,2,2731,13263,15994,0
Games,3000000.0,USA,2,3,292,13695,13987,1
Games,5000000.0,CAN,1,2,0,15232,15232,0
Games,11000000.0,CHN,1,2,0,10918,10918,0
Games,13000000.0,IND,3,6,2178,13601,15779,0
Content|Game|Games|iOS|iPad|iPhone|iPod Touch|Mac|Mobile|Mobile Games|Software,7100000.0,USA,4,30,604,14804,15408,0
Games,840000.0,GBR,2,1,459,16080,16539,0
Games|Internet|Publishing|Video Games,2300000.0,USA,2,2,2634,13149,15783,0
Games|Video Games,1000000.0,USA,1,1,0,14761,14761,0
Apps|Mobile|Mobile Commerce|Sports|Ticketing,13300000.0,USA,2,15,233,16336,16569,0
Health and Wellness,5999999.0,USA,2,1,553,15846,16399,0
Biotechnology,49793964.0,ISR,6,14,5007,11078,16085,0
Curated Web|Gambling|Game Mechanics|Games|Gamification|Virtual Worlds|Web Development,240000.0,USA,1,3,0,15506,15506,0
Games,1220000.0,DEU,1,2,0,13573,13573,0
Curated Web|Social Media|Twitter Applications,236448.0,ESP,3,3,276,15461,15737,0
Security,3550000.0,USA,3,2,402,16132,16534,0
Health Care|Medical|Software,125000.0,USA,1,1,0,15006,15006,0
Software,6200000.0,USA,1,2,0,12815,12815,1
Biotechnology,34000000.0,USA,3,3,463,15902,16365,0
Health Care,14000000.0,USA,1,2,0,14547,14547,0
Health Care,10000000.0,CHN,1,3,0,13514,13514,0
Games,1500000.0,USA,1,1,0,13954,13954,0
Game,500000.0,ISR,1,1,0,16191,16191,0
Games,1000000.0,USA,1,1,0,15154,15154,0
Biotechnology,46462082.0,CHN,3,4,1706,14730,16436,0
Semiconductors,20000000.0,CAN,3,9,1275,15287,16562,0
Biotechnology|Fitness|Manufacturing,12000000.0,USA,1,2,0,13822,13822,0
Curated Web|Internet,298000000.0,CHN,4,8,2050,14245,16295,1
Biotechnology,91597000.0,DEU,2,7,2406,13621,16027,0
Games|Social Media,6500000.0,POL,1,1,0,16505,16505,0
E-Commerce,50000000.0,CHN,4,6,945,14761,15706,0
Stock Exchanges,4890000.0,CHN,1,1,0,16323,16323,0
College Recruiting|Enterprises|Human Resources|Recruiting|SaaS|Technology|University Students,40000.0,USA,1,1,0,15314,15314,0
Curated Web|Design|Home & Garden,150000.0,POL,1,1,0,15431,15431,0
E-Commerce,2695400.0,FRA,1,1,0,14879,14879,0
Content Creators|Messaging|Mobile Games|Online Gaming|Payments|Social Network Media,2000000.0,SGP,1,1,0,14089,14089,0
Finance|FinTech|Fraud Detection|Identity|Internet|Media|Personalization|Software,24690000.0,GBR,4,9,1095,13262,14357,1
E-Commerce|Fashion|Marketplaces|Online Shopping|Retail,2660000.0,USA,2,2,364,16388,16752,0
Carbon|Manufacturing|Material Science,300000.0,USA,1,1,0,15831,15831,0
Biotechnology,10400000.0,USA,1,3,0,14278,14278,0
Advertising,3500000.0,RUS,1,1,0,15804,15804,0
Crowdsourcing|Curated Web|Gas|Mobile|Oil|Travel,4000.0,USA,1,2,0,10926,10926,1
Hardware + Software,12000000.0,ISR,1,1,0,15852,15852,0
Accounting|Cloud Computing|Enterprise Software|SaaS,3000000.0,USA,2,31,371,15737,16108,0
Photography,100000.0,USA,1,12,0,15400,15400,0
E-Commerce,128865.0,TUR,1,2,0,15881,15881,0
Groceries|Retail|Subscription Service,606000.0,SWE,2,5,712,15491,16203,0
Curated Web,177194.0,DEU,2,1,552,14245,14797,0
Automotive|Clean Energy|Electronics|Embedded Hardware and Software|Medical|Software|Telecommunications|Testing|Training,3500000.0,VNM,1,1,0,15085,15085,0
Local|Mobile Payments,700000.0,JOR,1,1,0,15584,15584,0
Mobile,800000.0,USA,1,10,0,15154,15154,1
Hardware + Software,2000000.0,USA,1,1,0,14060,14060,0
E-Commerce|Events|Nightlife,90000.0,GBR,1,1,0,15574,15574,0
Health Care,6230757.0,USA,4,17,1219,13375,14594,0
3D|Business Services|Design|E-Commerce|Mass Customization|Personalization,689518.0,GBR,2,2,786,15740,16526,0
Networking|News,27450000.0,USA,5,19,2184,12753,14937,0
Apps,1000000.0,USA,1,4,0,16575,16575,0
Curated Web|Messaging|Mobile|Reviews and Recommendations|Small and Medium Businesses|Social Media,100000.0,USA,1,2,0,15765,15765,0
Customer Service|Delivery|Groceries|Mobile|Recipes|Software|Technology,3793334.0,USA,3,2,558,16050,16608,0
Clean Technology,43000000.0,IND,1,1,0,15884,15884,0
E-Commerce|Fashion|Shoes,3615000.0,MEX,2,2,824,15643,16467,0
Biotechnology|Computer Vision|Medical|Mobile|Wireless,16626989.0,USA,3,11,724,15949,16673,0
Manufacturing,4000000.0,IND,1,1,0,16183,16183,0
Artificial Intelligence|Personalization|Retail Technology|Semantic Web|Shopping|Software|Web Development,4100000.0,CAN,2,2,485,15450,15935,0
FinTech,175000.0,USA,2,2,123,16344,16467,0
E-Commerce|Green|Marketplaces,55900000.0,USA,6,17,2779,13514,16293,1
Games,103000000.0,USA,4,6,878,14918,15796,0
Cloud Data Services|Computers|Embedded Hardware and Software|Hardware,975000.0,USA,2,1,365,16141,16506,0
Apps|Education|Kids,3250876.0,GBR,1,1,0,15460,15460,0
Analytics|Cloud Security|Linux,9560000.0,USA,3,2,759,14949,15708,1
Clean Technology,1320000.0,GBR,1,1,0,14138,14138,0
Information Services|Information Technology|Small and Medium Businesses|Software,1300000.0,ISR,3,10,536,15400,15936,0
Curated Web|Gift Card|Web Tools,5000000.0,USA,2,1,366,13879,14245,0
Health and Wellness|Health Care|Medical Devices,90000000.0,IRL,2,4,1229,14893,16122,0
Event Management|Service Providers|Weddings,40315041.0,USA,5,1,764,14074,14838,1
Health Care|Medical Devices|Pharmaceuticals,15000000.0,CHN,1,1,0,16315,16315,0
Finance,90000000.0,USA,1,1,0,12227,12227,0
Mobile,641000.0,DEU,1,1,0,13378,13378,0
Enterprise Software,15882388.0,GBR,1,1,0,15379,15379,0
Software,1650000.0,USA,2,1,667,14180,14847,0
Semiconductors,212528399.0,USA,8,22,5459,10865,16324,0
E-Commerce,500000.0,USA,1,4,0,15949,15949,0
Blogging Platforms|Consumer Electronics|Electronics|Gadget|Hardware + Software,3715000.0,USA,2,13,280,14426,14706,1
Hospitality|Internet|Online Reservations|Restaurants,625000.0,USA,1,1,0,15203,15203,0
Cloud Data Services|Curated Web|File Sharing|Networking|Peer-to-Peer|Real Time|Social Media|Social Network Media|Startups,457590.0,DNK,1,1,0,15328,15328,1
E-Commerce,5385352.0,GBR,1,1,0,15420,15420,0
Databases|Web Hosting,20000000.0,USA,2,5,624,13340,13964,1
Software,42223.0,ARG,2,2,183,16405,16588,0
Gps|Location Based Services|Mobile|SaaS|Wireless,26041107.0,USA,2,3,714,13565,14279,1
E-Commerce|Financial Services|Payments,2000000.0,ROM,1,2,0,12418,12418,1
CAD|Information Technology|Web Design,1000.0,ROM,1,2,0,8035,8035,0
Collaboration|Email|Linux|Messaging|Networking|Software,4940000.0,ROM,2,6,1169,12662,13831,1
Software,3000000.0,USA,1,1,0,13459,13459,0
Biotechnology,12505971.0,FRA,2,4,407,16048,16455,0
Software,10000000.0,CHN,1,1,0,13939,13939,0
Analytics|Data Integration|Data Visualization|SaaS|Software,1800000.0,GBR,2,8,636,14975,15611,0
Games|Health and Wellness|Health Care Information Technology|Internet of Things|Mobile Health,2100000.0,USA,3,2,382,15567,15949,1
Software,385790.0,GBR,1,1,0,16692,16692,0
Active Lifestyle|Cyber|Families|Internet|Social Media|Social Media Platforms,1000000.0,SGP,2,1,488,15886,16374,0
Auctions|Curated Web|Hardware|Local|Local Search|Marketplaces|Service Providers|Tech Field Support,2200000.0,USA,3,15,462,15819,16281,0
Games,3000000.0,USA,3,4,481,14518,14999,0
Information Technology,7000000.0,BRA,1,4,0,16569,16569,0
Social Commerce|Social Media|Social Recruiting,1250000.0,USA,1,12,0,15772,15772,0
Curated Web|Games|Reviews and Recommendations|Social Media|Technology,435953.0,USA,4,1,487,14285,14772,0
Advertising|App Stores|Mobile|Mobile Advertising|Monetization|Social Media Advertising,569790.0,ESP,4,11,616,15820,16436,0
Education|Knowledge Management|Online Education,2000000.0,USA,1,1,0,16427,16427,0
Mobile,170000.0,ISR,1,1,0,15431,15431,0
Games|Mobile|Software|Television,6225750.0,CZE,2,4,2531,13695,16226,0
Consulting,24699999.0,USA,3,4,340,14974,15314,0
Manufacturing,834798.0,GBR,1,1,0,15211,15211,0
Cloud Computing|Printing|Software,9000000.0,NOR,2,1,1999,14725,16724,0
Health and Wellness|Health Care,353102.0,GBR,1,2,0,16212,16212,0
Internet|Operating Systems|Search|Web Browsers,260000.0,TUR,2,2,678,15567,16245,0
Aerospace|Nanotechnology|Sensors|Test and Measurement,40000.0,USA,2,1,245,16266,16511,0
Biotechnology,4500000.0,USA,1,2,0,16148,16148,0
Mobile,50000.0,USA,1,3,0,15967,15967,0
Information Technology|SaaS|Services,1500000.0,GBR,1,2,0,16689,16689,0
Semiconductors,670000.0,DEU,1,1,0,13740,13740,0
Manufacturing|Semiconductors|Telecommunications,100000000.0,USA,2,9,2371,11386,13757,1
Hardware + Software,8080000.0,BEL,1,5,0,13234,13234,0
Biotechnology,71259078.0,CAN,4,17,782,14063,14845,1
Cloud Computing|Enterprise Software|Storage,485000.0,CAN,1,2,0,14839,14839,0
Mobile,32500000.0,USA,3,8,880,12784,13664,0
Biotechnology,5100000.0,USA,2,10,684,15519,16203,0
Apps|Collectibles|Social Network Media,4900000.0,USA,1,2,0,16380,16380,0
Local|Mobile|Privacy|Reviews and Recommendations|Services|Social Media,1200000.0,USA,1,6,0,16163,16163,0
Biotechnology,2450000.0,USA,1,1,0,16601,16601,0
E-Commerce,45200000.0,USA,3,7,789,14706,15495,0
E-Commerce,11100000.0,USA,3,4,639,14066,14705,0
Biotechnology,50095000.0,USA,6,2,1871,14410,16281,0
Bio-Pharm|Biotechnology|Health and Wellness|Pharmaceuticals,7483000.0,IRL,1,1,0,14558,14558,0
Biotechnology,55800000.0,USA,2,6,1236,15429,16665,0
Biotechnology,45500000.0,USA,3,4,545,15478,16023,0
Graphics|Software,22400000.0,USA,2,1,198,13879,14077,0
Software|Technology,2780000.0,ESP,1,2,0,14302,14302,0
Internet|Networking|VoIP|Web Hosting,646507662.0,USA,11,27,4190,11519,15709,0
Local Search|Mobile|Reviews and Recommendations|Software,6299999.0,USA,2,1,1942,13416,15358,0
Biotechnology,3262631.0,GBR,2,4,1240,11688,12928,0
Development Platforms,30675796.0,JPN,1,1,0,15764,15764,1
Biotechnology,500000.0,USA,1,1,0,15523,15523,0
Biotechnology|Health Diagnostics,25000000.0,USA,3,2,1090,15359,16449,0
Apps|Artificial Intelligence|Mobile Software Tools|Technology|Virtual Workforces,1450000.0,USA,1,4,0,16659,16659,0
Biotechnology,700000.0,USA,1,1,0,12857,12857,0
Health Care,28437.0,GBR,1,1,0,16130,16130,0
Biotechnology,17300000.0,USA,2,5,368,13326,13694,1
Software,440000.0,GBR,1,4,0,13341,13341,0
Biotechnology|Clinical Trials|Startups,11000000.0,KAZ,2,1,41,16458,16499,0
Biotechnology,8250000.0,USA,2,1,621,15630,16251,0
Clean Technology,9000000.0,USA,2,2,377,16030,16407,0
EdTech|Education|Startups,119500000.0,USA,5,22,1710,14998,16708,0
Sensors|Systems|Wireless,3500000.0,USA,1,1,0,15883,15883,0
Mobile,75000000.0,USA,1,1,0,16408,16408,1
Clean Technology,77490000.0,USA,4,4,560,14663,15223,0
Consumers|Publishing,160000.0,USA,1,1,0,16236,16236,0
Public Transportation,84900000.0,USA,3,2,401,14461,14862,1
Energy|Energy Management|Renewable Energies,62036851.0,CAN,5,29,2114,14460,16574,0
Mobile,5000000.0,CHN,1,3,0,15519,15519,0
Career Management|Entertainment|Games|Product Development Services|Television|Video,8000000.0,USA,2,3,497,13942,14439,1
E-Commerce|Fashion|Online Rental,25000000.0,USA,1,13,0,16161,16161,0
Software,2500000.0,USA,1,1,0,13021,13021,0
Biotechnology,4194532.0,USA,2,1,804,15840,16644,0
Discounts|E-Commerce|Retail,650000.0,USA,3,1,151,14914,15065,0
Finance,65000000.0,USA,2,1,306,15623,15929,0
Advertising|Consumers|Predictive Analytics|Publishing|SEO|Software|Video,17000000.0,USA,3,5,561,15609,16170,0
Web Hosting,22165091.0,USA,10,2,1318,13417,14735,1
Software,500000.0,ISR,1,1,0,12944,12944,0
Clean Technology,8628400.0,USA,2,1,515,15485,16000,0
Software,143780450.0,USA,5,6,1680,14718,16398,0
Technology,1980218.93300523,AUS,1,1,0,12859,12859,0
Health and Wellness|Life Sciences|Medical,1821000.0,USA,2,1,1987,12543,14530,0
Apps|Education|Kids,25000.0,USA,1,1,0,15106,15106,0
Biotechnology,24999998.0,USA,3,8,1425,14816,16241,1
Crowdsourcing|Curated Web|English-Speaking|Translation,24200000.0,JPN,6,29,1936,14610,16546,0
Curated Web|Social Media,15000000.0,USA,3,4,733,13530,14263,1
Accounting|Business Services|Human Resources|Legal|Small and Medium Businesses,36060811.0,GBR,2,1,547,16071,16618,0
Content|Content Creators|Developer Tools,318800.742451507,ESP,1,3,0,16764,16764,0
Medical Devices,4000000.0,USA,1,2,0,16545,16545,0
Architecture|Construction|Real Estate,1200000.0,DNK,2,2,445,16034,16479,0
Cloud Data Services|Databases,7570000.0,USA,3,3,2400,13879,16279,0
Curated Web|Local|Search,2000000.0,USA,1,2,0,13787,13787,0
Content|Digital Media|Music|Software|Text Analytics,56900000.0,USA,4,11,1515,15228,16743,0
3D|Indoor Positioning|Software|Virtual Worlds,56874.0,ISR,1,1,0,16130,16130,0
Design|Enterprise Software|Graphics|Internet Marketing,257800.0,ESP,2,3,470,15371,15841,0
Biotechnology,67751091.0,CAN,4,14,2272,11607,13879,0
Biotechnology,72770000.0,CHE,5,17,3264,13178,16442,0
Biotechnology,157000000.0,DNK,2,1,273,14518,14791,0
Biotechnology,19464900.0,ESP,2,3,361,15248,15609,0
Search|Web Tools,600000.0,ESP,1,1,0,12888,12888,0
Hardware + Software,5000000.0,ISR,1,2,0,12951,12951,0
Biotechnology,206525461.0,USA,8,36,1932,14579,16511,1
Biotechnology,21988000.0,CAN,7,14,3044,12817,15861,1
Clean Technology,113125621.0,USA,4,5,1429,14707,16136,0
Big Data|Biotechnology,211227.0,ESP,2,1,120,16467,16587,0
Biotechnology,11250000.0,USA,2,1,2115,11667,13782,0
Biotechnology|Collaboration|Design,5750000.0,USA,2,1,588,15999,16587,0
Biotechnology|Health Diagnostics,389000.0,POL,1,1,0,14033,14033,0
Medical,21000000.0,USA,1,1,0,12615,12615,0
Software,11200000.0,USA,3,6,1506,13088,14594,0
Clinical Trials|Health and Wellness|Health Care Information Technology|Medical|Pharmaceuticals|Social Media,20000.0,USA,1,1,0,15095,15095,0
Biotechnology,3000000.0,USA,1,1,0,15604,15604,0
Biotechnology,8674903.52335833,FRA,2,3,949,13136,14085,0
Biotechnology,11000000.0,USA,2,2,531,16169,16700,0
Analytics,1500000.0,USA,3,4,637,15469,16106,0
Social Media,80000.0,ESP,1,1,0,13573,13573,0
Biotechnology|Fitness|Health and Wellness|Medical Professionals,9059271.0,USA,4,3,1487,15097,16584,0
Big Data|Information Technology|Software,5000000.0,USA,1,1,0,16294,16294,0
Software,3000000.0,USA,1,1,0,13784,13784,0
Biotechnology,77673600.0,FRA,2,13,836,15803,16639,0
Biotechnology,41370920.0,FRA,2,9,1115,14704,15819,0
Biotechnology,10548260.0,USA,2,4,1124,13685,14809,0
Biotechnology,5000000.0,USA,1,1,0,12900,12900,1
Biotechnology,1917766.0,GBR,1,1,0,13577,13577,0
Hospitality,3000000.0,USA,1,1,0,15944,15944,0
Biotechnology|Health Care|Medical|Storage|Transportation,39803794.0,USA,4,6,1169,13607,14776,1
Mobile,7100000.0,USA,3,8,726,14875,15601,0
Internet Marketing|SaaS,312963.0,ARG,2,2,850,15737,16587,0
Android|Developer Tools|Enterprise Software|Software,9700000.0,USA,2,3,293,16332,16625,0
Biotechnology,20000000.0,USA,1,1,0,16241,16241,0
Information Technology|Recruiting,37799.0,JPN,1,1,0,16492,16492,0
Clean Technology,55400000.0,POL,1,1,0,16072,16072,0
Semiconductors,33909833.0,USA,9,3,987,14881,15868,0
Retail,400000.0,ESP,2,2,49,16568,16617,0
Web Hosting,40000000.0,USA,4,6,1096,9131,10227,1
Software,3070000.0,USA,1,5,0,12950,12950,1
Mobile,11253082.0,USA,4,6,661,14214,14875,0
Software,17926365.0,CAN,4,4,1378,14854,16232,0
Curated Web|Local|Local Search|Social Media,177404.0,FRA,2,5,330,14430,14760,0
Geospatial|Hi Tech|Image Recognition,78000000.0,USA,1,1,0,14876,14876,0
Analytics|Local Based Services|Location Based Services|Media|SaaS|Social Media|Social Media Monitoring,6790000.0,USA,3,7,1343,15156,16499,0
Data Visualization|Geospatial|Internet,9024386.74024407,BRA,3,3,931,15784,16715,0
Games,20000.0,RUS,1,1,0,15650,15650,0
Investment Management|Mobile|Services,252052.0,GBR,1,2,0,16231,16231,0
Algorithms|Oil and Gas|Service Providers|Software,350000.0,RUS,1,1,0,15863,15863,0
Education|Systems,31000000.0,USA,1,1,0,13935,13935,1
Advertising,4975500.0,FRA,3,1,671,14085,14756,0
Developer APIs|Enterprise Software|File Sharing|Location Based Services|Open Source,350000.0,USA,2,5,222,15169,15391,1
Software,8000000.0,USA,2,2,1159,14181,15340,1
Fitness|Toys,20000.0,USA,1,1,0,15777,15777,0
Clean Technology,10000000.0,CHE,1,1,0,16113,16113,0
Fashion,6446713.0,GBR,1,1,0,14638,14638,0
Digital Media|Information Technology|Maps|Service Providers,117932.54666767099,CZE,2,2,192,16183,16375,0
Mobile,24100000.0,NLD,2,3,926,13757,14683,1
Analytics|Business Intelligence|Distribution|Enterprise Software|Geospatial|Gps|Leisure|Location Based Services|Maps|Mobile|Property Management|Tourism|Web CMS,388005.0,GBR,1,1,0,14984,14984,0
Android|Games|iOS|Mobile,19713.0,NLD,1,1,0,15434,15434,0
Software,1594999.0,USA,3,1,849,13486,14335,1
Application Platforms|Databases|Real Time,10860000.0,GBR,2,3,369,16344,16713,0
Analytics|Big Data|Clean Energy|Clean Technology|Geospatial|Location Based Services|Maps|Solar|Wind,18250000.0,USA,5,3,1640,15069,16709,0
Clean Technology,18748565.0,GBR,1,3,0,15328,15328,0
Software,378901.0,GBR,1,1,0,14810,14810,0
Analytics|Big Data|Social Media,5400000.0,IND,2,1,450,15706,16156,0
Finance|Financial Services|Services,242132.0,BRA,1,1,0,11900,11900,0
Finance|Insurance|Intellectual Asset Management,10000000.0,CAN,1,2,0,11527,11527,0
Health Care,500000.0,CAN,2,2,426,15400,15826,0
Hardware + Software,26787093.0,USA,2,1,1122,13859,14981,0
Diagnostics|Mothers|Parenting,100000.0,USA,1,2,0,16353,16353,0
Television|Wireless,17000000.0,USA,2,3,462,11122,11584,1
Design|Email Marketing|Messaging|Web Design,71425.0,GBR,1,1,0,15218,15218,0
Enterprise Software|Portals,5666100.0,NLD,1,1,0,14250,14250,0
Ad Targeting|Mobile,1100000.0,USA,1,1,0,15027,15027,0
Health and Wellness|Wearables,15606990.0,CAN,3,10,186,15675,15861,0
B2B|Domains|Search,1273300.0,GBR,5,1,937,15424,16361,0
Ad Targeting|Optimization|Personalization|Software,5695948.0,USA,2,3,409,16262,16671,0
Construction|Online Rental,10766774.0,USA,3,29,1300,15190,16490,0
Property Management|Real Estate,470313.365243842,GBR,1,2,0,16709,16709,0
App Marketing|Apps|App Stores|Cloud Computing|Enterprise Software|Marketplaces|Productivity Software|SaaS|Software,1100000.0,ESP,1,1,0,15252,15252,0
Collaborative Consumption|Mobile|Peer-to-Peer|Transportation,43025000.0,USA,7,28,1397,14997,16394,0
Collaborative Consumption|Communities|Consumer Internet|Mobile Commerce|Search,156000.0,USA,1,5,0,16387,16387,0
Curated Web,1700000.0,USA,1,1,0,14189,14189,0
Analytics|Graphics|Media|Sales and Marketing,83210.0,IRL,2,2,188,15396,15584,0
Polling|Reviews and Recommendations|Software|Surveys,2300000.0,USA,1,1,0,16337,16337,1
Advertising|Internet Marketing|Semantic Search|SEO,25996.0,IRL,1,1,0,14943,14943,0
Advertising,400000.0,CAN,1,1,0,16195,16195,0
Hotels|Travel,2500000.0,USA,3,10,810,15340,16150,0
Advertising|Advertising Platforms|Technology,1400000.0,USA,2,3,736,15949,16685,0
Cloud Management,34419.0,BGR,1,1,0,16071,16071,0
Android|App Stores|Mobile|Wireless,42000000.0,USA,3,4,1195,13824,15019,1
Human Resources|Marketplaces|Mobile|Recruiting|Small and Medium Businesses,34181.0,ISR,2,1,135,16117,16252,0
E-Commerce,2200280.0,GBR,2,2,456,14488,14944,0
Human Resources|Recruiting|Software,71000.0,GBR,1,2,0,15601,15601,0
E-Commerce|Restaurants,48495.0,IND,1,1,0,16409,16409,0
News,1020903.0,GBR,2,2,878,13514,14392,0
Advertising|Bridging Online and Offline|Classifieds|Curated Web|Local Services|Marketplaces|Mobile|Service Providers,16700000.0,BRA,4,10,1538,15065,16603,0
Mobile,3330984.0,USA,3,4,258,15826,16084,0
Curated Web,1300000.0,ISR,1,3,0,15749,15749,0
Hospitality|Restaurants,200000.0,USA,1,2,0,13864,13864,0
Business Analytics|Internet of Things|Meeting Software|Office Space|Sensors,2100000.0,USA,1,5,0,16258,16258,0
EdTech|Education,2500000.0,USA,2,6,571,15744,16315,0
Content|SaaS|Social Media Marketing|Software,843550.409947646,PRT,1,2,0,15966,15966,0
Cloud Computing|Enterprise Software|Infrastructure|PaaS|Social Media,2024641.0,USA,2,11,201,16457,16658,0
Apps|Mobile|Private Social Networking,1155000.0,USA,1,6,0,16271,16271,0
Consumer Internet|Marketplaces|Mobile|Mobile Payments|Transportation|Travel,220000000.0,USA,6,9,1907,14647,16554,0
Software,3000000.0,USA,1,1,0,14566,14566,0
Charities|Finance Technology|Lifestyle|Nonprofits|Social Network Media,500000.0,USA,1,1,0,16468,16468,0
Information Technology|Innovation Management|Service Providers,25000.0,IND,1,2,0,16091,16091,0
Software,9000000.0,USA,2,7,2782,13079,15861,1
Business Services|Facebook Applications|Hardware|Internet|Mobile|Networking|NFC|Photo Sharing|RFID|Social Network Media|Startups|Twitter Applications,1554158.0,BEL,3,1,834,14335,15169,0
Internet,1922322.58575078,ESP,2,1,301,16344,16645,0
Energy,8264273.08831294,GBR,1,1,0,16737,16737,0
Chemicals|Clean Technology,59500000.0,USA,4,13,896,13581,14477,1
Games,52000000.0,CHN,3,4,944,15309,16253,0
Games,4120000.0,GBR,1,1,0,14523,14523,0
Hotels|Online Reservations|Travel,140000.0,TUR,1,2,0,15156,15156,0
Software,180000000.0,NZL,3,5,3795,12822,16617,0
Services|Software|Taxis|Transportation,200000.0,ARM,1,2,0,16603,16603,0
Bicycles|Electric Vehicles|GreenTech,1346000.0,ARG,2,1,195,16513,16708,0
Biotechnology,156304548.0,USA,5,8,3633,12563,16196,0
Health and Wellness,33942342.0,ISR,6,5,2758,13650,16408,0
Business Services|Games,44320000.0,CHN,1,1,0,13726,13726,1
News,5500000.0,USA,2,4,68,13939,14007,1
Cloud Computing|Developer Tools|Development Platforms|IaaS|PaaS|Software|Web Hosting,2325000.0,DEU,2,13,233,16276,16509,0
Environmental Innovation,16876.0,NLD,1,1,0,16493,16493,0
Gps|Local Search|Pets|Software,345000.0,USA,1,1,0,15964,15964,0
Biotechnology,7403435.0,CAN,1,2,0,15176,15176,0
Digital Entertainment|Digital Media|Digital Rights Management|Distribution|Licensing|Media|Music|News|Publishing,440000.0,USA,5,6,518,15930,16448,0
E-Commerce|Gift Card|Internet|Retail|Services,7500000.0,USA,4,1,2695,13300,15995,0
Gift Exchange|Gift Registries|Services,40000.0,CHL,1,1,0,15940,15940,0
Mobile,6400000.0,USA,2,2,371,14518,14889,1
Software,118000.0,USA,1,2,0,16643,16643,0
E-Commerce,2000000.0,IDN,1,4,0,16450,16450,0
E-Commerce,26100000.0,USA,2,6,125,11495,11620,1
E-Commerce,95582.0,JPN,3,5,489,15064,15553,0
Brand Marketing|Games,213700.0,GBR,2,2,194,16346,16540,0
Social Media,1020000.0,USA,2,6,232,14852,15084,1
Crowdfunding|E-Commerce|Gift Registries,30000.0,PHL,1,2,0,15706,15706,0
Consumers|Curated Web|Gift Card|Sales and Marketing,2800000.0,USA,1,6,0,15034,15034,0
E-Commerce|Facebook Applications,18885.0,DEU,2,1,396,15126,15522,0
Nonprofits,705000.0,USA,3,1,791,14914,15705,0
E-Commerce|FinTech|Software,420000.0,USA,3,6,348,16282,16630,0
Technology,6000000.0,USA,1,2,0,11332,11332,0
Manufacturing,5000000.0,USA,1,1,0,13676,13676,0
Public Relations,14600000.0,USA,1,3,0,13096,13096,0
E-Commerce,1000000.0,DEU,1,4,0,15113,15113,0
Public Relations,1400000.0,USA,1,2,0,13545,13545,0
Networking|Technology|Web Hosting,22800000.0,USA,1,1,0,14643,14643,1
Consulting|Events|Market Research|News|Technology,22325000.0,USA,6,17,2821,13300,16121,0
Cloud Computing|Networking|Virtualization|Web Hosting,9080000.0,ESP,3,7,993,15156,16149,0
Consumer Electronics|Software,18000000.0,USA,3,7,997,13003,14000,0
Sports,53192.0,JPN,1,1,0,15414,15414,0
Cloud Security|Data Security|Enterprise Software|Information Security|Mobile Security|Mobility,26174320.0,USA,2,3,340,13811,14151,0
Crowdfunding|Finance|Marketing Automation,40000.0,USA,1,1,0,16222,16222,0
B2B|Music|Musicians,200000.0,POL,1,1,0,16358,16358,0
Mobile,48407.0,GBR,1,1,0,15688,15688,0
Internet,5000000.0,USA,1,3,0,11151,11151,0
Artists Globally|Innovation Management|Services,962962.0,AUS,2,6,456,16161,16617,0
Food Processing,9742335.52197607,GBR,1,1,0,16755,16755,0
Manufacturing,4000000.0,USA,2,1,420,15140,15560,0
Games,365000.0,USA,1,5,0,15853,15853,0
Networking|Semiconductors|Telecommunications|Wireless,31000000.0,ESP,2,5,615,13230,13845,1
Curated Web|Music,68396.0,GBR,1,2,0,15817,15817,0
Music|Music Services|Social Network Media,8000.0,IND,1,1,0,16274,16274,1
Mobile|Wireless,21982714.0,USA,6,1,1641,15089,16730,0
Enterprises|Marketplaces,210000.0,IND,2,3,152,16256,16408,0
Apps|Internet|Mobile,1500000.0,USA,1,3,0,15990,15990,0
Curated Web|Music,192660.0,FIN,1,3,0,14810,14810,0
Games|Music,25000.0,USA,1,1,0,15715,15715,0
Crowdsourcing|Location Based Services|Mobile|Software,17800000.0,USA,3,18,1051,15098,16149,0
Enterprise Software|Identity Management,105800000.0,USA,7,27,2833,13545,16378,0
Databases|Enterprise Software|Marketplaces|Music|Photography|Software,40000.0,USA,3,2,485,15859,16344,0
Messaging,3350000.0,USA,2,5,516,14245,14761,0
Curated Web|Recruiting,25900000.0,USA,4,16,1035,15190,16225,0
DIY|Events,50000.0,USA,1,1,0,16602,16602,0
Design|E-Commerce|Fashion|Furniture|Lifestyle|Shopping|Travel,286000000.0,USA,7,18,2664,13818,16482,0
Health Care,4725236.0,DEU,1,5,0,14987,14987,0
Auctions|E-Commerce|Price Comparison|Retail|Sales and Marketing|Shopping,1951712.0,DEU,3,1,850,13149,13999,0
Curated Web|Facebook Applications|Social Media,300000.0,ISR,1,1,0,14276,14276,0
Media|News,1500000.0,USA,1,4,0,16385,16385,0
Vending and Concessions,450000.0,USA,1,2,0,16681,16681,0
Advertising|Big Data Analytics|Consumers|CRM|Gamification|Incentives|Loyalty Programs|Media,1720000.0,SGP,4,5,1215,15187,16402,0
Manufacturing,1500000.0,USA,1,1,0,14867,14867,0
Analytics|Big Data|Health and Wellness|Mobile,28200000.0,USA,5,18,1393,15034,16427,0
Software,11700000.0,USA,2,3,176,15398,15574,0
Advertising,2000000.0,IND,1,2,0,13846,13846,0
Artificial Intelligence|Consumers|Curated Web|Developer APIs|Document Management|Internet|Machine Learning|Mobile|Semantic Search|Software,1954083.0,DEU,6,7,1389,15034,16423,1
Biotechnology,54120000.0,USA,3,14,372,16267,16639,0
Education,2000000.0,USA,2,2,363,15881,16244,0
Analytics|E-Commerce|Enterprises|Enterprise Software|SEO,1714000.0,USA,5,8,1457,14730,16187,0
Brand Marketing|E-Commerce|Online Shopping,82100000.0,SGP,1,6,0,16639,16639,0
Internet|Search|Service Providers,23949998.0,USA,2,12,259,16205,16464,0
Mobile,725609.0,ITA,2,3,471,16220,16691,0
Consumer Electronics|Content|Software|Video|Video on Demand|Video Streaming,6500000.0,ISR,2,1,1757,14222,15979,0
E-Commerce,1370776.0,GBR,1,1,0,16066,16066,0
Advice|Apps|Communities|Curated Web|Media|Mobile|Social Media,1000000.0,USA,1,1,0,15975,15975,0
Communities|Content Delivery|Women,40000.0,CHL,1,1,0,15308,15308,0
Enterprise Software|Mobile Software Tools|Mobility|Web Development,65000000.0,IND,2,4,434,16029,16463,0
Hardware + Software,1400000.0,FRA,2,1,425,16255,16680,0
Curated Web,10750000.0,USA,2,4,449,14369,14818,1
Internet|Services|Software,350000000.0,USA,2,6,1115,15530,16645,0
Open Source|Software,5620000.0,USA,3,9,297,16405,16702,0
Big Data Analytics|Engineering Firms|Enterprise Software|SaaS,800000.0,USA,1,1,0,16540,16540,0
Biotechnology,3750000.0,USA,3,1,1220,15343,16563,0
Enterprise Software,2200000.0,GBR,1,5,0,16722,16722,0
Nonprofits,6322000.0,USA,2,6,605,15440,16045,1
Software,120000.0,USA,1,1,0,16405,16405,0
Crowdfunding|Startups,2515000.0,USA,3,10,785,14761,15546,0
Curated Web|Social Media,4340000.0,USA,3,9,1030,15426,16456,0
Digital Media|Publishing|Sports,4596695.0,GBR,2,2,453,15645,16098,0
Services,120000.0,GBR,1,1,0,16405,16405,0
E-Commerce|Finance,588000.0,USA,3,1,486,15345,15831,0
Charity|Nonprofits,70000.0,USA,1,1,0,16035,16035,0
Software,1500000.0,USA,1,3,0,14951,14951,0
Charity|Insurance,1000000.0,USA,3,3,335,16274,16609,0
Advertising,500000.0,IND,1,2,0,16055,16055,0
E-Commerce|Nonprofits|Performance Marketing|Retail,2789671.0,USA,2,1,727,16022,16749,0
Enterprise Software|Humanitarian|Life Sciences|Nonprofits,20000.0,USA,1,1,0,15845,15845,0
Nonprofits|SaaS|Technology,37500.0,USA,2,1,141,15431,15572,0
Crowdsourcing|Retail Technology|SaaS,770000.0,FIN,1,1,0,16468,16468,0
Advertising|App Marketing|Cloud Computing|Enterprises|Enterprise Software|Web Development,340000.0,USA,2,7,245,15034,15279,0
Public Relations,6000000.0,USA,1,1,0,13180,13180,1
Enterprise Software|Software|Web Design|Web Development|Web Tools,9250000.0,USA,3,6,2123,13695,15818,0
3D|Curated Web|Entertainment|Web Tools,18100000.0,USA,3,9,915,13634,14549,1
Audio|Content|Digital Media,75000.0,ECU,1,3,0,16287,16287,0
Clean Technology,58000000.0,USA,3,6,582,13907,14489,0
Adventure Travel|Services|Social Travel,350000.0,USA,1,1,0,16302,16302,0
Biotechnology|Health and Wellness|Health Care,3336438.0,CAN,1,4,0,16609,16609,0
Fashion,1360000.0,ARE,1,3,0,15977,15977,0
E-Commerce|Fashion|Retail Technology|Soccer,1030000.0,ARG,5,10,685,15400,16085,0
Content Creators|Curated Web|Fashion|Lifestyle|Media|Social Network Media|Video Streaming,244600000.0,USA,11,25,3976,12600,16576,0
Travel,163758.0,GBR,1,1,0,15055,15055,0
E-Commerce,13000000.0,JPN,1,2,0,14639,14639,0
Hospitality|Sustainability|Travel & Tourism,1040000.0,USA,2,2,573,15748,16321,0
Beauty|Cosmetics|Curated Web|Personal Health,24000000.0,USA,3,10,646,16071,16717,0
News,25000.0,USA,1,1,0,16083,16083,0
Biotechnology,200000000.0,IND,1,1,0,16037,16037,0
Media,30000.0,USA,1,1,0,16526,16526,0
Service Providers|Services,62895.0,AUS,1,1,0,15585,15585,0
Software,5000000.0,USA,2,1,334,15949,16283,0
Games,15210000.0,CAN,5,3,1996,14040,16036,1
Career Management|Employment|Recruiting|Social Media,161500000.0,USA,6,20,2476,13965,16441,0
E-Commerce|Eyewear|Marketplaces|Sunglasses,4500000.0,MYS,2,8,916,15706,16622,0
Eyewear|Fashion|Online Shopping,12500000.0,USA,1,1,0,16524,16524,0
E-Commerce,1750000.0,USA,2,3,661,15918,16579,0
Cloud Computing|Consulting|Data Centers|Flash Storage|Homeland Security|IT and Cybersecurity|Services|Storage|Virtualization,155710155.0,USA,13,25,3858,11504,15362,0
Concentrated Solar Power|Oil & Gas,86736464.0,USA,6,12,1545,14776,16321,0
Hardware|Software|Sports,810000.0,ESP,5,1,834,15541,16375,0
Health Care,121000392.0,USA,7,24,3812,11931,15743,1
Software,4000000.0,GBR,2,1,405,14015,14420,0
Advertising,40000.0,ROM,1,1,0,15380,15380,0
Biotechnology,800000.0,USA,1,1,0,16482,16482,0
Services|Telecommunications|Wireless,1610000.0,CAN,1,1,0,16405,16405,1
Health and Wellness,3350000.0,USA,3,1,166,15308,15474,0
Bio-Pharm,2500000.0,USA,1,1,0,11500,11500,0
Education|Employment|Gamification|Human Resources|Skill Assessment,197148.0,ITA,2,1,433,16130,16563,0
Messaging|Mobile,28500000.0,ISR,3,9,620,15785,16405,0
Biotechnology,30161601.3866021,GBR,3,5,2025,13738,15763,0
Public Relations,1990000.0,GBR,1,1,0,13939,13939,1
Business Development|Business Intelligence|Collaboration|Document Management|Finance|FinTech|Security|Software,1350000.0,USA,4,11,398,15406,15804,1
Bitcoin,118000.0,USA,1,1,0,16622,16622,0
Biotechnology,48386081.0,USA,8,2,1329,14622,15951,0
Web Hosting,21045594.0,USA,4,2,1687,13039,14726,0
Fashion|Search,4000000.0,USA,1,2,0,13149,13149,1
Enterprise Software|Human Resources,15500000.0,USA,2,5,477,16007,16484,0
Education|Human Resource Automation,409796.0,SGP,2,3,328,16149,16477,0
Bitcoin|Data Security|Messaging|Networking|Privacy|Security,393000.0,USA,5,7,701,15400,16101,0
Nanotechnology|Semiconductor Manufacturing Equipment|UV LEDs,66612432.0,SWE,3,13,1656,14490,16146,0
Biotechnology,7768156.0,USA,2,1,135,15040,15175,0
B2B|Emerging Markets|Hospitality|Hotels|Mobile|Online Travel|SaaS|Software|Travel,675000.0,USA,1,2,0,15937,15937,0
iPhone|Local Search|Location Based Services|Maps|Messaging,15000.0,USA,1,1,0,14700,14700,0
Analytics,40000000.0,USA,2,1,1351,14564,15915,0
Health Diagnostics|Medical,3219352.0,USA,3,2,1023,15491,16514,0
Biotechnology,88700000.0,USA,2,5,936,15505,16441,1
Health and Wellness,5000000.0,USA,1,1,0,13290,13290,0
Software,125000.0,USA,3,1,1007,13792,14799,0
Public Relations|Telecommunications,41000000.0,USA,1,1,0,9921,9921,1
Consulting,75000000.0,CHN,2,5,550,13573,14123,0
Bridging Online and Offline|Online Education|Young Adults,8000000.0,USA,1,1,0,15431,15431,0
Advertising,50000.0,BRA,1,3,0,13970,13970,0
Fashion,202000000.0,LUX,2,3,85,16532,16617,0
E-Commerce|Fashion,35000000.0,LUX,1,2,0,16533,16533,0
Health Care,9700000.0,FRA,2,5,1482,13339,14821,0
Nonprofits,2400000.0,USA,1,1,0,14549,14549,0
Health Care|Medical|Neuroscience|Therapeutics,14800000.0,AUS,2,2,16,16574,16590,0
Semiconductors,33000000.0,USA,2,5,503,12936,13439,1
Digital Media|IaaS|Online Gaming|SaaS,10001228.0,USA,1,1,0,13693,13693,0
News,8200000.0,USA,1,3,0,14256,14256,0
Cloud Infrastructure|Communications Infrastructure|Unifed Communications,4500000.0,USA,1,1,0,15400,15400,0
Games,700000.0,USA,1,1,0,14869,14869,0
Clean Technology,502508.0,GBR,1,1,0,16224,16224,0
Design|Innovation Management|Startups,100000.0,USA,1,1,0,15636,15636,0
Hospitality|Online Reservations,1300000.0,IDN,2,2,78,16680,16758,0
Semiconductors,10000000.0,GBR,1,3,0,13034,13034,0
Cloud Computing|Enterprise Software|Mobile,29158851.0,USA,3,2,958,14882,15840,0
E-Commerce|Golf Equipment|Product Development Services,500000.0,USA,1,1,0,14309,14309,0
Media,50000.0,USA,1,1,0,16323,16323,0
Security|Software,1000000.0,USA,3,4,315,13879,14194,0
Mobile,191874.0,GBR,1,1,0,15816,15816,0
Digital Media|Ediscovery|Hip Hop|Music|News|Social Media|Software|Video,7100000.0,USA,3,2,1132,13392,14524,0
Software,10000000.0,USA,1,14,0,16538,16538,0
Online Education|Skill Assessment|University Students,1050000.0,RUS,1,1,0,15764,15764,0
Software,42000000.0,USA,3,4,2749,13237,15986,0
Travel,1000000.0,USA,1,1,0,14607,14607,0
Hardware + Software|Printing,200000.0,USA,1,1,0,13970,13970,0
Industrial,6285.0,EST,1,1,0,16561,16561,0
Education|Software|Tutoring,27000000.0,USA,1,2,0,13913,13913,1
Finance|FinTech,8220000.0,USA,2,6,2012,13706,15718,0
Public Transportation|Software,50000000.0,USA,2,3,1334,14985,16319,0
Content|Delivery|Information Services,30000000.0,USA,1,1,0,11666,11666,0
Big Data|Cloud Computing|Content|Design|E-Commerce|Game|Mobile|Mobile Social|Software,28000000.0,ARG,2,4,840,14215,15055,1
Enterprise Software,393000.0,CAN,1,1,0,13151,13151,0
Biotechnology,120456440.0,USA,8,16,3008,13133,16141,1
E-Commerce,3200000.0,USA,2,5,540,15764,16304,0
Public Relations,1490000.0,CAN,1,1,0,13097,13097,0
Financial Services,82000000.0,USA,1,1,0,12331,12331,0
RFID|Software|Supply Chain Management|Tracking,8300000.0,USA,1,2,0,14315,14315,0
Mobile,5615000.0,USA,6,6,1216,15400,16616,0
Adventure Travel|Mobile|Social Media|Travel,50000.0,USA,1,1,0,15418,15418,0
Human Resources|SaaS|Services|Software,9300000.0,USA,2,3,1008,11688,12696,0
Health Care,110000000.0,USA,1,3,0,13748,13748,1
Clean Technology,30000.0,EST,1,1,0,15755,15755,0
Pharmaceuticals,1134305.0,ITA,1,3,0,16697,16697,0
Hardware + Software,16200000.0,USA,1,1,0,13326,13326,0
Android|Diabetes|Health and Wellness|Health Care|iPhone|mHealth,28000000.0,USA,4,24,1597,14914,16511,0
E-Commerce|Mobile Commerce|Online Shopping|Small and Medium Businesses|Social Buying|Social Commerce|Social Media|Social Network Media,243540.0,GBR,1,1,0,15608,15608,0
Photography,696081.0,GBR,2,2,326,15488,15814,0
Clean Technology,20000000.0,USA,2,7,203,15160,15363,1
Health Care,6292814.0,CHN,2,1,274,14214,14488,0
Beauty|Consumer Goods,10400000.0,USA,2,8,77,16314,16391,0
Health Care,19184620.0,USA,5,2,1405,14392,15797,0
Biotechnology|Medical,31700000.0,USA,4,5,119,14362,14481,1
E-Commerce,40000.0,DEU,1,1,0,15561,15561,0
Delivery|Local|Mobile|Transportation,2289388.43068056,ESP,2,6,292,16471,16763,0
Health and Wellness|Mobile Health|Women,23000000.0,USA,2,7,420,15925,16345,0
Advertising|Facebook Applications|Social Media|Social Media Advertising|Twitter Applications,8250000.0,GBR,2,7,580,15693,16273,0
Hardware + Software,37665000.0,USA,3,5,238,16493,16731,0
Biotechnology,604000.0,USA,2,1,403,15864,16267,0
Freemium|Games|Mobile|Technology,133121250.0,USA,5,8,3674,12895,16569,1
Analytics|Health Care|Health Care Information Technology,20000.0,USA,1,1,0,16471,16471,0
Medical Devices,13000000.0,USA,2,12,1111,12424,13535,0
Biotechnology,90000.0,USA,2,1,43,15625,15668,0
Software,20973227.0,USA,7,2,1584,14438,16022,0
Enterprise Software,18466599.0,USA,3,6,1021,15036,16057,0
Energy,1000000.0,USA,2,3,38,16507,16545,0
Health Care,50676045.0,USA,5,3,1999,14102,16101,0
Manufacturing,50000000.0,USA,1,1,0,11694,11694,0
Software,1500000.0,GBR,2,2,376,16071,16447,0
Enterprise Software,8500000.0,USA,1,2,0,14922,14922,1
Biotechnology,31650333.333333302,CHE,3,7,978,13330,14308,1
Biotechnology,4310700.0,FRA,1,4,0,14627,14627,0
Biotechnology|Health Care,86379412.0,USA,4,15,2715,12194,14909,1
Biotechnology|Health Diagnostics,1000000.0,ISR,1,2,0,12784,12784,0
Biotechnology,19393087.0,USA,8,13,2202,13910,16112,0
Consumer Electronics|E-Commerce|Entertainment|Hardware|iPad|iPhone|iPod Touch|Marketplaces|Media|Online Shopping|Peer-to-Peer|Retail|Video Games,27000000.0,USA,3,2,1430,13514,14944,0
Biotechnology,150000.0,USA,1,1,0,16146,16146,0
Location Based Services|Mobile|Mobile Software Tools,19500000.0,USA,3,10,1288,14946,16234,0
Health and Wellness,14000000.0,USA,3,2,843,15597,16440,0
Health Care,24412621.0,GBR,2,8,324,15348,15672,0
Biotechnology,3932928.0,GBR,2,2,621,14891,15512,0
Health Care,2296575.0,DEU,2,5,499,15321,15820,0
Consumer Electronics|Hardware|New Technologies|Wearables,25000.0,USA,1,1,0,16202,16202,0
Software,35000000.0,USA,1,3,0,13304,13304,0
Enterprise Software,5000000.0,USA,1,1,0,11995,11995,0
Clean Technology,26937803.0,USA,4,5,1261,15082,16343,0
Enterprise Software,6640000.0,USA,4,8,1287,13939,15226,1
Design|Infrastructure|Systems|Web Hosting,2190000.0,USA,2,3,473,13973,14446,0
Software,589000.0,SGP,1,2,0,16176,16176,0
Analytics|Big Data,34264920.0,USA,6,4,1638,14943,16581,0
Consumer Goods,5600000.0,SGP,1,1,0,16363,16363,0
Hospitality|Mobile Commerce|Restaurants,230000.0,USA,1,1,0,16049,16049,0
Ad Targeting|Content|Data Integration|Internet,20000.0,USA,1,1,0,16269,16269,0
Mobile|SaaS|Sports|Technology,2000000.0,USA,1,2,0,16358,16358,0
Electronics,15000.0,CAN,1,1,0,16071,16071,0
Delivery|Services,100000.0,USA,2,1,420,16071,16491,0
E-Commerce,45691558.0,GBR,1,1,0,15078,15078,0
Messaging,494000.0,GBR,1,1,0,14032,14032,0
Fashion|Lifestyle|Photography|Real Time,3750000.0,USA,3,4,740,14917,15657,1
Education,40000.0,NZL,1,1,0,15751,15751,0
Mobile,50000.0,SGP,1,2,0,14610,14610,0
Business Development|CRM|Education|Software,730458.41135035,AUS,1,3,0,16645,16645,0
Technology|VoIP,8500000.0,USA,3,4,1542,10926,12468,1
Health Care|Internet|Medical|Therapeutics,19615.0,AUS,2,1,309,15762,16071,0
Software,8500000.0,USA,1,6,0,10893,10893,1
Clean Technology|Consumer Goods|Hardware + Software|Solar,10918691.0,USA,4,4,610,15117,15727,1
Software,1050000.0,FRA,1,2,0,12898,12898,0
EdTech|Education,950000.0,USA,2,6,392,15240,15632,0
Finance,2000000.0,USA,1,2,0,14715,14715,0
E-Commerce|Mobile|Mobile Commerce|Social Commerce,7600000.0,USA,2,16,411,15095,15506,0
Mobile,2275000.0,USA,5,7,1193,14756,15949,0
Software,37611998.0,USA,5,13,1194,15247,16441,0
Cooking|Delivery|E-Commerce|Hospitality|Software,11950000.0,USA,3,22,1632,15105,16737,0
Cloud Computing|Digital Media|Enterprise Software,6331724.0,USA,11,42,1339,14975,16314,0
Big Data|Mobile|SaaS|Training,800000.0,USA,1,1,0,15792,15792,0
E-Commerce|Education|Textbooks,325000.0,BRA,2,1,59,15706,15765,0
Logistics|Services|Storage,1540000.0,DNK,2,2,273,16314,16587,0
Apps|Internet|Online Reservations,8000000.0,USA,2,14,151,16495,16646,0
Search|Travel,2500000.0,USA,1,2,0,14902,14902,1
Environmental Innovation,500000.0,USA,1,1,0,16308,16308,0
E-Commerce|Financial Services|Payments|Trading,11800000.0,GBR,3,12,721,15377,16098,0
Curated Web,441804.0,GBR,4,5,432,15826,16258,0
Software|Taxis|Transportation,8000000.0,AUS,2,2,399,15964,16363,0
App Marketing|Mobile|Polling|SMS|Social Media Marketing|Surveys,855000.0,USA,2,6,122,15553,15675,0
Advertising|Marketing Automation|Social Media,1500000.0,USA,2,9,792,15279,16071,0
Web Development,23000000.0,USA,1,1,0,11515,11515,0
Bitcoin|Mobile Payments,2050000.0,SGP,2,15,139,16016,16155,0
Software,70000.0,IND,2,2,0,16056,16056,0
Colleges|Game|Games|MMO Games|Networking|Social Games|Universities,375000.0,USA,1,2,0,13757,13757,0
Biotechnology,100000.0,USA,1,1,0,16260,16260,0
Advertising,16953708.0,USA,3,1,1295,14518,15813,0
Financial Services|Information Technology|Project Management,118000.0,GBR,1,1,0,16517,16517,0
Religion|Social Media|Social Network Media,32500000.0,USA,2,2,489,13514,14003,0
Apps|Mobile,500000.0,USA,1,4,0,16500,16500,0
Business Productivity|Cloud Computing|Mobile Software Tools|SaaS,5000000.0,USA,2,3,266,16259,16525,0
Billing|Cloud Computing|CRM|Distribution|Enterprise Software|Lead Generation|PaaS|SaaS|Small and Medium Businesses|Web Design|Web Development,133333.0,CAN,1,2,0,14610,14610,0
Mobile|Telecommunications|Wireless,323000000.0,USA,3,2,765,15516,16281,1
Local Search|Mobile|Reviews and Recommendations|Social Media|Travel,39000000.0,USA,3,10,1612,14774,16386,0
Bitcoin,105000.0,USA,1,2,0,15987,15987,0
Apps|iOS|Logistics|Mobile|Services|Transportation,26541250.0,HKG,4,5,526,16071,16597,0
Charity|Internet|Music|Social Network Media|Video Streaming,960273.0,ISL,1,1,0,14245,14245,0
Hardware + Software|High Tech|Industrial Automation|Logistics|Robotics,30000000.0,SGP,2,4,468,16189,16657,0
Health and Wellness,75375733.0,USA,2,1,1211,15503,16714,0
Design|Internet|Mobile|Telephony,10000000.0,DNK,1,2,0,13823,13823,0
Curated Web|Events,8500000.0,USA,2,4,196,13523,13719,1
Advertising|Curated Web|Green|Sustainability,25000.0,USA,1,1,0,16405,16405,0
Enterprises|Networking|Social Media|Software,8500000.0,USA,3,3,2017,12996,15013,0
Enterprise Software,1700000.0,CAN,1,9,0,15231,15231,1
Messaging,2616800.0,DNK,1,1,0,13518,13518,0
Technology,20000000.0,IND,1,1,0,16715,16715,0
Hospitality,4000000.0,USA,2,3,292,15231,15523,1
Apps|Education,2200000.0,GBR,2,2,61,16039,16100,0
Employment|Enterprises|Enterprise Software|Human Resources|Recruiting|Startups,25000.0,USA,1,1,0,16273,16273,0
Games,8000000.0,USA,1,2,0,15572,15572,0
Web Hosting,12319440.0,JPN,3,3,220,15492,15712,0
E-Commerce,100000.0,USA,1,1,0,15248,15248,0
Advertising|Advertising Networks|Email|Messaging|Monetization,625160.0,USA,2,1,211,14833,15044,0
E-Commerce|Marketplaces|Social Commerce|Specialty Foods,3000000.0,USA,2,10,683,15965,16648,0
Games,2825768.0,CHN,2,1,792,13818,14610,0
Consumer Goods|Restaurants|Services,2600000.0,VNM,1,1,0,14075,14075,0
Design|Developer Tools|Electronics|Technology,9000000.0,USA,1,2,0,12565,12565,0
Financial Services,6000000.0,USA,1,1,0,13770,13770,0
Advertising|Direct Marketing|Services,255894.0,BGR,3,3,91,16314,16405,0
Curated Web,500000.0,USA,1,1,0,15645,15645,0
Service Providers,7000000.0,USA,1,2,0,12240,12240,0
Software|Television,56000000.0,USA,3,12,438,10956,11394,1
Advertising|Mobile|Video,17050000.0,USA,3,3,1557,13514,15071,0
Entertainment,20329804.0,USA,1,1,0,16762,16762,0
Software,5500000.0,IND,1,2,0,16573,16573,0
Events,2200000.0,CAN,2,5,2191,13149,15340,0
Apps,700000.0,THA,1,1,0,16720,16720,0
E-Commerce|Golf Equipment|Loyalty Programs|Online Travel|Travel,1450000.0,USA,3,3,625,15886,16511,0
E-Commerce|Sports,35000.0,CHE,1,1,0,15706,15706,0
Apps|Software,5000000.0,USA,1,1,0,16211,16211,0
Advertising|App Marketing|Mobile,40000.0,USA,2,2,0,13361,13361,0
Fitness|Healthcare Services|Medical,459272.0,DNK,1,1,0,15841,15841,0
Advertising|Analytics|Private Social Networking|Social Media,40000.0,USA,1,1,0,15538,15538,0
Consulting,64900000.0,USA,7,16,1367,10957,12324,1
Finance|Travel,12000.0,USA,2,1,39,14914,14953,1
Peer-to-Peer|Public Transportation,2000000.0,DNK,3,6,715,15796,16511,0
Collaborative Consumption|E-Commerce|Finance|FinTech|Mobile Commerce|Social Commerce,1120000.0,USA,4,10,455,15706,16161,0
Manufacturing,3500000.0,CHN,1,1,0,15995,15995,0
Mobile,200000.0,USA,2,9,326,15420,15746,0
3D|Game|Internet|Software|Web Development,2200000.0,SWE,2,4,513,15938,16451,0
Delivery|E-Commerce|Hospitality,50000.0,HKG,1,1,0,15492,15492,0
Analytics|Big Data|Human Resources|Networking|Psychology|Recruiting|Social Media,2318000.0,USA,3,11,497,15694,16191,0
Analytics|Business Intelligence|Collaboration|Enterprise Software|SaaS,101199993.0,USA,9,34,2240,14083,16323,0
Food Processing,1250000.0,USA,1,1,0,16622,16622,0
Coupons|Sales and Marketing|Shopping|Software,1115520.0,ESP,1,2,0,15019,15019,0
Software,500000.0,USA,1,1,0,16378,16378,0
Delivery|Hospitality|Local|Organic Food,52500000.0,USA,6,27,1197,15187,16384,0
CRM|Email Marketing|Nonprofits|Sales and Marketing|Social CRM|Social Media,1650000.0,USA,4,5,871,15492,16363,0
Advertising,1247051.0,USA,2,3,529,14417,14946,0
News,500000.0,USA,1,5,0,14929,14929,0
E-Commerce,425000.0,USA,3,2,940,15187,16127,0
Biotechnology,60000000.0,USA,3,7,971,14862,15833,0
Analytics|Contact Management|Data Security|Development Platforms|Information Security|Mobile Commerce|Mobile Enterprise|Mobile Security|Mobility|Software,291297000.0,USA,6,18,3486,12857,16343,1
E-Commerce|Nonprofits|SaaS|Startups,25000.0,USA,1,1,0,15400,15400,0
Hospitality,1286600.0,IRL,1,3,0,16153,16153,0
Advertising|B2B|Groceries,89907.0,ITA,2,3,53,16283,16336,0
Finance|Personal Finance|Taxis,118000.0,USA,1,1,0,15838,15838,1
Biotechnology,16000000.0,USA,1,1,0,14096,14096,0
Messaging,2700000.0,IND,2,4,176,16581,16757,0
Apps|Mobile|Mobile Commerce|Mobile Payments|Web Development,115000.0,USA,1,1,0,14709,14709,0
Charity|E-Commerce,100000.0,USA,1,1,0,16336,16336,0
Entertainment|Film|Reviews and Recommendations|Social Media,170000.0,USA,2,1,153,15218,15371,0
Consumers|Curated Web|Environmental Innovation|Health and Wellness|Internet|iPhone|Reviews and Recommendations,14229998.0,USA,3,6,949,14263,15212,1
Health and Wellness,70000000.0,USA,1,1,0,16533,16533,0
Email|Email Marketing|Messaging,45000000.0,USA,4,10,1183,13073,14256,0
Health Care,26511.0,KOR,1,1,0,15553,15553,0
Interface Design|Rapidly Expanding|Software|Startups,1000000.0,JPN,1,1,0,16040,16040,0
Curated Web|Networking|Textbooks,2750000.0,USA,2,8,769,13818,14587,1
Health Care,1500000.0,USA,2,9,1436,15279,16715,0
Internet,1600000.0,IND,1,1,0,16609,16609,0
Local|Local Businesses|Local Commerce|Mobile Commerce|Mobile Payments,540000.0,USA,3,7,547,16040,16587,0
Content Discovery|E-Commerce|Reviews and Recommendations|Video,347531.0,GRC,1,1,0,16455,16455,0
College Recruiting|Education|Recruiting|Social Media,1220000.0,CHE,1,3,0,16071,16071,0
E-Commerce,450000.0,RUS,1,1,0,15949,15949,0
Charity|Social Commerce|Social Fundraising,2144000.0,USA,2,3,173,16450,16623,0
Blogging Platforms|Email|Information Technology|Search|Software|Video Streaming,26100000.0,USA,3,7,310,10439,10749,1
Internet|Media|Mobile|Social Media,11852030.0,FRA,2,7,551,13848,14399,0
Apps|Games|Internet Radio Market|iPhone|Mobile|Music|Sales and Marketing,16000000.0,FRA,1,3,0,14348,14348,0
Enterprise Software,2110120.0,USA,3,1,1113,14554,15667,0
Games|Social Games|Social Media,40000.0,CAN,1,1,0,15323,15323,0
Classifieds|Real Estate|Realtors|Technology,1230000.0,CHL,3,3,306,15655,15961,0
Curated Web|Polling|Real Time|Web Tools,425000.0,USA,1,2,0,15182,15182,1
Consumer Electronics|Games|Social Television|Television,250000.0,USA,1,1,0,16059,16059,0
3D|Hardware|Hardware + Software|Lifestyle Products|Video|Wearables,288205000.0,USA,3,6,820,14874,15694,1
Delivery|E-Commerce|Groceries|Logistics|Mobile|Retail|Software,3250000.0,USA,1,1,0,16749,16749,0
Consumer Electronics|Fitness|Lifestyle,13400000.0,USA,4,4,694,16071,16765,0
E-Commerce,580000.0,MYS,2,3,743,16010,16753,0
Biotechnology,1000000.0,ISR,1,2,0,16728,16728,0
Algorithms|Diagnostics|Health and Wellness|Health Care|Medical|Venture Capital,1153846.15384615,AUS,1,1,0,15251,15251,0
Finance|Real Estate,3996000.0,USA,6,34,1026,15737,16763,0
Software,40000.0,CHL,1,1,0,15670,15670,0
Advertising|Curated Web|Internet|Media|Sales and Marketing|Technology|Video,50000000.0,USA,1,1,0,13651,13651,0
Travel & Tourism,160000.0,IND,1,1,0,16510,16510,0
E-Commerce|Product Design|Retail,25000.0,ARG,1,1,0,16130,16130,0
Mobile Advertising,785000.0,USA,2,1,366,15340,15706,0
Consumers|Databases|E-Commerce|Location Based Services|Marketplaces|Mobile|Startups,75000.0,USA,1,2,0,15126,15126,0
Advertising|Automotive|Sales and Marketing|Social Media,750000.0,USA,1,1,0,14245,14245,0
Brand Marketing|Enterprise Software|Finance|Market Research|Mobile|Retail,9462508.0,USA,7,4,1464,15187,16651,0
EdTech|Education|Services|Technology,132564.0,IRL,3,3,393,15737,16130,0
Consumer Electronics|Hardware|Hardware + Software|Messaging|Mobile|Peer-to-Peer|Privacy,5836950.0,USA,2,4,562,16041,16603,0
Big Data|Data Security|Enterprise Software,13000000.0,USA,2,6,580,15065,15645,0
Manufacturing,16674.0,SVN,1,1,0,16616,16616,0
Advertising|Android|Apps|Big Data Analytics|Consumer Electronics|Internet of Things|NFC|Software|Wireless,400000.0,USA,2,3,1402,15279,16681,0
Curated Web|Data Integration|Development Platforms|Media,26000000.0,USA,3,5,733,12022,12755,1
Mobile,28000000.0,USA,3,4,1791,12843,14634,1
Hospitality,1773965.0,ITA,3,6,526,16049,16575,0
Consumer Goods|Food Processing|Specialty Foods,8000000.0,USA,1,1,0,13887,13887,0
E-Commerce,55000.0,GBR,1,1,0,15065,15065,0
Internet|Online Reservations|Restaurants,300000.0,IND,1,2,0,16370,16370,0
E-Commerce,11408356.0,GBR,4,5,357,15971,16328,0
Clean Technology,12638000.0,DEU,1,3,0,15589,15589,0
Business Services,5015781.98067657,GBR,1,1,0,16752,16752,0
Business Intelligence,20000000.0,USA,1,3,0,16562,16562,0
Advertising|Sales and Marketing|Social Media Advertising,8820000.0,GBR,1,1,0,14327,14327,1
Internet,11500000.0,USA,1,6,0,16649,16649,0
Curated Web|Location Based Services|Photography|Private Social Networking|Reviews and Recommendations|Social Media|Travel,10400001.0,USA,3,12,701,13936,14637,1
Corporate Training|Education|Online Education,1000000.0,HKG,1,2,0,16511,16511,0
Human Resources|Marketplaces|SaaS|Temporary Staffing,20532.0,EST,1,1,0,16116,16116,0
Career Management|Social Media,600000.0,USA,1,1,0,15715,15715,1
Real Estate,200000.0,USA,1,1,0,15831,15831,0
Big Data|Web Development|Web Hosting,40000.0,CHL,1,1,0,15380,15380,0
Hardware + Software,40000.0,DEU,1,1,0,13483,13483,0
Developer APIs|Developer Tools|Web Development,5400000.0,USA,1,1,0,16386,16386,0
Hardware + Software|Software|Startups,750000.0,USA,1,1,0,16222,16222,0
Delivery|Enterprises|Restaurants,1000000.0,IND,1,2,0,16552,16552,0
Advertising,24500000.0,USA,3,8,2109,13411,15520,1
Apps,1850252.86789195,GBR,1,9,0,16486,16486,0
CAD|Curated Web|Finance|Manufacturing,13618793.0,USA,6,18,1019,14610,15629,1
Software,40000.0,USA,1,1,0,15566,15566,0
Real Estate,13000000.0,IND,4,5,625,16091,16716,0
E-Commerce|Mobile Commerce|Retail|Shopping|User Experience Design,1350000.0,USA,2,2,253,16300,16553,0
Facebook Applications|Social Media|Social Network Media|Twitter Applications,40000.0,IND,1,1,0,15145,15145,0
Manufacturing,10636600.0,USA,3,6,605,15985,16590,0
Travel,680000000.0,SGP,5,15,499,16167,16666,0
Advertising|Television|Video,2000000.0,GBR,1,4,0,16399,16399,0
E-Commerce,20800000.0,USA,1,1,0,16199,16199,0
Automotive|Music|Sports|Video,33400000.0,USA,3,5,1086,11939,13025,1
CRM|Digital Media|SaaS|Software,4447626.0,USA,2,6,893,15600,16493,0
Analytics|Education|Productivity Software|Skill Assessment,18000.0,USA,1,1,0,15857,15857,0
Analytics,130272724.0,USA,2,1,1667,14642,16309,0
Mobile,3750000.0,USA,1,10,0,15511,15511,1
Education|Recruiting|Social Media,928793.0,DNK,2,1,983,14861,15844,0
Career Management|Education|Networking|SaaS,1100000.0,GBR,2,4,840,15757,16597,0
Messaging,1806747.0,GBR,1,1,0,15413,15413,0
Hardware + Software,835000.0,USA,1,3,0,15845,15845,0
Art|Curated Web|Facebook Applications,1600000.0,GBR,1,6,0,15309,15309,0
Hardware + Software,20000.0,USA,2,1,203,14396,14599,1
Art|Games|Social Games,125000.0,USA,3,1,651,15134,15785,0
Health Care|Health Diagnostics|Medical Devices|Mobile Health,1200000.0,USA,1,1,0,16665,16665,0
Local Businesses|Mobile,20000000.0,USA,1,3,0,14181,14181,0
Babies|Direct Sales|E-Commerce,66674.0,FRA,1,1,0,14975,14975,0
Software,5420000.0,FRA,1,2,0,13056,13056,0
Games|Mobile Games,1200000.0,TUR,3,8,703,15737,16440,0
Android|Games|iOS|Mobile|Social Games|Social Network Media|Tablets,5476000.0,USA,7,5,863,15359,16222,0
Real Estate,2300000.0,IND,1,1,0,15943,15943,0
Finance,21556050.0,IND,2,1,163,16043,16206,0
Consumers|Design|E-Commerce,2150000.0,USA,2,1,335,16308,16643,0
E-Commerce|Fashion,2500000.0,HKG,2,3,278,16360,16638,0
EdTech|Education|Technology,1250000.0,USA,1,1,0,15856,15856,0
Games,13000000.0,FIN,3,9,815,15100,15915,0
Health and Wellness|Health Care|Knowledge Management,410000.0,USA,4,5,762,15799,16561,0
Health and Wellness|Health Care|Healthcare Services,106000000.0,USA,4,10,1692,14975,16667,0
Hardware + Software,1300000.0,USA,1,9,0,15798,15798,0
Analytics|Big Data,600000.0,USA,2,2,723,15522,16245,0
Digital Media|Health Care Information Technology|Medical,500000.0,USA,1,1,0,16451,16451,0
Mobile|Telephony|VoIP,4000000.0,USA,1,1,0,13149,13149,1
Internet|Telecommunications|Television,45000000.0,USA,1,3,0,12335,12335,0
Semiconductors,13020000.0,USA,2,6,794,12080,12874,1
Cloud Computing|Collaboration|Enterprise Software|Video Streaming,10300800.0,USA,3,1,2420,13894,16314,0
Analytics|Big Data|E-Commerce|Machine Learning|Optimization,8500000.0,CAN,3,25,1028,15553,16581,0
Web Hosting,2000000.0,CAN,1,1,0,15827,15827,0
Health Care,100000.0,USA,1,1,0,14568,14568,0
Advertising|Games|Mobile|Mobile Games|Online Gaming|Social Games|Startups,5975000.0,USA,3,9,1210,15126,16336,0
Agriculture|Analytics|SaaS,27258523.0,USA,2,11,563,16124,16687,0
Ad Targeting|Advertising|Software,5745506.0,USA,2,3,1568,14589,16157,0
Advertising|Marketplaces,1150000.0,USA,2,3,469,16007,16476,0
Big Data|Cloud Computing|Databases|Interest Graph|Internet of Things|Predictive Analytics|SaaS|Web Hosting,315000.0,USA,2,2,121,16165,16286,0
Analytics|Data Visualization|Internet,500000.0,USA,2,1,800,15581,16381,0
Analytics,3000000.0,USA,3,13,658,15293,15951,0
Clean Technology,500000.0,USA,1,1,0,14257,14257,0
Nanotechnology,2345000.0,USA,2,2,304,15968,16272,0
Manufacturing,1286600.0,USA,1,1,0,16045,16045,0
Nanotechnology,20000.0,USA,1,1,0,15949,15949,0
Analytics|Big Data|E-Commerce|Machine Learning|Predictive Analytics,225000.0,ZAF,1,2,0,16090,16090,0
Comics|Entertainment|Film|Games|Graphics|Mobile|Publishing|Television,5300000.0,SGP,2,6,793,15720,16513,0
Advertising|Digital Media|Entertainment|Finance|Publishing,10024049.0,USA,7,18,1490,14462,15952,1
Big Data|Databases|Data Visualization|Market Research|Reviews and Recommendations|Search|Semantic Web,17000000.0,USA,3,5,825,14944,15769,0
App Marketing|Data Security|Enterprises|File Sharing|Mobile|Mobile Security|Software,4400000.0,USA,1,1,0,15875,15875,0
Machine Learning|Software,25250000.0,USA,2,6,604,15839,16443,0
Advertising|Big Data|Consumer Goods|Facebook Applications|Social Media,3179999.0,USA,4,2,1597,14802,16399,1
Big Data|Databases|Enterprises|Real Time,2546269.0,USA,2,6,48,16023,16071,0
Networking|Social Media|Video,2500000.0,USA,1,1,0,14070,14070,0
Broadcasting|Media|Professional Services|Training,36000000.0,USA,1,1,0,11477,11477,1
CRM|Mobile,700000.0,USA,3,3,924,15315,16239,0
Curated Web|News|Social Media|Social News,650000.0,USA,1,4,0,16344,16344,0
Health and Wellness|Insurance,25600767.0,USA,3,6,595,15947,16542,0
Cloud Data Services|Information Technology|Software,40259004.0,USA,3,5,799,15579,16378,1
Sensors|Technology|Wireless,35000000.0,USA,2,10,531,11017,11548,0
Advertising|Interest Graph|Personalization,20600000.0,USA,2,6,1250,14365,15615,1
Ad Targeting|Advertising|Big Data Analytics|Data Mining|E-Commerce|Machine Learning|Personalization|Reviews and Recommendations,3000000.0,HUN,2,1,259,14974,15233,0
Technology,14000000.0,USA,3,3,1347,15186,16533,0
Transportation,3100000.0,USA,2,3,61,15584,15645,0
Biotechnology,3990000.0,USA,3,3,493,16007,16500,0
Analytics|Enterprise Software|Open Source|Software,4400000.0,USA,2,8,436,16034,16470,0
Advertising,1800000.0,SGP,1,5,0,15308,15308,0
E-Commerce,1400000.0,USA,1,3,0,14439,14439,0
Games,7500000.0,CHN,4,6,1188,13269,14457,0
Medical Devices,1900000.0,USA,1,1,0,16699,16699,0
Biotechnology,17070531.0,USA,5,8,2577,13747,16324,0
Software,15881418.0,CHN,1,1,0,15400,15400,0
Mobile,74707100.0,USA,3,8,812,13726,14538,0
Clean Energy|Clean Technology,562000000.0,USA,6,10,2285,13102,15387,0
E-Commerce|Fashion|Shoes,3000000.0,USA,2,6,268,16174,16442,0
Games|Mobile|Mobile Games|Mobile Social|Social Network Media,152197921.0,JPN,4,2,2664,12607,15271,1
E-Commerce,10000.0,USA,1,1,0,15706,15706,0
Health and Wellness,20673981.0,CHN,3,2,549,14669,15218,0
Curated Web,132000000.0,IRL,3,3,247,15706,15953,0
Biotechnology,40000.0,CHL,1,1,0,15911,15911,0
Biotechnology,118248563.0,GBR,8,26,2652,13804,16456,0
Food Processing,900000.0,USA,3,6,331,16322,16653,0
Batteries|Clean Technology|Smart Grid,56000000.0,USA,2,3,240,16040,16280,0
Food Processing|Health and Wellness|Organic Food,15500000.0,USA,2,4,134,16405,16539,0
Clean Technology,75000.0,USA,1,1,0,14978,14978,0
Mechanical Solutions,765120.0,FRA,1,1,0,16364,16364,0
Finance|FinTech,33000000.0,USA,4,4,2891,11323,14214,1
Services,19299.0,ESP,1,1,0,16020,16020,0
Clean Energy|Clean Technology|Green,2835588.0,GBR,3,2,1898,14137,16035,0
Clean Technology,780000.0,GBR,1,1,0,14030,14030,0
Agriculture|Biotechnology|Life Sciences|Technology,6000000.0,USA,1,1,0,16309,16309,0
Clean Technology,17802942.0,GBR,5,5,1017,15340,16357,0
E-Commerce|Games|Social Commerce|Social Media Marketing|Video Games,147159.0,GBR,1,1,0,15187,15187,0
Clean Energy|Enterprise Software|Technology,2704277.83293835,ESP,6,9,730,15826,16556,0
Android|Apps|Green|iPad|iPhone|iPod Touch|Marketplaces|Music|Outdoors|Social Media,9075000.0,USA,5,5,1207,14730,15937,0
Hospitality,184934.0,DEU,1,1,0,15767,15767,0
Construction,100000.0,USA,1,1,0,16260,16260,0
Games,6000000.0,USA,1,2,0,15553,15553,1
Clean Technology,5400000.0,ISR,1,1,0,14042,14042,0
Chemicals|Clean Technology|Intellectual Property,600000.0,USA,3,8,237,16421,16658,0
Hospitality,5825000.0,USA,3,3,675,15922,16597,0
Big Data|Big Data Analytics|Business Development|Business Information Systems|Business Intelligence|Data Integration|Internet of Things|M2M|Open Source|PaaS|SaaS|Smart Grid|Software|Utilities,144060.0,NOR,1,1,0,14610,14610,0
Biometrics|Environmental Innovation|Services,3350245.0,ITA,1,3,0,16701,16701,0
Clean Technology|Hardware + Software|Home Automation|Internet of Things|Water,450000.0,USA,2,1,55,15826,15881,0
Environmental Innovation|Green|Waste Management,50000.0,USA,1,1,0,14365,14365,0
Finance,400000.0,FRA,1,1,0,15227,15227,0
Software,1500000.0,NZL,2,3,847,14770,15617,1
Enterprise Software,42500002.0,USA,7,6,1651,14379,16030,1
Agriculture|Environmental Innovation|Waste Management,140000.0,KEN,1,2,0,16495,16495,0
Enterprise Software,20896797.0,USA,7,6,1532,15218,16750,0
E-Commerce,40000000.0,IND,1,3,0,15519,15519,0
Clean Energy|Curated Web|Environmental Innovation|Hardware + Software,43720.0,IRL,1,1,0,15130,15130,0
Point of Sale|Services|Technology,74966.0,GBR,1,1,0,16457,16457,0
Clean Technology|Media|News,1400000.0,USA,1,1,0,14057,14057,0
Software,2000000.0,FRA,1,2,0,14810,14810,0
Mobile,1000000.0,CAN,1,2,0,16008,16008,0
Android|Apps|App Stores|iOS|iPhone|iPod Touch|Mobile,100000.0,USA,2,1,3,15810,15813,0
Clean Technology,14300000.0,CAN,2,3,122,14947,15069,0
Hardware + Software|Health and Wellness|Lifestyle|Sensors,1200000.0,USA,2,5,27,15028,15055,0
Android|Developer Tools|Enterprise Software|iOS|SaaS,200000.0,EST,1,1,0,16071,16071,0
Recruiting|SaaS|Software,60130270.0,USA,6,20,1210,15461,16671,0
Financial Services|Investment Management|Venture Capital,45031000.0,ITA,1,3,0,16082,16082,0
Clean Technology,241983286.0,IND,2,1,1730,14637,16367,1
Innovation Management|Manufacturing|Portals|Rental Housing,455204.0,FRA,1,1,0,16470,16470,0
Clean Technology,5500000.0,USA,2,4,643,15897,16540,0
Clean Technology,541712.0,ISR,1,1,0,14201,14201,0
Networking|Social Media|Social Search,40264.0,GBR,1,1,0,15175,15175,0
Biotechnology,27000000.0,USA,3,4,709,15929,16638,0
Clean Technology,14000000.0,USA,2,2,1022,15448,16470,0
Clean Energy|Clean Technology|Environmental Innovation|Green|Technology,20000000.0,USA,1,1,0,13939,13939,0
Delivery|Hospitality|Local|Organic,10455846.0,USA,4,2,531,15720,16251,0
Advertising|Consulting|Group Buying|Performance Marketing|Social Commerce,3500000.0,USA,1,1,0,14469,14469,0
Clean Technology,7000000.0,USA,2,3,1003,14123,15126,0
Manufacturing,17000000.0,CAN,2,3,951,15429,16380,0
Mobile,460000.0,KOR,1,1,0,15517,15517,0
Education|Finance,4200000.0,USA,1,2,0,13787,13787,1
Content Creators|Sustainability,40000.0,USA,1,1,0,15180,15180,0
Biotechnology,7062120.0,DEU,1,4,0,13477,13477,0
Semiconductors,31338462.1019442,NLD,3,10,1255,13291,14546,0
Software,5806037.0,USA,2,1,389,15233,15622,1
Analytics|Big Data|Business Intelligence|Collaboration|Databases|Software|Video,92899155.0,USA,5,17,1112,13208,14320,1
Clean Technology,4000000.0,USA,2,3,14,14426,14440,0
Cars|Clean Technology|Diving|Green|Internet|Software,98900000.0,GBR,7,22,3383,13136,16519,0
Energy,17177795.0,USA,2,1,89,16589,16678,0
Accounting|Security,14400000.0,ISR,3,11,1652,14517,16169,0
News,4575000.0,USA,3,8,812,13657,14469,0
E-Commerce Platforms|Marketplaces,1195000.0,USA,3,3,507,15825,16332,0
Clean Technology,7000000.0,USA,1,1,0,15131,15131,0
Clean Technology,96800000.0,USA,5,5,1308,14123,15431,0
Clean Technology,7945200.0,BEL,1,4,0,15407,15407,0
Home Automation|Software,41250672.0,USA,3,2,1211,14777,15988,0
Business Services|Software|Technology,22000000.0,USA,1,2,0,13453,13453,1
Software,5900000.0,USA,6,7,1767,14245,16012,0
E-Commerce|Flowers|Gift Card|Personalization,15870000.0,NLD,2,3,550,13770,14320,0
Facebook Applications|Opinions|Psychology|Sales and Marketing|Social Media|Software|Twitter Applications,1883452.0,USA,6,6,1159,15218,16377,0
Broadcasting,3100000.0,USA,1,1,0,12369,12369,0
Financial Services,625000.0,IND,1,2,0,16651,16651,0
Games|Mobile Games,2500000.0,FIN,2,6,114,14914,15028,0
Advertising|Media,25107724.0,USA,5,10,1056,13433,14489,1
Application Platforms|Innovation Management|Startups|Technology,3000000.0,IND,1,2,0,16315,16315,0
E-Commerce Platforms|Enterprise Software|Mobile Commerce,1500000.0,USA,1,1,0,16664,16664,0
Mobile|SaaS|Software|Wireless,12400000.0,USA,2,5,412,16311,16723,0
Software,6750000.0,USA,3,9,686,13768,14454,0
Hardware + Software|Utilities,15130688.0,USA,3,1,117,16128,16245,0
Software,9349999.0,USA,5,2,1972,14525,16497,0
Environmental Innovation,1500000.0,ISR,1,1,0,16405,16405,0
Software,5000000.0,USA,2,3,360,12606,12966,1
Clean Technology,42499992.0,USA,4,10,1086,15166,16252,0
Security,95000.0,USA,2,1,132,15820,15952,0
Clean Energy|Home Automation|Semiconductors|Smart Grid,560000.0,SGP,1,1,0,15743,15743,0
Big Data Analytics|Business Intelligence|SaaS|Software|Startups,2200000.0,USA,1,5,0,16289,16289,1
Analytics|Big Data|Cloud Infrastructure|Transaction Processing,12500000.0,USA,2,4,602,15313,15915,0
Software,8267939.0,CAN,3,1,1267,13970,15237,0
Big Data|Big Data Analytics|Hardware + Software,13000000.0,USA,1,3,0,15340,15340,1
Software,1754998.0,USA,2,5,302,15474,15776,0
Cloud Computing|Collaboration|Enterprises|Enterprise Software|File Sharing|Messaging|SaaS|Task Management,130000.0,IND,4,6,783,15937,16720,0
Web Hosting,200000000.0,USA,1,2,0,14132,14132,0
Content Delivery|Games|Peer-to-Peer|Video Streaming,20500000.0,USA,3,4,870,13149,14019,0
Clean Technology|Energy Management|Sustainability,307588886.0,USA,11,13,3104,13149,16253,1
Software,8000000.0,USA,1,2,0,13720,13720,0
Technology,249999.0,USA,2,6,304,16451,16755,0
Finance,10000000.0,USA,2,5,763,13210,13973,0
Cloud Computing|Cloud Infrastructure,25470400.0,USA,3,10,1071,14972,16043,0
Clean Technology,969000.0,USA,1,1,0,15772,15772,0
Communities|Public Safety|Technology,190000.0,MEX,2,2,487,16222,16709,0
Advertising|Curated Web|Customer Service|Mobile,270000.0,USA,3,1,512,16048,16560,0
Education,100000.0,USA,1,1,0,16650,16650,0
Health Care,102000000.0,USA,1,7,0,16728,16728,0
Delivery|Groceries|Internet,710000.0,USA,2,5,110,16472,16582,0
Software,8050000.0,USA,1,1,0,13755,13755,0
Comparison Shopping|Coupons|Curated Web|Groceries,1375000.0,USA,3,3,608,14202,14810,0
Certification Test|Education|Games|Kids|MMO Games|Testing,44720000.0,USA,7,23,2761,13514,16275,1
Consumer Electronics|Groceries|Pharmaceuticals|Retail,165500000.0,IND,4,8,353,16412,16765,0
Health and Wellness|Video,15500000.0,USA,2,8,95,16041,16136,0
Mobile,3900000.0,USA,2,4,296,15336,15632,0
3D Technology|Mass Customization|Retail,250000.0,USA,3,2,733,15819,16552,0
Social Media,3565000.0,USA,2,2,608,13149,13757,0
Big Data|Brand Marketing|Curated Web|Publishing|Real Time,200000.0,FRA,1,2,0,15636,15636,0
File Sharing|Internet TV|Mobile|Photography|Social Media|Social Network Media|Social Television|Television|Video|Video Streaming,700000.0,USA,3,1,180,16134,16314,0
Curated Web|Internet|Private Social Networking|Social Media,626341.0,ESP,4,8,280,16142,16422,0
Big Data|Cloud Computing|Software,150000.0,USA,1,1,0,16028,16028,0
CRM,28000.0,USA,1,1,0,16111,16111,0
Biotechnology,9900000.0,USA,2,9,595,14725,15320,0
Advertising|Displays|E-Commerce,25000.0,ARG,1,1,0,15187,15187,0
Software,2200000.0,USA,3,5,230,15266,15496,1
Clean Technology|Commercial Solar,12500000.0,USA,2,6,181,13865,14046,0
Collaboration|Social Media,5000000.0,USA,3,3,1003,14031,15034,0
Big Data Analytics|Mobile,2000000.0,USA,1,3,0,15789,15789,0
Real Estate,1000000.0,USA,2,2,299,16002,16301,0
Limousines|Travel,20000000.0,USA,1,1,0,13974,13974,0
Hardware + Software,7541000.0,USA,5,10,1137,15349,16486,0
Cloud Computing|Cloud Management|Data Centers|Software|Virtualization,29000000.0,USA,4,11,1967,12563,14530,0
Coupons|E-Commerce|Group Buying,39000000.0,USA,3,13,728,14761,15489,0
Cyber Security|Data Security|Fraud Detection,938000.0,RUS,2,2,36,15609,15645,0
Construction|Energy|Innovation Engineering,8443200.0,FRA,1,2,0,14636,14636,0
Apps|Collaboration|Communities|Private Social Networking,120000.0,USA,1,2,0,16405,16405,0
Price Comparison|Retail|Software,50907890.0,ESP,4,19,456,14739,15195,0
Big Data|E-Commerce|Enterprise Search|Software,3300000.0,CAN,2,1,928,15708,16636,0
Software,2880000.0,FRA,2,3,252,12800,13052,0
Internet,137607.0,FRA,1,1,0,16157,16157,0
Messaging,500000.0,USA,1,1,0,14937,14937,0
Data Integration|Employer Benefits Programs|Health and Insurance|Human Resources|Software Compliance,220000.0,USA,2,1,35,16436,16471,0
Hospitality,4000000.0,USA,2,8,398,15896,16294,0
Consumer Lending|Finance Technology|FinTech|Peer-to-Peer,10200000.0,CAN,2,2,322,16343,16665,0
Social Network Media|Software,2600000.0,USA,3,11,227,13665,13892,0
Messaging|Mobile|Social Media,11450000.0,USA,2,19,132,14846,14978,1
Advertising|Discounts|Internet|Local Commerce|Retail|Social Media|Technology,1137000000.0,USA,6,23,1516,13514,15030,1
Internet Service Providers,20000000.0,IND,1,1,0,16504,16504,0
Software,1300000.0,GBR,2,11,911,13879,14790,0
Design|Finance|Marketplaces|Software,1000000.0,USA,2,4,471,15279,15750,0
Collaboration|Email|Enterprises|Enterprise Software,28000.0,USA,2,2,334,15645,15979,0
Analytics,3000000.0,USA,1,1,0,13426,13426,0
Travel,1000000.0,USA,2,1,267,16042,16309,0
Lifestyle|Online Dating|Social Network Media,200000.0,HKG,1,1,0,16470,16470,0
Agriculture|Organic Food,4315412.0,USA,6,9,781,15963,16744,0
Curated Web|EdTech|Education|Enterprises|Enterprise Software|Freemium|Human Resources|SaaS|Systems|Video,22023992.0,USA,3,19,1265,15219,16484,0
Analytics|Software,1500000.0,USA,1,7,0,16415,16415,0
App Marketing|Apps|Mobile|Mobile Games,1000000.0,USA,1,2,0,15584,15584,1
Communities|DIY|Home & Garden|Internet|Lifestyle|Organic|Social Media|Social Network Media|Sustainability|Tutoring,564400.0,ITA,2,2,538,15094,15632,0
B2B|Lead Generation|SaaS|Sales Automation,600000.0,USA,1,2,0,16732,16732,0
Gift Card|Social Media|Startups,634533.0,ITA,3,4,1244,15309,16553,0
Enterprise Software|Information Technology|Social Network Media,40000.0,IND,2,2,128,16222,16350,0
Marketplaces|Sales and Marketing|Temporary Staffing,118000.0,USA,1,1,0,16622,16622,0
Big Data|Business Intelligence|Business Services|Enterprise Software|Real Time|Risk Management|Sales and Marketing,3400000.0,GBR,1,1,0,16500,16500,0
Electronics|Networking|Systems,16000000.0,USA,1,3,0,10925,10925,1
Enterprise Software,64000.0,PRT,1,1,0,13336,13336,0
Financial Services,7618892.82249503,GBR,1,2,0,16759,16759,0
Enterprise Software,16000000.0,USA,2,3,664,12724,13388,0
Business Services|Delivery|Hospitality|Restaurants,84100000.0,USA,6,13,2120,13818,15938,1
E-Commerce|Organic Food|Specialty Foods,12100000.0,USA,2,14,234,16462,16696,0
E-Books|E-Commerce|Publishing,6772388.0,BRA,1,1,0,14517,14517,0
Health and Wellness,26148000.0,ESP,1,1,0,15336,15336,0
Content|Entertainment|Facebook Applications|Film|Games|Reviews and Recommendations,19311.0,GBR,1,1,0,14858,14858,0
Concerts|Entertainment|Events|Marketplaces|Music|Social Commerce,33174.0,BGR,1,1,0,15959,15959,0
Logistics,150000.0,USA,1,1,0,16374,16374,0
Mobile,2160000.0,USA,3,2,902,15584,16486,0
Search|SEO|Social Media|Software,3001390.0,CAN,4,4,1475,14791,16266,0
Software,11753046.0,USA,2,2,1412,13604,15016,1
Information Technology|Services|Technology,13500000.0,USA,3,7,804,11620,12424,1
Manufacturing,6000000.0,USA,1,2,0,13458,13458,0
Semiconductors|Technology,23250000.0,USA,6,8,1869,12607,14476,0
Pharmaceuticals,84682455.0,USA,3,3,4114,12284,16398,1
Advertising,19650002.0,USA,4,2,574,16111,16685,0
E-Commerce,10000000.0,CHN,1,1,0,16260,16260,0
Communities|Disruptive Models|Innovation Management|Life Sciences|Marketplaces|Monetization|Open Source|Social Innovation|Technology,356920.391107898,EST,2,2,123,16344,16467,0
Health and Wellness|Health Care|Medical,495000000.0,CHN,2,6,346,16356,16702,0
Advertising,7653826.0,CHN,1,2,0,14944,14944,0
Health and Wellness,7861635.0,CHN,1,1,0,15279,15279,0
Web Hosting,2200000.0,CHN,1,1,0,14412,14412,0
E-Commerce,4100000.0,CHN,2,3,792,14214,15006,0
Biotechnology,2929687.0,CHN,2,2,334,14245,14579,0
Mobile,6003001.0,CHN,2,2,1619,14944,16563,0
Travel,1000000.0,CHN,1,1,0,16040,16040,0
Manufacturing,1904761.0,CHN,3,1,456,14975,15431,0
Software,5520000.0,CHN,2,1,578,10592,11170,0
Education,4000000.0,CHN,1,1,0,14907,14907,0
Health and Wellness|Health Diagnostics,90000000.0,USA,4,12,970,15499,16469,0
Security,25000000.0,USA,1,8,0,11562,11562,1
Defense|Oil|Security,185924.0,GBR,1,1,0,16191,16191,0
Security,44300000.0,USA,6,12,3228,13149,16377,0
Enterprise Software,19500000.0,USA,3,11,777,12940,13717,1
Network Security|Security,11000000.0,ISR,1,2,0,16300,16300,0
Databases|Hardware + Software|Networking|Security,11800000.0,USA,2,9,278,13007,13285,1
Enterprises|Mobile|Mobile Emergency&Health|Security,2592379.0,CAN,3,14,1034,15065,16099,0
Mobile|Real Time|Security,137164.0,CHL,2,2,273,16222,16495,0
Biotechnology|Health Diagnostics,17500000.0,USA,3,7,1596,11495,13091,1
Banking|Content|E-Commerce|Music|Payments|Social Games|Virtual Goods,250000.0,ARG,1,1,0,14612,14612,0
Collaborative Consumption|Marketplaces|Peer-to-Peer|Pets,481599.0,ESP,3,3,420,15832,16252,0
Games|Green|Mobile Games|Social Games|Sustainability,500000.0,USA,1,1,0,14944,14944,0
Infrastructure|Mobile|Networking|Semiconductors|Wireless,5884000.0,USA,7,3,743,15830,16573,0
News,560000.0,USA,1,5,0,15944,15944,0
Travel,5250000.0,USA,2,4,770,13669,14439,0
Mobile,4950000.0,CAN,4,18,1219,14791,16010,0
E-Commerce|Hospitality|Hotels|Travel,800000.0,USA,1,6,0,15187,15187,0
Software,450000.0,USA,1,1,0,14323,14323,0
Finance Technology|Financial Services|FinTech|Personal Finance,7000000.0,BRA,3,16,780,15887,16667,0
Consumers|E-Commerce|Information Services|Internet|Local Advertising|Service Providers|Social Media Marketing,1025000.0,ARG,3,1,1065,14700,15765,0
E-Commerce,47000000.0,USA,1,2,0,10934,10934,0
Apps|Guides|Software|Television,2500000.0,USA,2,12,147,15741,15888,0
Financial Services|FinTech|Personal Finance,450000.0,USA,1,1,0,15765,15765,0
Internet|Mobile,10000000.0,USA,1,2,0,16632,16632,0
Content|DIY|Education|Mobile,1500000.0,USA,3,20,942,15584,16526,0
Hardware + Software,250000.0,USA,1,1,0,15714,15714,0
Health and Wellness|Healthcare Services|Medical|Medical Devices,50000.0,USA,1,1,0,15636,15636,0
Finance|FinTech|Services|Small and Medium Businesses|Technology,2000000.0,USA,1,8,0,16664,16664,0
Big Data Analytics|Recruiting,900000.0,USA,1,1,0,16756,16756,0
Mobile,4950000.0,SWE,3,2,1977,14245,16222,0
E-Commerce|Lead Generation|Publishing,500000.0,CAN,1,1,0,16184,16184,0
Information Services|Mobile|Restaurants,125000.0,USA,1,1,0,16001,16001,0
Enterprise Software,42200000.0,USA,3,10,546,15944,16490,0
Consumer Goods,2100000.0,USA,1,4,0,16576,16576,0
Music,16500.0,USA,1,1,0,15551,15551,0
Curated Web|Social Network Media|Universities,158940.0,FRA,1,1,0,14727,14727,0
Advertising|Advertising Exchanges|Advertising Networks|Advertising Platforms|Brand Marketing|Digital Media|Image Recognition|Internet Marketing,36825000.0,USA,5,12,2735,13848,16583,0
Games,94000000.0,SGP,3,9,942,15313,16255,1
Mobile,830000.0,USA,1,3,0,16478,16478,0
E-Commerce,1265955.0,CAN,1,1,0,16057,16057,0
E-Commerce|Social Commerce,8100000.0,USA,2,10,89,15378,15467,0
Mobile Games,1300000.0,GBR,2,4,257,16388,16645,0
Mobile,24100000.0,JPN,3,6,503,15741,16244,1
Manufacturing,1633097.0,CHN,1,1,0,15979,15979,0
Health and Wellness,24970059.0,CHN,2,3,1127,13787,14914,0
Networking,20000000.0,JPN,1,2,0,16426,16426,0
Mobile,33000000.0,IND,3,8,1166,13504,14670,0
Education,759353.0,GBR,1,1,0,14168,14168,0
Business Services|Marketplaces|Market Research,16000000.0,USA,1,2,0,10925,10925,1
Software,5400000.0,USA,2,3,595,16084,16679,0
Publishing|Services|Technology,100000.0,USA,1,1,0,11136,11136,0
Development Platforms,750000.0,URY,1,2,0,16612,16612,0
Search,15000000.0,IND,2,1,365,13149,13514,0
Mobile Payments|Payments|Wearables,100000.0,GBR,1,2,0,16328,16328,0
Mobile,1800000.0,USA,2,1,138,16173,16311,0
Customer Service|Market Research|Software,22000000.0,USA,4,11,1841,14894,16735,0
Advertising|Cloud Computing|Collaboration|Databases|Digital Media|iPad|Publishing|Services|Software|Textbooks|Web Development,6433000.0,FRA,2,1,170,15853,16023,0
Art|Graphics|Publishing,50000.0,USA,1,1,0,15826,15826,0
Entertainment|Games,130362293.0,NOR,5,4,2517,14245,16762,0
Information Technology,77332.7421674821,GBR,1,1,0,16729,16729,0
Sales and Marketing|Social Media,20000.0,SRB,1,1,0,16040,16040,0
Analytics|Manufacturing|Service Providers,25000000.0,IND,1,1,0,13843,13843,0
E-Commerce|Groceries|Retail,118000.0,USA,1,1,0,16590,16590,0
Health and Wellness|Health Care|Medical Devices,420003.0,USA,2,1,933,15567,16500,0
Internet|Networking|Services,3000000.0,USA,1,2,0,12439,12439,0
Games|Networking|Web Tools,1000000.0,USA,2,3,457,13361,13818,1
Fitness|Health and Wellness|Health Care,19146472.0,GBR,2,2,1538,14720,16258,0
Curated Web|Fitness|Location Based Services|Mobile,20000.0,USA,1,1,0,15826,15826,0
Health and Wellness,677787.0,ESP,1,3,0,16465,16465,0
Health and Wellness,135000.0,IND,1,2,0,16441,16441,0
Health and Wellness,501794.656852702,BGR,6,6,821,15796,16617,0
Exercise|Wearables,2500000.0,CAN,1,4,0,16475,16475,0
Health Care,117296441.0,USA,10,15,3219,13537,16756,0
Internet|Local|Local Search|Mobile|Search,100000.0,NGA,1,1,0,14669,14669,0
Advertising,2000000.0,CHN,1,2,0,14060,14060,0
Public Relations,64795.0,ITA,1,1,0,12874,12874,1
E-Commerce,16900000.0,USA,3,4,524,14917,15441,0
3D|Chat|CRM|Entertainment|Services|Software|Virtual Workforces,129590.0,ITA,1,1,0,12874,12874,1
Mobile,37833.0,ITA,1,1,0,15584,15584,0
B2B|Consumer Internet|Design|Fashion|Retail|SaaS|Travel & Tourism,1929900.0,ITA,2,3,399,15747,16146,0
Software,508520.0,ITA,1,1,0,13330,13330,1
Translation,135000.0,TUR,1,2,0,16467,16467,0
Enterprise Software,302000.0,IRL,1,1,0,13180,13180,0
Hardware + Software,3954000.0,FRA,1,3,0,14078,14078,0
Energy|Utilities|Water,500000.0,USA,1,1,0,16512,16512,0
Clean Technology,19704871.0,USA,5,7,3339,12760,16099,0
Information Technology|Law Enforcement|Legal|Software,6500000.0,USA,1,1,0,12090,12090,0
Technology,285899.424173236,SWE,2,1,3659,12808,16467,0
Real Estate,3074566.0,GBR,1,1,0,15978,15978,0
Enterprise Software,6000000.0,USA,1,3,0,13362,13362,1
Tracking,40000.0,CHL,1,1,0,16222,16222,0
Health and Wellness,25000.0,USA,2,2,666,15860,16526,0
Health and Wellness,745000.0,USA,2,6,180,15200,15380,0
Real Estate,3371127.41737929,FRA,1,1,0,16610,16610,0
Architecture|Construction|Design|Local Businesses|Real Estate,866950.0,ESP,4,5,1240,14245,15485,0
Advertising|Curated Web,25000.0,ARG,1,1,0,15889,15889,0
Curated Web,150000.0,USA,1,1,0,15825,15825,0
Food Processing,4400000.0,JPN,1,4,0,16289,16289,0
Big Data|Human Resources|Marketplaces,140500.0,GBR,2,2,232,16390,16622,0
Education,217000.0,USA,3,5,586,14761,15347,0
Software,500000.0,IND,2,2,268,15857,16125,0
E-Commerce,40000.0,CHL,1,1,0,15973,15973,0
Security,34000000.0,USA,2,9,391,16219,16610,0
B2B|Biotechnology|Business Development|Business Services|Hardware|Hardware + Software|Mobile|Software,2159025.0,USA,4,57,1000,15623,16623,0
EdTech|Education|Training|Video Chat,175000.0,USA,1,1,0,16288,16288,1
Analytics|Big Data|Social Media,8700011.0,USA,2,2,309,16183,16492,0
Mobile,254680.0,JPN,1,1,0,16421,16421,0
Entrepreneur|Events|Search,40000.0,USA,1,1,0,15308,15308,0
Analytics|Big Data|Big Data Analytics|Business Intelligence|Software,16200000.0,USA,2,2,384,15268,15652,1
Biotechnology,5000000.0,USA,1,1,0,15099,15099,0
Clinical Trials|Medical Devices|New Technologies,264686.0,GBR,2,2,251,16134,16385,0
Education,1250063.0,KOR,1,2,0,15814,15814,0
Apps|Cars|Payments,10000000.0,CHN,1,2,0,16286,16286,0
Home Automation,364000000.0,IND,1,1,0,16047,16047,0
iPad|Mobile|Presentations|Productivity Software|Startups,4620949.0,USA,5,11,1650,15079,16729,0
Automotive|Location Based Services|Mobile|Real Time|Transportation,100600000.0,GBR,4,18,1025,15065,16090,0
Search,23500238.0,USA,6,8,1590,13453,15043,0
Networking|Web Hosting,4959580.0,CHN,1,1,0,14914,14914,0
Media,500000.0,USA,1,7,0,16485,16485,0
Software,7275635.0,ITA,1,1,0,11976,11976,1
Coupons|Discounts|Search|Social Commerce,9000000.0,USA,2,3,288,14826,15114,0
Health Care,4850000.0,USA,2,6,502,14890,15392,0
Collaboration|Enterprises|Messaging|Mobile,6080000.0,USA,3,10,691,15218,15909,1
Games,2000000.0,CAN,1,1,0,13879,13879,1
Security,1000000.0,USA,1,2,0,14979,14979,0
Health and Wellness|Health Care Information Technology|Wearables,1650000.0,USA,2,5,283,15908,16191,0
Clean Energy|Clean Technology|Environmental Innovation,27500000.0,USA,3,7,1029,13587,14616,0
Health Care,93890518.0,USA,10,3,2463,13636,16099,0
Hardware + Software,3000000.0,USA,1,1,0,15960,15960,0
Finance|Insurance|Risk Management,526666000.0,BMU,1,1,0,16040,16040,0
Games|Mobile,9300000.0,USA,3,12,944,15532,16476,0
Public Transportation,1250000.0,USA,2,7,331,16040,16371,0
Web Hosting,73000000.0,USA,3,16,1283,12443,13726,0
Curated Web|Services|Web Presence Management,1613875.0,FIN,1,1,0,15358,15358,0
Consumer Goods|Environmental Innovation|Specialty Foods|Technology,120000000.0,USA,5,34,1447,14975,16422,0
Software|Video Editing,500000.0,RUS,1,1,0,15706,15706,0
Health and Wellness,25000000.0,CHN,1,1,0,13879,13879,0
Biotechnology,116267844.0,USA,2,2,227,14540,14767,0
Apps|Education,100000.0,BRA,1,4,0,15553,15553,0
Mobile,60500000.0,USA,1,6,0,13403,13403,1
Games,25000.0,USA,1,1,0,16035,16035,0
Curated Web,800000.0,USA,2,8,366,13635,14001,0
Design|Handmade,125000.0,AUS,2,2,45,16448,16493,0
Email|Messaging|Productivity Software|Task Management,12110000.0,USA,5,6,1044,15279,16323,0
Health and Wellness|mHealth|Software,405000.0,GBR,2,2,9,15583,15592,1
Social Media,15391438.0,USA,3,6,1487,13683,15170,0
Mobile|Wireless,10000000.0,USA,2,9,360,13038,13398,1
Health Care|Medical|Medical Devices,50000.0,USA,1,2,0,15492,15492,0
Finance|FinTech,2196193.0,CHN,3,2,822,14457,15279,0
Apps|Big Data|Mobile|Recipes|Reviews and Recommendations|Social Network Media,4150000.0,USA,2,8,365,15949,16314,0
Art|Photography|Project Management,100000.0,USA,1,3,0,16101,16101,0
Artificial Intelligence|Hardware + Software|Robotics|Security,60000.0,USA,2,2,257,15719,15976,0
Games|Mobile,30000000.0,USA,1,4,0,13061,13061,1
B2B|SaaS|Sales Automation,8000000.0,USA,4,5,496,15664,16160,0
Enterprises|Service Providers|Wireless,1350000.0,USA,1,3,0,11607,11607,0
Crowdfunding|Mobile Payments|Social Fundraising,870000.0,USA,3,8,318,15949,16267,0
Mobile|Online Travel|Travel,13000000.0,HKG,1,1,0,16762,16762,0
Apps|Home & Garden|Services|Software,110728926.0,USA,6,19,1112,15629,16741,0
Consumers,500000.0,IND,1,2,0,16617,16617,0
Biotechnology,23600000.0,USA,3,6,2813,11283,14096,1
Android|Celebrity|iPhone|Media|Mobile|Photography|Social Media|Video|Video Streaming,2000000.0,USA,1,2,0,15902,15902,0
Advertising,1610280.0,GBR,1,1,0,15275,15275,0
Advertising,18000000.0,USA,2,5,482,13549,14031,0
Advertising,6200000.0,USA,1,1,0,16350,16350,0
Games,12000000.0,USA,3,4,1125,13573,14698,0
Curated Web,3500000.0,USA,2,17,626,15139,15765,0
Enterprise Software,3734372.0,CHN,2,1,943,14488,15431,0
Software,16236400.0,CHN,1,1,0,15279,15279,0
Biotechnology,7000000.0,CHN,2,2,591,14078,14669,0
Marketing Automation,4700000.0,IND,1,1,0,16604,16604,0
Career Management|Document Management|Health and Wellness|Software|Tracking,10000000.0,SWE,1,3,0,16251,16251,0
Software,2196193.0,CHN,2,2,273,14396,14669,0
Apps|Consumer Goods|Internet,16000000.0,CHN,1,2,0,16653,16653,0
Health Care,17760000.0,CHN,3,5,1520,13514,15034,0
Mobile,12000000.0,CHN,1,1,0,15201,15201,0
Mobile,162954.0,CHN,1,1,0,16130,16130,0
Manufacturing,6578947.0,CHN,1,1,0,14184,14184,0
Real Estate,50000000.0,CHN,1,1,0,15034,15034,0
EdTech|Education|K-12 Education|Underserved Children,7500000.0,USA,2,4,62,15675,15737,0
Mobile,3200000.0,USA,2,2,771,15522,16293,0
Software,45000000.0,IND,1,2,0,15294,15294,0
Apps|Content|Games|Health and Wellness|Psychology,11508015.0,USA,5,6,1184,15383,16567,0
E-Commerce,64640656.0,CHN,3,4,365,14669,15034,0
Application Platforms|Apps|Mobile,22000000.0,FRA,3,12,944,15765,16709,0
Consumer Goods|Distribution|Food Processing|Restaurants,650000.0,USA,1,1,0,15614,15614,0
Games,8750000.0,USA,3,3,623,15818,16441,0
Health and Wellness,5913947.0,GBR,1,1,0,15448,15448,0
Music,378812.0,GBR,1,1,0,16047,16047,0
Games,35000000.0,CHN,2,3,472,14791,15263,0
Apps|Business Services,70000.0,USA,2,2,417,16010,16427,0
Apps|Mobile|Property Management|Real Estate|SaaS,3676000.0,USA,2,4,946,15539,16485,0
Analytics|Information Technology|Internet|Services|Software,157450.0,BEL,1,1,0,15506,15506,0
Cars|Online Rental|Transportation,1580000.0,DEU,2,8,381,16343,16724,0
E-Commerce Platforms|Groceries|Mobile Commerce,12000000.0,IDN,2,9,188,16504,16692,0
App Marketing|Apps|Coupons|Discounts|E-Commerce|Location Based Services|Mobile|Mobile Commerce|Online Reservations|QR Codes|Retail|Sales and Marketing|Shopping,5600000.0,CHL,3,3,588,14914,15502,0
Pets,250000.0,SWE,1,1,0,16467,16467,0
E-Commerce,5492100.0,FRA,2,3,781,14245,15026,0
Biotechnology,1925000.0,USA,5,3,1195,15492,16687,0
Health Care|Medical Devices,1000000.0,ISR,1,1,0,16702,16702,0
Internet|Startups,52869.0,DEU,1,1,0,15949,15949,0
Customer Service|Customer Support Tools|Messaging|Tech Field Support,1000000.0,USA,1,1,0,16329,16329,0
Brand Marketing|Corporate Training|Education|Enterprise Software|SaaS|Video,1840892.0,USA,2,3,678,15653,16331,0
Events|Local|Mobile,20000.0,USA,1,1,0,16293,16293,0
Enterprise Software,45000000.0,USA,3,10,732,14379,15111,1
Biotechnology,3216500.0,USA,1,1,0,15910,15910,0
Web Hosting,37000000.0,CHN,1,4,0,12845,12845,0
Drones|Industrial Automation|Robotics,40000.0,CHL,1,1,0,16222,16222,0
Industrial|Material Science|Mechanical Solutions,2142305.0,GBR,1,2,0,12523,12523,0
Enterprise Software,2000000.0,USA,1,3,0,13487,13487,1
Analytics|Information Technology|Search,32570.0,PER,1,1,0,14822,14822,0
Big Data Analytics|Child Care|Diagnostics|Health and Wellness|Mobile,120000.0,POL,2,1,184,16013,16197,0
Entertainment|News|Politics|Social Media|Sports|Television,5000000.0,USA,1,1,0,13818,13818,0
Financial Services|Personal Finance,136122092.0,NZL,2,4,256,16447,16703,0
Games,15045983.0,USA,5,6,7038,9644,16682,1
Software,42000000.0,USA,4,7,1829,13494,15323,1
Medical Devices,5308147.0,USA,2,1,384,16309,16693,0
Audio|Big Data|Collaboration|Enterprise Software|Human Resources,7768177.0,USA,3,11,1381,13879,15260,0
Hospitality|Recruiting|Restaurants|Technology,375000.0,USA,2,6,529,15779,16308,0
Business Services|Clean Technology|Service Providers,48300000.0,USA,2,5,2300,9745,12045,0
Fashion|Lifestyle|Price Comparison|Social Commerce,287100001.0,USA,6,23,1056,15567,16623,0
Hardware + Software,1200000.0,USA,2,2,2377,12784,15161,0
Cloud Security|Cyber Security|Data Security|Startups,3124000.0,USA,3,2,1219,15299,16518,0
Manufacturing,33467316.0,USA,7,12,1839,14617,16456,0
Financial Services|Investment Management|Marketplaces,9400000.0,USA,3,4,867,15737,16604,0
Clean Technology,244514000.0,USA,12,24,2160,14602,16762,0
Contact Management|Mobile|Networking,4000000.0,USA,3,7,738,14197,14935,0
Games|Internet|Social Games,684150.0,USA,2,7,919,15461,16380,0
Consulting|Content|Curated Web|Knowledge Management,190000.0,JOR,1,1,0,15679,15679,0
Software,25000.0,USA,1,1,0,15400,15400,0
Development Platforms|Enterprise Software,10000000.0,USA,1,3,0,16414,16414,0
3D Technology|Games|Mobile|Social Games|Video Game Tournaments|Video Streaming|Virtual Worlds,250000.0,USA,1,13,0,16526,16526,0
Web Hosting,400000.0,USA,1,2,0,16233,16233,0
Bitcoin,695000.0,USA,2,3,126,16344,16470,0
Big Data|Internet Marketing|SaaS|Social Media|Social Media Marketing,200000.0,UKR,2,2,603,15953,16556,0
CRM|E-Commerce|Local|Local Based Services|Small and Medium Businesses,6814032.0,GBR,4,4,766,15432,16198,1
E-Commerce|Marketplaces|Mass Customization,1650000.0,USA,2,11,1,15860,15861,0
Consumer Electronics,7000000.0,USA,1,5,0,16723,16723,0
CRM|Email Marketing|Marketing Automation|SaaS|Sales and Marketing|Sales Automation|Small and Medium Businesses|Software,4750000.0,USA,3,7,1033,15614,16647,0
Biotechnology,22630691.0,AUS,3,11,3076,12933,16009,0
Health Care,20000.0,USA,1,1,0,16270,16270,0
Software|Virtualization,5000000.0,CAN,1,2,0,14943,14943,0
Web Hosting,36000000.0,USA,2,7,358,12942,13300,1
Advertising Networks|Apps|Content|Location Based Services|Media|Mobile|News|Publishing|Reviews and Recommendations|Video|Video Streaming,1440000.0,USA,3,5,454,16102,16556,0
Beauty|E-Commerce|Fashion|Social Commerce|Social Media|Video Streaming,1250000.0,USA,1,4,0,15644,15644,0
Security|Software,2100000.0,USA,2,3,798,13514,14312,1
Shopping,120000.0,USA,1,1,0,16267,16267,0
E-Commerce|Fashion|Flash Sales|Shopping,41000000.0,USA,2,4,387,14376,14763,1
Curated Web|Finance,12000.0,USA,1,1,0,14497,14497,0
Logistics|Marketplaces,3000000.0,USA,1,3,0,16506,16506,0
Curated Web|Design|Services,7520000.0,USA,4,7,275,16468,16743,0
Clean Technology,8067250.0,NOR,1,3,0,14941,14941,0
Biotechnology,12445000.0,USA,3,2,3897,12209,16106,0
E-Commerce|Lifestyle|Retail,22000000.0,USA,3,3,4261,12053,16314,0
Entertainment|News|Video Streaming,1700000.0,USA,1,7,0,16532,16532,0
Advertising Platforms|Digital Media,1789475.0,USA,5,6,325,16217,16542,0
Big Data|Cloud Computing|Databases|Enterprise Software|Software,13500000.0,USA,3,4,635,15696,16331,0
Finance,1500087.0,USA,2,1,441,14579,15020,0
Restaurants,1500000.0,USA,1,2,0,12306,12306,0
Software,12600000.0,USA,1,1,0,16770,16770,0
Enterprise Software|Software,36714000.0,USA,5,1,922,15807,16729,0
Manufacturing|Oil & Gas,12879637.0,GBR,1,1,0,15893,15893,0
Entertainment|Fantasy Sports|Sports,15000.0,USA,1,3,0,15492,15492,0
Mobile,3000000.0,USA,1,4,0,16022,16022,0
Nonprofits,408225.0,IND,1,6,0,15930,15930,0
Application Platforms|Mobile,1800000.0,GBR,1,3,0,16721,16721,0
Software,900000.0,USA,1,1,0,13388,13388,0
Communities|Curated Web|iPhone|Social Network Media|Video Chat,1500000.0,DEU,2,10,932,15419,16351,0
3D|Casual Games|Games,25000.0,USA,3,3,445,15380,15825,0
Health and Wellness,34149500.0,USA,3,13,384,16315,16699,0
Software,10356751.0,USA,3,5,3089,11590,14679,1
Health and Wellness,110000.0,USA,1,1,0,16283,16283,0
Apps,5000000.0,USA,1,9,0,16609,16609,0
Health and Wellness|Health Care|mHealth|Mobile,3400000.0,USA,2,1,730,14975,15705,0
Health and Wellness,5401700.0,USA,5,1,1058,15522,16580,0
Biotechnology,716867.0,KOR,1,1,0,15924,15924,0
Big Data|Health and Wellness|Machine Learning|Medical|Mobile|Sensors,1361500.0,SGP,3,7,484,16037,16521,0
Biotechnology,2600000.0,USA,1,5,0,14224,14224,0
Biotechnology,29167989.0,JPN,1,6,0,15986,15986,0
Biotechnology,15500000.0,ISR,2,1,1073,13844,14917,0
Fitness|Health and Insurance|Health and Wellness|Incentives|Medical Devices,605000.0,USA,2,1,1,16282,16283,0
Health and Wellness,2050000.0,USA,2,2,128,15838,15966,0
Analytics,152000000.0,USA,5,15,1293,15218,16511,0
Health and Wellness|Medical Devices|Psychology,340423.0,GBR,1,1,0,16244,16244,0
Electronic Health Records|Health and Wellness|Health Care Information Technology,6547691.0,USA,3,2,495,15716,16211,0
Biotechnology,1006102.0,USA,2,3,281,15638,15919,0
Data Integration|Health and Wellness|Health Care Information Technology,19264593.0,USA,1,1,0,16444,16444,0
Colleges|Content|Doctors|Health and Wellness|Health Care|Internet|Media|Medical|News|Video|Video Streaming,9450000.0,USA,3,11,1640,13514,15154,1
Software,16000000.0,USA,1,6,0,13469,13469,1
Biotechnology,8193628.0,USA,5,2,4179,12053,16232,0
Bioinformatics|Biotechnology|Health and Wellness,5500000.0,USA,1,6,0,16421,16421,0
Analytics,17939377.0,USA,4,3,2034,12810,14844,1
Biotechnology|Health and Wellness|Health Care|Medical|Technology,15748632.0,USA,2,2,1119,15022,16141,0
Finance,6500000.0,USA,1,5,0,13990,13990,0
Diabetes|Enterprise Software|Health and Wellness|Health Care|Hospitals,1849999.0,USA,4,1,913,15540,16453,0
Analytics,5400000.0,USA,1,1,0,16024,16024,0
Specialty Foods,3300000.0,USA,1,1,0,16269,16269,0
Health and Wellness|Health Care|Insurance,3000000.0,USA,1,2,0,14610,14610,1
Automotive|Entrepreneur|Health Care|Incubators|Startups|Venture Capital,7000000.0,USA,1,2,0,16177,16177,0
Health and Wellness,10000000.0,USA,2,2,74,16010,16084,0
Health and Insurance|Health and Wellness,17370000.0,USA,3,3,2816,13684,16500,0
Software,10663730.0,USA,1,2,0,16665,16665,0
Consulting|Design|Hospitals,8100000.0,USA,1,4,0,12096,12096,0
Health and Wellness|Health Care|Health Care Information Technology|Internet,2500000.0,IND,1,1,0,14287,14287,1
Software,41200000.0,USA,2,2,997,13924,14921,1
Health and Wellness|News,50000000.0,USA,1,4,0,13879,13879,1
Health Care|Health Care Information Technology|Medical Devices|Software,43720.0,IRL,1,1,0,15130,15130,0
Big Data|Enterprise Software|Health and Wellness|Mobile Health|SaaS,2628000.0,USA,3,11,1117,15645,16762,0
Health and Wellness,13200000.0,USA,1,3,0,12996,12996,1
Software,49283758.0,USA,3,1,499,15994,16493,0
Curated Web|Dental|Doctors|Health and Wellness|Medical|Software,9512195.0,AUS,1,2,0,15933,15933,0
Information Technology|Services,3750000.0,USA,1,3,0,16513,16513,0
Enterprise Software|Health and Wellness|Health Care Information Technology|mHealth|Technology,8250000.0,USA,2,6,1096,15340,16436,0
Health Care Information Technology|Software,3149999.0,USA,2,6,686,15826,16512,0
Enterprise Software|Health Care|Information Technology,4000000.0,IND,1,1,0,14491,14491,0
Health and Wellness,1500000.0,USA,1,1,0,16637,16637,0
Fitness|Health and Wellness|Health Care|Neuroscience,30100000.0,USA,2,1,1564,15187,16751,0
Health and Wellness|Health Care|Mobile Health,500000.0,USA,2,2,230,15974,16204,0
Fitness|Health and Wellness|Lifestyle|Video,12000000.0,USA,2,4,638,13514,14152,0
Doctors|Health and Wellness|Health Care|Information Technology|Medical|Search,63500002.0,USA,5,6,3050,13149,16199,0
Health and Wellness,15394552.0,USA,2,3,567,16048,16615,0
Health and Wellness|Health Care|Medical,3000000.0,USA,1,2,0,12142,12142,1
Health Care,4500000.0,USA,1,3,0,16504,16504,0
Curated Web|Health Care,2000000.0,USA,1,2,0,15574,15574,1
Health and Wellness|Health Care,8532000.0,USA,5,1,1196,15106,16302,0
Software,3907000.0,USA,2,1,377,16155,16532,0
Hardware + Software,15000000.0,USA,3,6,702,15163,15865,0
Social Media,400000.0,USA,2,4,31,15309,15340,0
Biotechnology,32130000.0,USA,8,9,1966,14335,16301,0
Biotechnology|Hospitals,3700000.0,USA,1,1,0,15875,15875,1
Doctors|Games|Health and Wellness|Health Care|mHealth|Mobile Health|Physicians,38250000.0,USA,5,21,1223,14610,15833,0
Health and Wellness|K-12 Education,5900000.0,USA,2,2,439,14714,15153,0
E-Commerce,17620401.0,USA,7,3,1947,14361,16308,1
Health Care Information Technology,1413497.0,KOR,2,1,39,16065,16104,0
Fitness|Health and Wellness|Health Care,25000000.0,USA,2,1,750,15230,15980,1
Analytics|Health and Wellness|Health Care,20000.0,USA,1,1,0,16471,16471,0
Diabetes|Health and Wellness|Medical|Nutrition,150000.0,USA,1,1,0,14061,14061,0
Diabetes|Health and Wellness|Hospitals,100000.0,USA,2,2,506,15949,16455,0
Automotive|Biometrics|Fleet Management|Insurance Companies|Machine Learning|Risk Management|Software,240568.723758925,PRT,2,2,67,16222,16289,0
Analytics,2000000.0,USA,1,16,0,15944,15944,0
Consumers|Fitness|Hardware + Software|Health and Wellness|Sensors|Wearables,5560000.0,USA,3,4,381,15887,16268,0
Music|Music Services|Television,320000.0,USA,1,1,0,15765,15765,0
Apps|Audio|Entertainment|Social Network Media,750000.0,ISR,1,1,0,16283,16283,0
Artists Globally|Consumer Goods|Music|Music Venues|Social Media|Ticketing,320500.0,USA,5,7,615,15414,16029,0
Financial Services|Social Business|Social Media|Social Media Marketing|Software,51000000.0,USA,3,14,945,15008,15953,0
Biotechnology,24000000.0,USA,2,6,467,15709,16176,0
E-Commerce,20000.0,USA,1,1,0,15095,15095,0
Biotechnology|Health Diagnostics,172715918.0,USA,5,1,1761,14718,16479,0
EdTech|Education|Hardware + Software|Health Care Information Technology|Internet of Things,90000.0,GBR,2,2,273,16071,16344,0
Life Sciences,100000.0,USA,1,1,0,13348,13348,0
Health Care,16980998.0,USA,1,1,0,13627,13627,1
Healthcare Services|Medical Devices|Technology,18400000.0,USA,2,5,562,13066,13628,0
E-Commerce|Online Shopping|Reviews and Recommendations,2000000.0,USA,1,7,0,15938,15938,1
Biotechnology|Health Care,15599800.0,USA,4,2,1741,14566,16307,1
Electrical Distribution|Semiconductors|Water,1112822.0,DNK,2,2,826,14880,15706,0
Assisitive Technology|Energy|Food Processing,3088720.0,USA,6,5,1702,14791,16493,0
Nonprofits,1716931.0,GBR,1,1,0,16059,16059,0
Cloud Data Services|Consumer Behavior|Video,81462.0,BRA,1,1,0,16344,16344,0
Chemicals|Energy Efficiency|Waste Management,3304283.0,NLD,2,2,365,15706,16071,0
Games,12600000.0,USA,2,1,721,14089,14810,0
Advertising,25800000.0,USA,3,3,2121,11382,13503,0
Healthcare Services|Manufacturing|Medical Devices,920090.0,DNK,1,1,0,15586,15586,0
Analytics|Finance,4750000.0,IND,3,3,709,15340,16049,0
Consumer Goods|Specialty Foods,36700000.0,IND,2,7,777,15845,16622,0
Finance|Finance Technology|Financial Services|FinTech|Investment Management|Personal Finance,1850000.0,USA,2,3,334,15980,16314,0
Finance|Investment Management|Psychology|Social Media|Software|Stock Exchanges,385000.0,USA,6,1,644,15770,16414,0
Advertising|Consulting|Curated Web|Finance|Hedge Funds|Internet|Investment Management,3000000.0,USA,2,3,2015,13979,15994,0
Bitcoin|Finance Technology|FinTech|Peer-to-Peer|Trading,1200000.0,USA,1,3,0,16555,16555,0
Cloud Infrastructure|Data Center Infrastructure|Software|Storage,30500000.0,USA,3,8,1089,15498,16587,0
Fashion|Personal Health|Shoes|Women,54948.0,EST,4,1,485,15994,16479,0
Apps|Services|Transportation,500000.0,FRA,2,1,450,16071,16521,0
Advertising,38100000.0,CHN,4,5,1249,12935,14184,0
Consumer Internet|Digital Media|Social Media,1000000.0,USA,1,1,0,16391,16391,0
Android|Apps|App Stores|iOS|Photo Sharing|Social Media,2000000.0,USA,2,2,0,16391,16391,0
E-Commerce Platforms|Employment|Online Rental|Peer-to-Peer|Shared Services,250000.0,USA,1,1,0,16728,16728,0
Biotechnology,123400000.0,USA,3,4,489,15462,15951,0
Clean Technology,49826996.0,DEU,2,15,1769,14574,16343,0
Aerospace|Embedded Hardware and Software|Innovation Engineering,2499329.0,USA,1,12,0,16513,16513,0
Web Hosting,1000000.0,USA,1,2,0,13228,13228,0
Manufacturing,55000000.0,CHN,2,6,204,16280,16484,0
Aerospace|Governments|Medical,20500000.0,USA,1,1,0,12363,12363,0
Environmental Innovation,12114202.0,USA,2,2,326,16296,16622,0
Bicycles|Gps|Hardware,25000.0,USA,2,2,656,15837,16493,0
Health Care,20000000.0,USA,1,5,0,11275,11275,0
Telecommunications,630000000.0,GBR,1,5,0,16261,16261,0
Clean Technology,4475888.0,SWE,1,1,0,15258,15258,0
Clean Technology|Energy Efficiency,11482.0,USA,2,1,365,15706,16071,0
Clean Technology,253000000.0,USA,6,11,2985,12935,15920,0
Curated Web|Journalism|Publishing,31986800.0,USA,3,2,920,14179,15099,1
Hardware + Software|Internet of Things|Wireless,18775935.0,USA,2,15,403,16010,16413,0
Software,12253817.0,IRL,1,1,0,16219,16219,0
Batteries|Manufacturing|Services,12300000.0,USA,1,2,0,14056,14056,0
Biotechnology,3362500.0,USA,3,3,614,14322,14936,0
Biotechnology,17333335.0,USA,2,3,783,13755,14538,1
Consumer Electronics|Hardware + Software|Music|Sports,40000.0,CHL,1,1,0,16222,16222,0
E-Commerce|Hardware|Software,33907283.0,USA,3,4,503,16098,16601,0
Audio|Babies|Photo Sharing|Video|Web Development,665404.0821727479,RUS,2,1,544,16191,16735,0
Mobile,889999.0,USA,2,6,1046,13665,14711,0
Hospitality,500000.0,IND,1,1,0,16136,16136,0
Health and Wellness|Health Care|Mobile Health,1500000.0,USA,1,12,0,16520,16520,0
Health Care,21500000.0,USA,2,1,272,15398,15670,0
Local|Media|Messaging|Mobile|News,50000.0,RUS,1,1,0,15095,15095,0
Classifieds|E-Commerce|Mobile Commerce|Startups,2500000.0,KOR,1,4,0,16212,16212,0
Business Services|Online Auctions|Proximity Internet|Real Estate,3300000.0,AUS,3,1,1463,15187,16650,0
Curated Web,500000.0,ARE,1,2,0,15584,15584,0
Content Delivery|Hospitality|Recipes|Specialty Foods,278500000.0,DEU,5,11,1009,15686,16695,0
Hospitality,1400000.0,KOR,2,3,721,15621,16342,0
Web Hosting,11000000.0,USA,1,4,0,12081,12081,1
Advertising|Events|Public Relations|Sales and Marketing|Sponsorship,58000.0,USA,1,1,0,16455,16455,0
New Technologies|Sales Automation|Tech Field Support,17000000.0,USA,3,22,232,16462,16694,0
Software,16150000.0,USA,3,5,692,14673,15365,1
Advertising|Software,3085717.0,KOR,5,7,1560,15111,16671,0
Software,2500000.0,FIN,1,2,0,13389,13389,0
Home & Garden|Internet|News|Online Rental|Real Estate|Technology,500000.0,USA,1,1,0,14822,14822,0
Customer Service|Customer Support Tools|Email|Finance|FinTech|Software|Web Tools,6800000.0,USA,4,19,1478,15034,16512,0
Big Data|Diabetes|Health Care|Mobile Emergency&Health|Mobile Health,610000.0,ISR,1,4,0,16269,16269,0
Apps|Customer Service|Customer Support Tools,500000.0,USA,1,2,0,16436,16436,0
E-Commerce|Education|Marketplaces|Mobile|Tutoring,250000.0,CAN,1,1,0,16153,16153,0
Health and Wellness,1655236.0,IND,2,1,1314,14975,16289,0
Curated Web|Home & Garden|Service Providers,62000000.0,DEU,2,8,113,16406,16519,0
Home & Garden|Internet|Online Rental|Real Estate|Social Network Media,154000.0,USA,1,1,0,15187,15187,0
Banking|Finance,3860000.0,ESP,1,1,0,14182,14182,0
Customer Service|Customer Support Tools|Mobile,13200000.0,USA,2,6,602,15643,16245,0
Curated Web|Customer Service,8600000.0,USA,1,2,0,13937,13937,0
Software,30935270.0,GBR,10,21,3076,12794,15870,0
Biotechnology,51499999.0,USA,4,12,1592,13819,15411,0
Biotechnology,4790000.0,FRA,2,3,501,14291,14792,0
Biotechnology,3000000.0,DEU,1,1,0,14577,14577,0
E-Commerce|Marketplaces,5500000.0,TUR,3,4,1013,15569,16582,0
Analytics|Consulting|Investment Management,20000000.0,USA,1,1,0,16071,16071,0
Health Care,9300000.0,USA,1,7,0,14706,14706,1
Innovation Management|Medical|Medical Devices,100000.0,USA,1,1,0,16008,16008,0
Clean Technology|Energy Management|Home Automation|Smart Grid,400000.0,USA,1,3,0,15788,15788,0
Professional Networking|Social Media|Social Network Media,400000.0,CHN,1,2,0,14610,14610,0
Education,12600000.0,USA,4,8,524,14890,15414,0
Health Care,3000000.0,USA,1,1,0,16099,16099,0
Biotechnology,430000.0,USA,2,2,199,15261,15460,0
Biotechnology,4500000.0,USA,4,4,1394,14124,15518,0
Biotechnology,26500000.0,GBR,3,4,2971,13735,16706,1
Advertising|Colleges|Fashion|Lifestyle|Media|News|Sales and Marketing|Sponsorship|Women,50000.0,USA,1,1,0,15271,15271,0
Biotechnology,19346025.0,USA,4,2,785,15868,16653,0
Development Platforms|Innovation Management|Project Management,398750.0,USA,3,3,776,15848,16624,0
Apps,17000.0,USA,1,1,0,15584,15584,0
Health Care|Pharmaceuticals|Supply Chain Management,10000000.0,USA,1,2,0,13984,13984,0
Analytics|Big Data|Health and Wellness|Machine Learning|Productivity Software|SaaS,118000.0,USA,1,1,0,15726,15726,0
Enterprise Software|Venture Capital|Web Development,13020000.0,USA,3,8,860,13879,14739,1
Social Media,1525940.0,CHN,1,1,0,15065,15065,0
Education|Internet|Textbooks,40000.0,ARG,1,1,0,16048,16048,0
Advice|Curated Web,1000000.0,USA,2,2,568,15807,16375,0
Cloud Computing|Internet|SaaS|Software,26577387.8392203,DEU,5,9,1809,14610,16419,0
E-Commerce,11700000.0,RUS,3,5,503,15293,15796,0
Security,2500000.0,ISR,1,2,0,16252,16252,0
Manufacturing,4500000.0,SWE,1,2,0,14375,14375,0
Web Hosting,5280000.0,TUR,1,3,0,13262,13262,0
Design|Hardware + Software|Information Technology|Open Source,25000.0,CHN,1,1,0,15837,15837,0
Semiconductors,16758778.0,USA,7,4,3250,13117,16367,0
Analytics,20000.0,USA,1,1,0,13888,13888,0
Local Businesses,5500000.0,USA,2,22,29,16044,16073,0
Beauty|Fashion|Online Shopping|Retail|Women,550000.0,USA,2,3,80,16040,16120,0
Software,29300000.0,USA,4,11,983,10991,11974,1
iPhone|Mobile|Networking|Social Media,850000.0,ISR,2,2,100,16030,16130,0
Software,2699955.0,USA,3,1,321,16240,16561,0
Contests|Facebook Applications|Internet Marketing|Promotional|Social Media Marketing|Social Network Media|Software|Web Design,2000000.0,USA,2,3,691,15456,16147,0
Game,248571.0,ESP,1,4,0,16505,16505,0
E-Commerce|File Sharing|Peer-to-Peer|Social Media,483333.0,SGP,1,2,0,15187,15187,0
Internet,3000000.0,IND,1,1,0,16758,16758,0
Messaging|SMS,875000.0,USA,2,3,183,13538,13721,1
Games,20000000.0,CHN,1,1,0,13921,13921,0
Ad Targeting|Advertising|Analytics|Big Data Analytics|E-Commerce|Personalization|Search,4069860.0,IRL,3,4,1734,14910,16644,0
Education|Recruiting|University Students,238000.0,GBR,2,5,279,16419,16698,0
Advertising|Mobile|Mobile Advertising,7995000.0,USA,5,13,1430,14245,15675,0
Education,100000.0,MYS,2,2,708,14427,15135,0
Clean Technology|Food Processing,520000.0,USA,2,2,406,13389,13795,0
Software,70000.0,USA,1,1,0,14568,14568,0
Analytics|Big Data|Lead Generation,6259998.0,USA,5,4,1313,14883,16196,0
Analytics|B2B|Hardware + Software|Software,540000.0,POL,3,1,700,15887,16587,0
Software,3480000.0,FRA,2,2,1033,12784,13817,0
Software,3000000.0,ISR,1,1,0,13880,13880,0
Games|Networking,52000000.0,USA,4,4,1108,13695,14803,1
All Students|Home & Garden|Office Space|Software|Storage|Synchronization,50000.0,SGP,1,1,0,13514,13514,0
Security,13400000.0,IRL,1,1,0,14615,14615,0
Robotics|Services|Technology,2703374.0,JPN,1,1,0,16384,16384,0
Fashion,5155000.0,USA,2,1,538,16126,16664,0
Analytics|E-Commerce|Optimization|Sales and Marketing|Software,5705000.0,USA,4,1,1813,14936,16749,0
Advertising,286911.0,RUS,1,2,0,15848,15848,0
Games,15000000.0,USA,1,2,0,13817,13817,0
Application Platforms|Mobile|Software,50000000.0,USA,1,2,0,11122,11122,1
Health Care|Mobile,120000.0,USA,1,1,0,16495,16495,0
Manufacturing,5400000.0,CAN,1,2,0,16125,16125,0
Education|Internet|Online Education,47900.0,USA,2,2,365,15706,16071,0
Automotive,1300000.0,USA,2,4,159,15095,15254,1
E-Commerce|Group Buying|Social Commerce|Social Network Media|Software,300000.0,USA,2,2,578,15309,15887,0
B2B|Enterprise 2.0|SaaS|Venture Capital,35000000.0,USA,1,3,0,16596,16596,0
Hardware + Software|Virtual Worlds,17450000.0,USA,4,8,695,15796,16491,0
Automotive,12000000.0,USA,2,3,607,13818,14425,1
Software,4556909.0,GBR,1,3,0,12950,12950,0
Software,14300000.0,USA,2,5,593,15196,15789,0
Information Security|Security,4300000.0,CHE,1,1,0,15649,15649,0
Nonprofits,1000000.0,NZL,1,1,0,16287,16287,0
Apps|Computers|Lifestyle|Mobile|Network Security|Social Media,700000.0,USA,2,7,183,16344,16527,0
Biotechnology,31748500.0,USA,4,9,1219,13809,15028,0
Security,1000000.0,USA,1,2,0,13452,13452,1
Curated Web,3100000.0,USA,1,2,0,12048,12048,1
Consumer Goods|Manufacturing|Service Providers,21373000.0,ISR,2,3,385,16090,16475,0
Apps|EdTech|Education|Google Apps|iOS|Mobile|Radical Breakthrough Startups|Software|Startups,6500000.0,USA,2,4,284,16115,16399,0
Recruiting|Retail Technology|SaaS,120000.0,USA,2,4,259,16405,16664,0
Education|Testing,1065000.0,USA,4,1,687,14853,15540,1
Collaboration|Communications Hardware|Enterprise Software|Messaging|Video Conferencing,45400000.0,USA,3,20,974,15532,16506,0
Customer Service|Enterprise Software|Human Resources|Incentives|Reviews and Recommendations,10159999.0,USA,3,1,626,15675,16301,1
Software,10000000.0,USA,1,2,0,11722,11722,1
Biotechnology,81700000.0,CAN,4,3,677,15933,16610,0
Mobile|Social + Mobile + Local|Social Search,4000000.0,USA,2,10,680,15371,16051,0
Mobile|Video,3000000.0,USA,2,7,911,14396,15307,0
Education|Finance,730000.0,USA,4,13,399,14910,15309,0
Software,31092540.0,CAN,8,11,3982,12606,16588,0
Games|Kids|Parenting,284775.0,CAN,2,8,390,14975,15365,0
Enterprise Software|Sales and Marketing,9600000.0,USA,1,1,0,16381,16381,0
Collaboration|File Sharing|Mobile|Storage,92700000.0,USA,8,27,3165,12996,16161,0
Mobile Enterprise|Real Estate|Software,21660000.0,USA,4,30,608,16059,16667,0
Finance,200000000.0,USA,2,4,1644,14622,16266,0
Content Delivery|Software,310000000.0,USA,3,8,1976,13949,15925,0
Art|Electrical Distribution|Retail,100000000.0,CHN,1,2,0,16387,16387,0
Energy|Energy Management|Services,22000000.0,USA,2,2,35,16259,16294,0
Messaging|Mobile,86000000.0,IND,3,4,488,15820,16308,0
Distribution|Manufacturing|Services,60000000.0,USA,1,1,0,12551,12551,0
Coffee|E-Commerce,500000.0,USA,1,1,0,16096,16096,0
Consumer Electronics|Mobile|Sensors|Software|Tablets|Television,19542562.0,USA,3,3,2974,12423,15397,0
Non Profit,16000000.0,USA,1,1,0,16689,16689,0
Curated Web,40000000.0,USA,1,1,0,15936,15936,0
Health Care|Medical,5102426.0,CHN,2,1,579,14730,15309,0
Android|Facebook Applications|Games|iOS|Match-Making|Mobile|Networking|Online Dating|Social Media,20600000.0,USA,4,36,1009,15406,16415,0
Software,3400000.0,ISR,1,1,0,13653,13653,0
Consumer Goods|Health and Wellness|Water,6812500.0,USA,2,1,537,15522,16059,0
Banking|Consumers|Curated Web|Finance,20000.0,USA,1,2,0,15857,15857,0
Advertising|Home Renovation|Lead Generation|Local Businesses|Marketplaces,12000000.0,AUS,2,8,392,16196,16588,0
Analytics|Customer Service|Software,750000.0,USA,1,4,0,10651,10651,1
Content|Content Discovery|Outdoors,2000000.0,USA,1,9,0,16343,16343,0
Chat|Collaboration|Enterprises|Messaging,100000.0,USA,1,3,0,14831,14831,1
Advertising|Business Analytics|Mobile Commerce,17550000.0,USA,3,2,2399,13594,15993,1
Health Care,1263511.0,DEU,3,5,1752,14263,16015,0
Property Management|Real Estate,335000.0,THA,1,4,0,16062,16062,0
Travel,500000.0,USA,1,1,0,15084,15084,0
Mobile,14664565.0,USA,2,5,663,13917,14580,1
Curated Web|Lead Generation|Social Media|Social Media Marketing|Software,12000000.0,USA,2,4,189,15838,16027,0
Hotels|Travel,40215000.0,USA,5,25,1382,14838,16220,0
Education,20997981.0,IND,5,7,878,15375,16253,0
Internet|Software,41250.0,HKG,1,1,0,16405,16405,0
Curated Web,1000000.0,USA,1,14,0,15110,15110,1
E-Commerce|Fashion|Lifestyle,1100000.0,USA,1,4,0,15428,15428,0
E-Commerce,4720000.0,SGP,3,7,831,15884,16715,0
E-Commerce|Lifestyle Products|Marketplaces|Retail,1340000.0,DNK,2,3,955,15431,16386,0
Online Travel|Startups|Travel|Venture Capital,2900000.0,RUS,3,14,396,14883,15279,0
Analytics|Big Data Analytics|Enterprises|Human Resources,5000000.0,USA,3,4,471,16146,16617,0
Marketplaces,10000.0,IND,1,1,0,16384,16384,0
Legal,1075000.0,USA,3,5,873,15349,16222,0
Curated Web,151525.0,GBR,1,1,0,16155,16155,0
E-Commerce|Human Resources|Music Venues,1684565.0,GBR,1,1,0,16217,16217,0
Curated Web,150000.0,USA,1,2,0,13634,13634,0
Enterprises|Enterprise Software|Human Resources|Recruiting,1400000.0,USA,1,8,0,15340,15340,0
College Recruiting|Enterprise Software|Recruiting,58000.0,USA,1,1,0,16455,16455,0
Curated Web|Internet|Marketplaces|Recruiting,32700000.0,USA,3,17,707,15706,16413,0
Big Data|Human Resource Automation|Predictive Analytics|Software,6872344.0,USA,7,5,1975,14699,16674,0
Analytics|Human Resources|Identity Management|Recruiting|SaaS|Software,13531778.0,USA,4,3,1080,15495,16575,0
Curated Web|Human Resources|Recruiting|Software,93000000.0,USA,5,17,2669,13919,16588,0
Home Owners|Home Renovation|Local Businesses|Local Search,20000.0,USA,1,1,0,16269,16269,0
Computers|Enterprise Software|SaaS|Technology,834904.0,IRL,4,4,608,15614,16222,0
Career Management|Human Resources|Recruiting|Social Recruiting|Software,1000000.0,USA,1,5,0,15400,15400,0
Curated Web,5000000.0,USA,1,1,0,13252,13252,0
Biotechnology|Environmental Innovation|Medical,4600000.0,CHE,1,1,0,16384,16384,0
Biotechnology,24900000.0,USA,1,3,0,16615,16615,0
Biotechnology,96400000.0,USA,3,5,1418,14126,15544,1
Consulting,1150000.0,GBR,2,4,1583,13665,15248,0
Biotechnology,13260546.0,USA,4,10,2446,12675,15121,1
Hospitality,6000.0,IND,1,1,0,14085,14085,0
Biotechnology,30172418.0,USA,4,2,2019,14662,16681,0
Content|Education|Social Media,300000.0,USA,1,2,0,15340,15340,0
Cloud Computing|Enterprise Software|Information Services|SaaS|Virtualization,125000.0,USA,1,1,0,14123,14123,0
Games|Video Streaming,4000000.0,AUT,1,2,0,16741,16741,0
Entertainment|Events|Games|Music|Television,6800000.0,USA,3,8,1553,14335,15888,0
Chat|Mobile|Social Network Media,103039.0,ESP,2,3,304,15614,15918,0
E-Commerce|Promotional|Real Time,161671.0,GBR,1,1,0,15706,15706,0
Games,2000000.0,USA,1,3,0,16448,16448,0
Databases|Local|Mobile|Photography|Social Media|Sports,2000000.0,USA,3,12,846,14610,15456,1
Entertainment Industry|Online Video Advertising|Social Media Marketing,1410000.0,ESP,3,1,699,16077,16776,0
Games|Networking|Video,2285000.0,USA,3,1,246,13846,14092,0
Curated Web,14200000.0,AUS,2,2,1279,11139,12418,1
Cloud Data Services|File Sharing|Music,500000.0,HKG,1,2,0,16421,16421,0
Games,1500000.0,USA,1,3,0,15217,15217,0
B2B|Delivery,5400000.0,USA,1,2,0,16587,16587,0
B2B|Blogging Platforms|Forums|Networking|Social Media|Web Tools,8950000.0,USA,3,3,482,13454,13936,1
Facebook Applications|Social Media|Software,270593.0,JPN,1,1,0,12641,12641,0
Curated Web|Customer Service,25000.0,USA,1,1,0,15282,15282,0
Drones|Maps|Navigation|Software,2900000.0,USA,1,4,0,16744,16744,0
Finance|Financial Services|Investment Management,19299.0,DNK,1,1,0,15950,15950,0
Apps|Mobile|Music|Social Media|Software,50223.0,ESP,1,1,0,15584,15584,0
Hardware + Software,20000000.0,CHN,2,2,283,15973,16256,0
Software,14000000.0,USA,2,3,1,13879,13880,1
Insurance,10500000.0,USA,1,1,0,16715,16715,0
Content|Curated Web|Hardware|Journalism|Photography|Privacy|Private Social Networking|Social Media|Video,639062.0,GBR,3,2,397,15340,15737,0
Hardware + Software,347000.0,DNK,1,1,0,13542,13542,0
Curated Web,10000.0,CZE,1,1,0,15775,15775,0
Coupons|East Africa|E-Commerce|Marketplaces|West Africa,1600000.0,MAR,1,2,0,15930,15930,0
Design|Health and Wellness|Health Care|Manufacturing|Semiconductors,5500000.0,USA,3,7,2607,13757,16364,0
Coupons|East Africa|E-Commerce|Marketplaces|West Africa,1600000.0,MAR,2,2,897,15026,15923,0
Energy,500000.0,USA,2,2,455,12784,13239,0
Hardware + Software,6695600.0,USA,3,2,1855,13488,15343,0
Logistics,25000.0,DEU,2,2,135,16202,16337,0
Collectibles|Internet|Marketplaces,118000.0,USA,1,2,0,16600,16600,0
Mobile Games|Social Games,4025000.0,USA,2,3,124,16191,16315,0
E-Commerce,387715.117270899,GBR,2,1,3,15947,15950,0
Marketplaces,765320.0,POL,1,2,0,16146,16146,0
Cloud Computing|Collaboration|Enterprise 2.0|Enterprise Software|Productivity Software|Web Development,620000.0,DEU,2,3,345,15300,15645,0
Consumer Goods|Distribution|Services,790000.0,IND,2,3,608,15938,16546,0
Internet|Software,24000000.0,ISR,2,3,2624,14069,16693,0
Food Processing,3420000.0,IND,2,3,139,16468,16607,0
Biotechnology|Health and Wellness,42000000.0,USA,1,6,0,16163,16163,0
Finance|Media|Software|Venture Capital,2520000.0,USA,2,1,50,16395,16445,0
Biotechnology|Health and Wellness|Nutrition,300000.0,USA,2,2,1097,15358,16455,0
Resorts|Surveys|Travel,20000000.0,IND,2,3,893,15743,16636,0
Travel & Tourism,4000000.0,ARE,1,1,0,16449,16449,0
Internet|Travel,100000.0,IND,1,1,0,16725,16725,0
Marketplaces|Pets|Travel,150000.0,USA,2,4,856,15830,16686,0
Electronics,3791818.0,FRA,1,3,0,16637,16637,0
Logistics,1500000.0,IND,1,1,0,16307,16307,0
Hospitality,250000.0,USA,1,2,0,14502,14502,0
Curated Web,5000000.0,USA,1,1,0,14140,14140,0
3D|Electronics|Manufacturing,2700000.0,USA,1,1,0,13877,13877,0
Banking|Finance|FinTech|Technology,2716125.0,FIN,3,2,1025,15187,16212,0
Finance,1000000.0,USA,2,11,91,14350,14441,1
Finance,16500000.0,USA,1,1,0,16504,16504,1
Consumer Internet|E-Commerce|Retail,1800000.0,USA,1,4,0,15706,15706,0
Travel,9200000.0,CHN,3,5,700,12084,12784,0
Health and Wellness|Health Care|Therapeutics,20000.0,USA,1,1,0,15492,15492,0
E-Commerce|Furniture,138801437.0,DEU,2,2,142,16445,16587,0
Advertising|Services|Technology|Travel|Vacation Rentals,504678374.0,USA,5,12,2099,12784,14883,1
Travel,250000.0,ESP,1,1,0,14975,14975,0
Health and Wellness|Health Care|Senior Citizens|Senior Health,23000000.0,USA,2,6,302,16314,16616,0
Real Estate,150000.0,USA,1,1,0,15821,15821,0
Hospitality,39700000.0,USA,5,24,1375,14669,16044,0
Interior Design,54500000.0,IND,2,3,112,16489,16601,0
Real Estate,4500000.0,USA,3,16,811,15659,16470,0
Online Rental|Travel,131945.0,FRA,1,11,0,15420,15420,0
Furniture|Home Decor|Interior Design|Manufacturing,5000000.0,RUS,1,3,0,15461,15461,0
Health and Wellness,4950000.0,USA,1,1,0,13088,13088,1
Service Providers,48000000.0,USA,1,5,0,11120,11120,0
Logistics,2000000.0,USA,1,6,0,16637,16637,0
E-Commerce,25000.0,USA,2,2,647,15285,15932,0
E-Commerce|Online Shopping|Retail,65000000.0,IND,3,6,1933,14068,16001,0
Analytics|Finance|Real Estate,5500000.0,USA,2,3,1132,14426,15558,0
Internet|Maps|Property Management|Real Estate|Search,40000.0,SGP,1,1,0,13848,13848,0
SaaS|Software|Supply Chain Management,2000000.0,USA,2,3,2422,11842,14264,1
Hospitality|Leisure|Marketplaces|Travel,3000000.0,IRL,1,1,0,16231,16231,0
Portals|Rental Housing|Service Providers,12300000.0,USA,2,6,56,16597,16653,0
Real Estate,500000.0,USA,1,4,0,16371,16371,0
Real Estate|Rental Housing,225000.0,USA,1,1,0,15777,15777,0
Health and Wellness,11000000.0,USA,1,3,0,16274,16274,0
Local Search|Navigation|Travel|Vacation Rentals,9901272.0,DEU,2,3,275,16343,16618,0
Health Care|SaaS|Software,121700.0,GBR,1,1,0,15887,15887,0
Real Estate,5500000.0,USA,2,2,1042,15279,16321,0
Curated Web,40000.0,ARG,1,1,0,15156,15156,0
E-Commerce,4751847.0,CHN,1,1,0,15371,15371,0
Clean Technology,50000.0,USA,1,1,0,15964,15964,0
Curated Web|Home Renovation|Real Estate|Sales and Marketing,2300000.0,USA,2,2,1307,15056,16363,0
Education,135172.0,ESP,1,1,0,15979,15979,0
Fashion|Mens Specific|Mobile|Social Media|Wireless,375000.0,USA,1,1,0,16255,16255,0
Commercial Real Estate|Curated Web,17250000.0,USA,5,11,1231,15358,16589,0
Financial Services,3000000.0,USA,1,6,0,16710,16710,0
Consumer Goods|Customer Service|Tea,12000000.0,USA,1,2,0,13545,13545,0
Online Shopping,15000000.0,SGP,1,5,0,16729,16729,0
Curated Web,1200000.0,USA,1,6,0,14901,14901,0
B2B|Enterprises|Enterprise Software|File Sharing|Media|Networking|News|Social Media,2250000.0,USA,2,1,687,15860,16547,0
Coupons|Curated Web|E-Commerce|Retail|Shopping,1500000.0,USA,1,5,0,16375,16375,0
Apps|Curated Web|Digital Media|Events|Marketplaces,32000000.0,USA,2,16,164,16335,16499,0
Agriculture|Big Data|Cloud Data Services|Drones|Software,415870.0,USA,3,2,197,16153,16350,0
Security,911000.0,GBR,1,2,0,13724,13724,0
Food Processing|Hospitality,25000000.0,USA,1,2,0,16603,16603,0
Manufacturing|Technology,11400000.0,USA,1,1,0,14544,14544,1
Manufacturing,10000000.0,CHN,2,2,183,13970,14153,0
Automotive|Field Support Services,13250000.0,USA,2,20,127,16393,16520,0
Consumers|Parking|Transportation,2255277.34899665,CAN,1,1,0,16710,16710,0
Medical|Senior Health,20000000.0,USA,1,9,0,16527,16527,0
Content Creators,475000.0,SWE,2,6,212,15979,16191,0
Apps,1600000.0,USA,2,11,434,16322,16756,0
Local|Location Based Services|Mobile,250000.0,USA,1,1,0,15718,15718,0
Mobile|SMS,1250000.0,USA,1,4,0,13848,13848,0
App Marketing|Apps|Developer APIs|Messaging|SMS|Social Games|Software,900000.0,USA,2,1,2245,13520,15765,0
Advertising|Distribution|Games|Mobile Games|Monetization,4500000.0,USA,2,4,395,13970,14365,0
Biotechnology,35305200.0,AUT,2,7,748,15265,16013,0
Analytics|Brand Marketing|E-Commerce|Events|Media|Mobile|Networking|Social Media|Sports,800000.0,USA,1,1,0,14383,14383,0
Advertising|Advertising Platforms|E-Commerce|Internet Marketing|Media|Mobile Advertising|Mobile Commerce|Online Travel|Retail|Software,39000000.0,USA,3,8,1462,15226,16688,0
Apps|Internet of Things|Wearables,118000.0,USA,1,2,0,16622,16622,0
SaaS|Software,13100000.0,USA,3,7,784,15330,16114,0
Games|Mobile|Social Games,934328.0,ESP,2,4,1323,15192,16515,0
Collaboration|Education|Tutoring,25000.0,USA,1,1,0,15103,15103,0
Advertising|Big Data Analytics|Brand Marketing|Messaging|Online Scheduling|Social Media|Software|Twitter Applications,284900000.0,CAN,6,19,1759,14579,16338,0
Apps|Messaging|Mobile|Social Media,720000.0,ISR,1,2,0,15309,15309,0
Curated Web,20000.0,USA,1,1,0,15126,15126,0
Health and Wellness|Nonprofits|Technology,9000000.0,USA,1,1,0,12784,12784,0
Design|File Sharing|Mobile,50000.0,USA,1,1,0,16314,16314,0
Internet|Social Travel|Travel,750000.0,USA,1,1,0,16506,16506,1
Big Data|Mobile|Travel,21723709.0,USA,3,6,2053,13514,15567,0
Machine Learning|Personalization|Reviews and Recommendations|Search,500000.0,USA,1,3,0,15522,15522,1
Apps|iPhone|Mobile,2000000.0,USA,2,5,1059,15065,16124,0
K-12 Education|Kids|Mobile Games|Social Network Media,1200000.0,USA,1,4,0,16198,16198,0
Baby Accessories|Consumer Goods|E-Commerce|Kids|Online Shopping|Retail,12800000.0,IND,2,7,257,16198,16455,0
E-Commerce|Social Commerce,1300000.0,USA,1,4,0,14853,14853,0
All Markets|Android|Curated Web|iPad|Navigation,2000000.0,USA,2,2,184,13695,13879,1
Brewing|Consumer Goods|Craft Beer,88688.0,GBR,1,1,0,15887,15887,0
Designers|Freelancers|Marketplaces|Search,755083.0,FRA,1,1,0,16164,16164,0
Logistics|Service Providers|Trading,4253074.0,GBR,1,1,0,16248,16248,0
Alumni|Online Travel|Private Social Networking,10000000.0,USA,1,4,0,13482,13482,0
Biotechnology|Health Diagnostics|Pharmaceuticals,50251719.0,GBR,5,19,1883,13976,15859,1
Clean Technology,8000000.0,SGP,1,1,0,13937,13937,0
Financial Services,30900000.0,USA,2,1,267,16252,16519,1
Biotechnology|Health Care,492000000.0,USA,4,3,2523,13717,16240,1
Clean Technology,318000000.0,USA,2,2,26,14581,14607,1
Construction|Design,20000.0,ARG,1,1,0,16495,16495,0
E-Commerce,697792.0,SWE,1,1,0,14181,14181,0
Hardware + Software,770000.0,USA,3,1,664,15482,16146,0
Real Estate,4200000.0,USA,2,1,1216,13944,15160,0
Big Data|Enterprise Software|Search|Software,248000000.0,USA,5,23,1149,15126,16275,1
Games,2500000.0,CHN,1,1,0,15887,15887,0
E-Commerce,250000.0,USA,1,1,0,15033,15033,0
Hospitality,2500000.0,USA,1,1,0,15748,15748,0
Hospitality|Professional Networking|Social Media,360000.0,HKG,1,1,0,15706,15706,0
Manufacturing,46000000.0,USA,1,1,0,12754,12754,0
Advertising|Cloud Computing|Enterprises|Enterprise Software|Finance|SaaS,85900000.0,USA,7,16,2019,14379,16398,0
Curated Web,6753120.0,USA,2,1,957,15675,16632,0
Adventure Travel|Online Travel,1025000.0,USA,3,1,231,16139,16370,0
Web Hosting,2000000.0,USA,1,2,0,14190,14190,0
Hospitality,2000000.0,GBR,1,5,0,16757,16757,0
Advertising,130000.0,USA,1,4,0,16289,16289,0
Web Hosting,110000000.0,USA,1,4,0,14697,14697,0
Apps|Hotels|Mobile|Sustainability|Tourism|Travel,1118000.0,ESP,2,2,429,16161,16590,0
Journalism|News,252040.0,SVN,1,5,0,14204,14204,0
EdTech|Education,235000000.0,USA,2,1,2839,13906,16745,0
Dental|Doctors|Health and Wellness|Medical|Web Hosting,1618785.76351502,AUS,1,1,0,16653,16653,0
Advertising|E-Commerce|Entertainment|Social Network Media,600000.0,USA,1,9,0,16337,16337,0
Travel,5000000.0,USA,1,1,0,12870,12870,0
Hotels|Travel,135000000.0,BRA,5,6,1588,15034,16622,0
Hospitality|Hotels|Service Providers,136332.0,BRA,1,1,0,11443,11443,0
Entertainment|Hotels|Sports,750000.0,ESP,1,3,0,15796,15796,0
Cable|Hotels|Television,15000000.0,USA,1,1,0,12142,12142,0
Curated Web|Hotels|Networking|Reviews and Recommendations|Search|Social Media|Software|Travel,5000000.0,USA,2,1,864,14200,15064,0
Enterprise Software|Hospitality|Hotels,3000000.0,IND,2,5,947,15441,16388,0
Hospitality|Hotels|Mobile|Travel,5660000.0,HKG,2,3,287,15973,16260,0
Online Reservations|Software|Travel|Travel & Tourism,2000000.0,TUR,3,3,435,15454,15889,0
Hotels|Travel,10141273.0,CHE,4,8,1096,15340,16436,0
Hotels|Mobile|Travel,80685000.0,USA,6,24,1162,15104,16266,0
Software,198000.0,USA,1,4,0,15714,15714,0
Enterprises|Software|Virtualization,10000000.0,USA,1,2,0,15195,15195,0
Colleges|Events|Facebook Applications|Private Social Networking|Social Media,1474998.0,USA,4,3,1340,14000,15340,0
Hotels|Online Rental|Real Estate|Search|Vacation Rentals,2300000.0,USA,1,1,0,13573,13573,1
Social Media,1420000.0,USA,1,16,0,14573,14573,1
Software,825000.0,USA,1,3,0,11640,11640,0
Communications Infrastructure|Service Providers|Telecommunications,3541773.0,SWE,1,1,0,12197,12197,1
Customer Service|Health Care|Medical Devices,10321150.0,USA,5,1,1035,14184,15219,1
Cars|E-Commerce,1000000.0,USA,1,1,0,13514,13514,0
Enterprise Software,65000.0,USA,2,2,445,15495,15940,0
Consulting|Enterprise Software|Professional Services|Small and Medium Businesses,12550000.0,USA,3,9,510,15960,16470,0
Entertainment,30000000.0,USA,1,1,0,12500,12500,0
Consumer Goods|Home Decor|Home Renovation,7450000.0,USA,1,1,0,16384,16384,0
Advertising|Social Media Advertising,9950000.0,USA,3,9,2216,13149,15365,0
Internet|Online Rental|Privacy|Real Estate|Startups|Technology|Travel,59700000.0,GBR,3,6,553,15069,15622,0
Curated Web,9000000.0,USA,3,5,635,16058,16693,0
Internet,4000000.0,IND,1,1,0,16606,16606,0
Clean Technology|Consumer Internet|Consumers|Home & Garden|Service Providers|Technology,1000000.0,GBR,1,1,0,16211,16211,0
Hospitality|Mobile|Mobile Payments|Social Commerce|Social Media,1157500.0,USA,6,19,693,15645,16338,0
Innovation Engineering|Real Estate|Technology,14500000.0,USA,1,1,0,12559,12559,1
Real Estate,139500000.0,IND,4,6,533,15860,16393,0
Mobile Payments|Payments|Rental Housing,1000000.0,NLD,1,1,0,16477,16477,0
Diagnostics|Finance|Health Care|Health Care Information Technology|Healthcare Services|Health Diagnostics|Life Sciences|Medical|Medical Devices|Medical Professionals|Startups,25000.0,USA,1,1,0,16484,16484,0
Health Care,2200000.0,USA,1,1,0,15405,15405,0
Curated Web|Design|Home Renovation,213600000.0,USA,4,28,1420,14924,16344,0
Computer Vision|Mobile|Software,17300000.0,USA,4,4,1083,15675,16758,0
Curated Web|Online Dating,22300000.0,USA,3,16,1120,14853,15973,1
Finance,4714510.0,CHN,2,4,548,15492,16040,0
Content|Online Education|Portals|Video,11000000.0,USA,3,4,612,13910,14522,0
Food Processing,2000000.0,USA,1,3,0,16330,16330,0
Curated Web,75000000.0,USA,2,3,2492,11122,13614,1
Software,40000.0,CHL,1,1,0,15379,15379,0
Finance|Payments|Software,232866.22094347,GBR,1,1,0,16657,16657,0
Human Resources,5658647.0,FRA,1,2,0,16604,16604,0
Information Technology,10600000.0,SGP,3,3,956,15764,16720,0
Biotechnology,9200000.0,USA,1,1,0,15798,15798,0
Human Resources|SaaS,500000.0,USA,2,1,340,16010,16350,0
Analytics,1000000.0,USA,1,1,0,15750,15750,1
EdTech|Education|K-12 Education,18000.0,USA,1,1,0,16111,16111,0
Fashion,10000000.0,CHN,1,1,0,15065,15065,0
Hospitality,500000.0,BRA,1,1,0,15524,15524,0
Biotechnology|Health Diagnostics,47232377.0,USA,5,5,1282,15029,16311,1
Finance|Software,3325510.0,USA,4,2,1091,15056,16147,0
Fashion|Finance,80000000.0,CHN,3,3,288,13787,14075,0
Pharmaceuticals,75000000.0,CHN,2,8,1206,15237,16443,0
Health Care|Mobile|Mobile Health,32000000.0,CHN,1,4,0,16553,16553,0
Consumer Goods|Distributors,106000000.0,CHN,1,2,0,16253,16253,0
EdTech|Education,8094638.0,CHN,2,1,184,14669,14853,0
Entertainment,69337442.0,CHN,1,1,0,15095,15095,0
Beauty|Cosmetics|E-Commerce,16300000.0,IDN,1,1,0,16363,16363,0
Analytics|Optimization|SEO,1000000.0,USA,2,1,578,15309,15887,0
Software,16393577.0,CAN,3,14,631,16085,16716,0
Coworking|Office Space,350000.0,THA,1,4,0,16729,16729,0
Consumers,4600000.0,AUS,1,1,0,16603,16603,0
Biotechnology,1150000.0,USA,4,5,634,15492,16126,1
Audio|Broadcasting|File Sharing|Messaging|Music|News|Social Media|Video Streaming,300000.0,AUT,1,1,0,15254,15254,0
Crowdfunding|Education|Social Fundraising,1477903.0,GBR,4,3,532,15826,16358,0
E-Commerce|Groceries|Local|Marketplaces|Online Shopping|Shopping,3398489.0,GBR,1,2,0,16240,16240,0
Enterprise Software,12400000.0,USA,2,4,1793,13818,15611,0
Manufacturing,3918495.0,CHN,1,1,0,15218,15218,0
Biotechnology,2381617.0,CHN,2,1,1156,14031,15187,0
All Students|Communities|Freelancers|Video Streaming,30000.0,ISR,1,1,0,16147,16147,0
Internet Marketing|Software,150000.0,USA,2,2,43,15868,15911,0
E-Commerce,6200000.0,USA,3,14,557,15964,16521,0
Crowdsourcing|Curated Web|Journalism,8000000.0,USA,2,3,211,13730,13941,0
Enterprises|Enterprise Software,2000000.0,CHN,3,5,822,14153,14975,0
Software,13000000.0,USA,1,4,0,13070,13070,1
Lead Generation|Software,100500000.0,USA,6,20,2385,13269,15654,1
Collaboration|Communities|Coworking|Entrepreneur|Networking|Office Space|Real Estate|Shared Services|Startups|Technology,4086462.38084569,GBR,2,3,976,15765,16741,0
Construction|Consumer Electronics|Consumer Goods|Interior Design|Real Estate,1000000.0,KOR,2,4,231,16314,16545,0
Collaboration|Document Management|Enterprise Software|Internet|Project Management|Web Development,89200000.0,USA,4,14,2585,13830,16415,0
Apps|Events|Mobile|Optimization,105000.0,USA,1,2,0,16244,16244,0
Business Productivity|Business Services|Employer Benefits Programs|Small and Medium Businesses|Subscription Businesses,571740.0,GBR,1,8,0,15075,15075,0
Advertising|Curated Web|Forums|Mobile|Shopping,22750000.0,USA,3,6,975,14000,14975,1
Software|Sports|Video,76850000.0,USA,3,3,2648,13879,16527,0
Content|Distribution|Film|Games|Media|Television|Video|Video on Demand,325000.0,USA,2,2,170,14805,14975,0
Media|News|Publishing,37000000.0,USA,5,10,1918,12904,14822,1
Curated Web,58700.0,GBR,1,1,0,15938,15938,0
Curated Web,600000.0,USA,1,1,0,14853,14853,0
Manufacturing,273417808.0,CHN,2,1,1308,13483,14791,0
Internet|Internet Marketing|Mobile|SEO|Software|Web Tools,25000.0,PAK,1,1,0,14014,14014,0
Curated Web|E-Commerce|Fashion|Retail,4500000.0,USA,3,10,483,15658,16141,0
Consumers|Curated Web|Events|Internet|Local|Parenting|Women,500000.0,USA,1,3,0,15847,15847,0
Digital Media|Education|Kids|Mobile,6450000.0,USA,3,41,892,15856,16748,0
Content|Entertainment|Games|Office Space|Television|Video,100000000.0,USA,2,2,638,13726,14364,0
Biotechnology,199762373.0,USA,2,6,277,16451,16728,0
Software,10600000.0,CAN,1,1,0,13431,13431,0
Mobile|Mobile Advertising|Startups,1225000.0,USA,2,4,107,15677,15784,1
Health and Wellness|Health Diagnostics,70000000.0,USA,1,4,0,16133,16133,0
Developer APIs|Software,6624982.0,USA,1,1,0,16451,16451,0
Android|Apps|Developer APIs|iOS|iPhone|Location Based Services|Mobile|Networking|Proximity Internet|Real Time|Social Media|Social Search,470000.0,USA,2,2,92,15034,15126,0
Business Services|Internet|Software,9000000.0,USA,1,4,0,16475,16475,0
Audio|Developer APIs|SEO|Social Media|Software|Speech Recognition|Video|Video Streaming|Web Development,1100000.0,USA,2,20,183,14761,14944,1
Analytics|Business Productivity|Human Resources,1000000.0,USA,1,3,0,16490,16490,0
Digital Media|Games|Nonprofits,4480000.0,USA,1,3,0,15085,15085,0
Health and Wellness,63000000.0,USA,3,10,928,14518,15446,1
Aquaculture|Clean Technology|Farming|Organic Food,750000.0,USA,1,2,0,16071,16071,0
Curated Web|Local,19200000.0,USA,3,6,862,13818,14680,1
Mobile,50000.0,USA,1,1,0,15706,15706,0
Education,50000.0,SGP,1,2,0,14975,14975,0
Travel & Tourism,1110531.0,ESP,1,4,0,16616,16616,0
Finance|Finance Technology|FinTech,532000000.0,CHN,1,1,0,16162,16162,0
Games|Music Services,140000000.0,IND,2,4,258,16255,16513,0
Software,33474.0,BGR,1,1,0,15966,15966,0
Groceries|Organic|Organic Food|Service Providers,25000.0,USA,1,1,0,16405,16405,0
Software,2710014.0,USA,1,2,0,16091,16091,0
Web Development,30000000.0,CHN,2,4,227,16161,16388,0
Software,1225000.0,USA,3,4,259,15871,16130,0
Advertising|Curated Web,10000000.0,CHN,2,6,1163,14975,16138,0
Mobile,20000000.0,CHN,2,2,303,15006,15309,0
Games,10000000.0,CHN,1,1,0,13361,13361,0
Media|News|Social Media|Sports,16000000.0,CHN,1,1,0,16265,16265,0
Software,5100000.0,IND,1,1,0,13789,13789,0
Consulting,22621063.0,GBR,1,1,0,15027,15027,0
Fashion,4000000.0,CHN,1,1,0,12112,12112,1
Group Buying|Location Based Services|Mobile|Networking,20000.0,USA,1,1,0,14730,14730,0
E-Commerce|E-Commerce Platforms|Mobile|Transportation,192357.0,CAN,2,1,92,16130,16222,1
Health Care,20200000.0,CHN,2,2,43,14921,14964,0
Big Data|Information Technology|Manufacturing|SaaS,7500.0,BGR,1,1,0,15857,15857,0
E-Commerce,40000.0,CHL,1,1,0,15562,15562,0
Entertainment|Games|Social Games,4000000.0,USA,1,1,0,16751,16751,0
Information Technology,2000000.0,USA,1,1,0,16657,16657,0
Social Media,157397.0,CHN,2,1,669,15522,16191,0
Restaurants,40000000.0,VNM,2,5,197,16341,16538,0
Hardware,4121860.0,SWE,1,1,0,16203,16203,0
Hardware + Software,4000000.0,TWN,1,5,0,16588,16588,0
Biotechnology|Health Diagnostics,7800000.0,USA,2,2,225,14292,14517,0
Medical|Medical Devices|Technology,16227.0,NLD,1,1,0,16525,16525,0
E-Commerce,500000.0,USA,1,1,0,15150,15150,0
Biotechnology|Cannabis|Pharmaceuticals,580000.0,CAN,4,5,405,16210,16615,0
Clean Technology|Energy|Manufacturing,1161200.0,IRL,1,1,0,15084,15084,0
E-Commerce|Finance|Security|Telecommunications,500000.0,ISR,1,1,0,15896,15896,0
Cloud Computing|Enterprise Software,18026455.549135502,GBR,4,16,796,15675,16471,0
Biotechnology,27450440.0,FRA,3,12,3392,11109,14501,0
Content|Enterprise Software|Services,30000000.0,CAN,4,3,1257,14512,15769,1
Building Products,15000000.0,USA,1,3,0,14071,14071,1
Biotechnology,94677500.0,USA,5,20,4631,11894,16525,0
Clean Technology,8974291.0,FRA,2,3,1299,14762,16061,0
Telecommunications,10000000.0,GBR,1,1,0,16357,16357,0
Clean Energy|Hardware + Software|Outdoors,12000.0,USA,1,1,0,15965,15965,0
Health and Wellness,18347935.0,USA,4,4,3236,11477,14713,0
Environmental Innovation,7500000.0,CAN,1,1,0,16561,16561,1
Environmental Innovation|Services,1100000.0,USA,1,1,0,12296,12296,1
Manufacturing,3429998.0,USA,2,2,418,14944,15362,0
Agriculture|Analytics|Water,40094161.0,USA,4,12,2955,12733,15688,0
Health and Wellness,13060100.0,USA,2,1,455,16104,16559,0
Biotechnology,8990000.0,DEU,1,4,0,13018,13018,0
Curated Web,50000.0,FRA,1,1,0,13483,13483,0
Finance|FinTech,33458281.0,DNK,3,7,1037,12487,13524,0
Apps|Events|Mobile|Search|Social Media,26001.0,ESP,1,1,0,15774,15774,0
Consumers|Curated Web|Reviews and Recommendations|Social Media|Web Tools,30015.0,CAN,1,1,0,15737,15737,0
Content Delivery|Content Discovery|Curated Web|Media|Video|Video Streaming,1100000.0,DEU,1,5,0,16673,16673,0
Advanced Materials,400000.0,USA,1,1,0,16679,16679,0
Manufacturing,336000.0,SWE,1,1,0,13965,13965,0
Event Management|Events|Information Technology|Service Providers,492373.0,JPN,1,2,0,16094,16094,0
Software,17200000.0,USA,4,9,769,13532,14301,1
Hospitality|Restaurants|Software,16004450.0,USA,4,2,2089,13295,15384,0
Advertising,4000000.0,ISR,1,3,0,10925,10925,0
Games|Mobile|Monetization|Publishing,110000.0,GBR,1,1,0,15492,15492,0
Health Care,18557041.0,USA,9,2,3029,12810,15839,0
Development Platforms|Mobile Commerce|Software,10600000.0,KOR,2,2,321,16435,16756,0
Curated Web,235536.0,POL,1,1,0,13879,13879,0
3D|Curated Web,2800000.0,USA,2,3,439,15675,16114,0
Software,11800000.0,USA,2,6,916,13390,14306,1
Cloud Management|Software,9900000.0,USA,2,4,391,13278,13669,1
Advertising,1200000.0,USA,1,4,0,15274,15274,0
Biotechnology|Health Care,165961509.0,USA,7,11,1521,13761,15282,1
Clean Technology,16374000.0,USA,3,3,1850,14033,15883,0
E-Commerce,1028880.0,USA,2,1,1374,14922,16296,0
Big Data Analytics|Cloud Data Services|Databases|Data Center Infrastructure|Data Integration|Data Visualization|Enterprise Software|SaaS,35000.0,CAN,1,1,0,16503,16503,0
Technology|Transportation,37100000.0,USA,2,3,266,16478,16744,0
Curated Web,75762572.0,GBR,1,1,0,15848,15848,0
Games,3000000.0,USA,1,1,0,13640,13640,0
Software,550000.0,USA,2,1,70,14033,14103,0
Analytics|Ediscovery|Local|Search,1150000.0,USA,2,8,480,14373,14853,0
Analytics|Outsourcing|Professional Services|Surveys,15500000.0,USA,2,6,590,12946,13536,1
Enterprise Software,24500000.0,USA,2,9,538,11963,12501,1
Computer Vision|Machine Learning|Startups,1000000.0,USA,1,3,0,16664,16664,0
Document Management|Internet|Knowledge Management,18000000.0,AUT,1,4,0,11697,11697,0
Social Media|Web Tools,761798.0,CHE,4,5,1221,14211,15432,1
Collaboration|Curated Web|EdTech|Education|Health and Wellness,3581700.0,FRA,4,1,1261,13879,15140,0
Diagnostics|Medical|Therapeutics,47500000.0,USA,1,9,0,12128,12128,1
Cyber Security|Security,92500000.0,USA,6,25,2186,14340,16526,0
Consumer Electronics|Customer Service|Hardware + Software|Life Sciences|Sales and Marketing,48625021.0,USA,5,9,1463,15201,16664,0
Advertising|Brand Marketing|Lead Generation,100000.0,USA,1,2,0,14426,14426,0
Broadcasting|Consumer Electronics|Event Management|Games|Real Time,53980.0,ARG,1,1,0,15614,15614,0
Clean Technology,2028545.0,JPN,4,1,1850,14636,16486,0
Enterprise Software,9670000.0,ARE,1,1,0,14881,14881,0
Social Bookmarking|Social Network Media,661448.0,KOR,2,3,448,15490,15938,0
Enterprise Software,1770000.0,GBR,1,2,0,13129,13129,0
Curated Web|Local|Local Search|Network Security|Online Scheduling|Service Providers|Small and Medium Businesses,103403.0,FRA,1,1,0,15034,15034,0
Digital Media|E-Books|Publishing,490830.0,KOR,1,1,0,16237,16237,0
Hotels|Resorts|Travel,63173.0,DEU,1,1,0,15522,15522,0
Social Media,200000.0,USA,1,2,0,14914,14914,0
Software,100000.0,USA,1,1,0,15706,15706,0
Energy|Energy Efficiency|Energy Management,12500.0,HKG,1,1,0,16252,16252,0
Mobile,1110000.0,GBR,1,1,0,13239,13239,0
Business Services|Software|Software Compliance,6000000.0,GBR,2,5,25,14060,14085,0
Data Centers|Web Hosting,361000000.0,USA,3,2,845,14223,15068,0
Electronics,22000000.0,USA,2,1,162,11381,11543,0
Finance|FinTech,10000000.0,NGA,1,1,0,16146,16146,0
Consumer Electronics|Entertainment|Games|Online Reservations|Social Television|Television|Twitter Applications,9197854.0,USA,2,1,119,15929,16048,0
Health Care,389673.0,CHN,1,1,0,15918,15918,0
Software,7000000.0,USA,1,1,0,11128,11128,1
Security,2250000.0,USA,1,2,0,14607,14607,0
Financial Services,41250.0,HKG,1,1,0,16252,16252,0
Clean Technology|Water,19491529.0,GBR,2,3,1849,14549,16398,0
Social Media,750000.0,USA,1,1,0,14046,14046,0
Health Care|Healthcare Services|Hospitals|Product Design,465000.0,SGP,1,1,0,16130,16130,0
Big Data|Cloud Data Services|Enterprise Software,35000.0,NOR,1,1,0,15675,15675,0
Search,6000000.0,USA,1,2,0,13649,13649,0
Enterprise Software|Security,15300000.0,IND,5,5,937,15572,16509,0
Advertising|E-Commerce|Telecommunications,17349401.0,FRA,3,5,2030,14669,16699,0
Finance|Internet,724400.0,ESP,1,1,0,15130,15130,0
Mobile Games,120000.0,GBR,1,2,0,16251,16251,0
Events|Internet|Mobile,602744.0,ARG,2,2,331,15587,15918,0
Public Relations,8000000.0,USA,1,3,0,13382,13382,0
E-Commerce,6000000.0,USA,1,1,0,13637,13637,0
Crowdfunding|Finance|FinTech,2250000.0,ISR,1,1,0,16518,16518,0
Health and Wellness|Health Care|Hospitals|Medical,1500000.0,USA,1,1,0,13794,13794,1
Manufacturing,20000000.0,CHN,1,2,0,14518,14518,0
Technology,11263347.0,CAN,2,5,128,12361,12489,0
Social Media,25000.0,USA,1,1,0,15899,15899,0
Healthcare Services|Medical|Medical Devices,13500000.0,USA,2,2,527,12999,13526,0
Games|Video,1000000.0,USA,1,2,0,13962,13962,1
Education|Training,1000000.0,CHN,1,1,0,16102,16102,0
Software,1630000.0,FRA,1,2,0,13572,13572,0
Analytics,340973.0,ESP,2,3,464,15340,15804,0
Aerospace|Drones|Hardware + Software,6160000.0,ESP,1,1,0,14650,14650,0
Data Visualization|Networking|Sensors,75762.0,GBR,1,1,0,15849,15849,0
Finance|Finance Technology|FinTech|Investment Management,2312413.0,USA,5,7,911,15400,16311,0
Big Data|Biotechnology|Machine Learning|SaaS,300000.0,RUS,1,1,0,16405,16405,0
Broadcasting|Internet Radio Market|Manufacturing|Semiconductors,42477641.0,USA,2,1,1623,12822,14445,1
Entertainment|Internet|Media|Personalization,500000.0,USA,1,3,0,13192,13192,0
Software,35000000.0,USA,1,1,0,16742,16742,0
Mobile,60000000.0,USA,3,10,880,15826,16706,0
Credit Cards|E-Commerce|Mobile|Mobile Payments,4800000.0,HKG,2,2,1417,15340,16757,0
Finance|FinTech,12200104.0,CHN,2,2,395,15492,15887,0
Software,60000000.0,IND,1,1,0,13720,13720,1
Finance|Financial Services|Service Providers,6020000.0,USA,1,5,0,12761,12761,0
Game|Games|Mobile Social|Social Games|Sports,25000.0,BGD,1,1,0,14167,14167,0
Android|Business Productivity|iPhone|Mobile|Publishing,2475000.0,USA,8,5,1010,15248,16258,0
B2B|E-Commerce|Networking|Small and Medium Businesses|Web Hosting,3174603.0,CHN,1,1,0,15340,15340,0
Sensors,22500000.0,USA,1,1,0,12478,12478,1
Analytics,15000000.0,USA,1,1,0,15342,15342,1
Biotechnology|Health and Wellness,5000000.0,USA,1,1,0,14508,14508,1
Application Platforms|Health and Wellness|Information Services,4000000.0,USA,1,4,0,11187,11187,0
Sports,1000.0,COL,1,1,0,15562,15562,0
Clean Technology,6500000.0,MYS,1,1,0,16139,16139,0
Biotechnology,4000000.0,USA,3,6,2675,13460,16135,0
Assisitive Technology|Elder Care|Services,80390.0,GBR,1,1,0,15677,15677,0
Hardware + Software,24634.0,NLD,1,1,0,15550,15550,0
Consumers|E-Commerce,70475000.0,SGP,3,8,616,15765,16381,0
Business Development|Finance|Startups,1900000.0,HUN,1,1,0,15675,15675,0
E-Commerce|Jewelry,47000000.0,USA,1,1,0,13879,13879,0
Health and Wellness,60000.0,HKG,1,2,0,16533,16533,0
Clean Technology|Local Businesses|Smart Grid,92000000.0,USA,4,9,1751,13149,14900,0
Games,8500000.0,CHN,1,2,0,13665,13665,0
Distribution|Telecommunications|Wireless,65000000.0,USA,1,2,0,16525,16525,0
E-Commerce|Marketplaces|Mobile|Software,1700000.0,FRA,1,1,0,16580,16580,0
Chat|Events|Mobile|Social Network Media,7200000.0,USA,1,2,0,13669,13669,0
Network Security,2500000.0,USA,1,1,0,16406,16406,0
Apps|Photography|Photo Sharing|Storage,713964.8202675909,GBR,2,1,140,16265,16405,0
Health and Wellness,14000000.0,USA,3,2,2406,14078,16484,0
Hardware + Software|Outdoors|Sporting Goods,1030000.0,USA,2,2,1555,14245,15800,0
E-Commerce|Lead Generation,3208418.0,NLD,1,1,0,16513,16513,0
Software,1500000.0,USA,1,2,0,12983,12983,1
Clean Technology|Networking,12404224.0,GBR,2,2,802,15281,16083,0
Mobile,244500000.0,GBR,9,25,3038,12090,15128,1
Search,300000.0,USA,1,1,0,12600,12600,1
Cloud Data Services|Enterprise Software|SaaS|Software,6000000.0,USA,1,2,0,16553,16553,0
Software|Surveys|Video,1859053.98948877,AUS,2,3,1195,14715,15910,0
Biotechnology,5082873.0,USA,4,2,2100,12954,15054,0
Information Technology,2800000.0,FIN,1,3,0,16751,16751,0
Career Management|Email|Fitness|Health and Wellness|Messaging|Mobile|Wine And Spirits,2330500.0,USA,4,6,1144,13787,14931,1
Analytics|Business Intelligence|Data Visualization|SaaS,10800000.0,USA,5,7,1686,14610,16296,0
Software,92583584.0,USA,3,1,2090,14623,16713,0
Mobile|Software,842723.0,ESP,1,1,0,15921,15921,0
Enterprise Software,59238985.0,USA,5,6,1702,14571,16273,0
Clinical Trials|Enterprise Software|Pharmaceuticals,20000.0,USA,1,1,0,16270,16270,0
Clinical Trials|Health Care|Pharmaceuticals,10000000.0,AUS,1,1,0,13886,13886,0
Apps|Content|Mobile,679347.0,PRT,1,1,0,16108,16108,0
Enterprise Software,2601416.0,USA,3,2,936,15043,15979,0
Software,81088.0,GBR,1,1,0,15597,15597,0
Hardware + Software,85000000.0,USA,2,9,722,15154,15876,0
Enterprise Software,12500000.0,USA,3,7,433,12815,13248,1
Public Relations,50000.0,AUS,1,1,0,14061,14061,0
Crowdsourcing|Design|Internet|Search,1500000.0,DNK,2,3,622,15508,16130,0
Biotechnology,28391902.0,USA,5,8,3395,12781,16176,0
Intellectual Property|Local|SaaS|Software|Translation,438032.0,IRL,1,3,0,16639,16639,0
Brand Marketing|Games|Licensing|Monetization|Software,3300000.0,DEU,1,1,0,15727,15727,0
Software,19000000.0,USA,3,5,963,15702,16665,0
Communications Infrastructure|Social CRM|Social Media,12500.0,NLD,1,1,0,16102,16102,0
Consumer Electronics|iPad|iPhone|iPod Touch|Manufacturing|Music,1600000.0,CAN,1,1,0,15553,15553,0
Design,50000.0,PER,1,1,0,15553,15553,0
Analytics,5000.0,USA,1,1,0,16222,16222,0
Email|Email Marketing|Email Newsletters|Messaging|Social Media Marketing|Surveys,53400191.0,USA,6,5,1582,13269,14851,1
Public Transportation|Shipping|Trading,1632395.0,ESP,2,6,2500,14048,16548,0
Ad Targeting|Advertising|Promotional,10000000.0,RUS,1,1,0,15938,15938,0
Software,4000000.0,USA,1,1,0,14130,14130,0
Security,93500000.0,USA,5,19,1881,13264,15145,0
Analytics|Big Data Analytics|Outsourcing,20000000.0,USA,1,1,0,16725,16725,0
Advertising,4890000.0,USA,3,3,3633,11710,15343,0
Health and Wellness|Predictive Analytics|Psychology|Therapeutics,20000.0,USA,1,1,0,15340,15340,0
Law Enforcement|Messaging|Politics|Polling|SaaS|Social Media,182500.0,USA,2,8,245,14730,14975,0
Software,12430000.0,IND,2,3,1048,14638,15686,0
Mobile,125000.0,USA,1,1,0,16010,16010,0
Advertising|Business Services|Internet Marketing|Sales and Marketing|Semantic Search|SEO,108000000.0,GBR,3,9,743,12977,13720,1
Clean Technology,10000000.0,USA,1,1,0,15665,15665,0
News,3000000.0,USA,1,1,0,14092,14092,1
Internet,650000.0,IND,3,6,251,16422,16673,0
Defense|Homeland Security|Public Safety|Sensors,3500000.0,USA,1,1,0,13544,13544,1
Enterprise Software,35150000.0,USA,3,9,1841,11808,13649,1
Consumer Goods|Online Shopping|Retail|Specialty Foods,5700000.0,IND,1,1,0,16374,16374,0
Data Privacy|E-Commerce Platforms|Identity Management|Online Identity,19665000.0,USA,9,11,1706,14806,16512,0
Security,5600000.0,CHE,1,1,0,15993,15993,0
Travel,3000000.0,USA,2,4,1048,14819,15867,0
Accounting|Big Data Analytics|Data Visualization|Finance Technology|SaaS,20000.0,USA,1,1,0,16468,16468,0
Web Hosting,81389.0,CHN,1,1,0,15857,15857,0
Apps|Distribution|Ediscovery|Games|iOS|Mobile,3500000.0,USA,1,7,0,15279,15279,0
Data Center Automation|Data Centers|Enterprises,4000000.0,IND,1,1,0,15987,15987,0
Advertising,5000000.0,IND,1,1,0,14063,14063,0
Web Browsers|Web Development|Web Hosting,28000000.0,USA,3,8,2359,10878,13237,0
Software,1150000.0,GBR,1,3,0,12921,12921,0
Consumers,12500.0,USA,1,1,0,15887,15887,0
Clean Technology|Energy,8250000.0,USA,4,2,1091,14839,15930,1
Advertising,1700000.0,USA,1,7,0,15894,15894,0
Collaboration|E-Commerce|Technology,13300000.0,USA,3,4,896,14195,15091,0
Incubators|Mobile|Startups|Technology,3250000.0,USA,2,1,144,15562,15706,0
Messaging,382000.0,BEL,1,1,0,13279,13279,0
Business Services|Cloud Computing|Contests|Creative|Productivity Software|Software,130000.0,NLD,1,1,0,15987,15987,0
E-Commerce,106800000.0,USA,5,12,2045,13848,15893,1
Biotechnology|Health Care,132000000.0,USA,3,1,1162,14936,16098,1
Software,338000.0,DEU,2,4,507,14715,15222,0
RFID|Software|Tracking|Wireless,35304000.0,USA,3,4,1792,13325,15117,0
Hardware + Software,1220000.0,USA,1,2,0,13112,13112,0
Analytics|Networking|Recruiting|Social Media,22500000.0,USA,4,31,886,14610,15496,1
Construction|Energy|Oil & Gas|Unmanned Air Systems,2000000.0,USA,2,5,271,16262,16533,0
Agriculture|Biotechnology|Diagnostics|Organic Food,2490000.0,IRL,1,1,0,13027,13027,0
Security,21700000.0,USA,2,5,236,13055,13291,0
Data Visualization|E-Commerce|Finance Technology|FinTech|Identity|Identity Management|Risk Management,12600000.0,USA,2,7,319,16191,16510,0
Enterprise Software,4000000.0,USA,1,2,0,15356,15356,0
Security,20000000.0,USA,1,2,0,12930,12930,0
Biotechnology,53800000.0,USA,3,1,1483,14628,16111,1
Biotechnology,59705235.0,USA,3,5,665,14741,15406,1
Hardware + Software,20100000.0,USA,4,3,1055,15246,16301,0
Enterprise Software,30000000.0,USA,1,1,0,14001,14001,0
Enterprise Software|Machine Learning|Natural Language Processing,6900000.0,USA,2,6,548,15811,16359,0
Customer Service|Market Research|Software|Surveys,6000000.0,KOR,6,10,1096,14975,16071,0
Advertising|Consulting|CRM|Customer Service|Marketing Automation|Semantic Web|Social Media|Web CMS,8800000.0,GBR,3,5,2953,13453,16406,0
Clean Technology,1895000.0,USA,2,1,467,14017,14484,0
Facebook Applications|Games|Social Games,19027562.0,USA,2,1,286,15013,15299,0
Clean Technology,3000000.0,USA,1,1,0,15148,15148,0
Curated Web|Health and Wellness|Medical|mHealth|Startups|Telecommunications,405000.0,USA,3,1,850,15645,16495,0
Enterprise Software,9000000.0,ISR,1,2,0,15867,15867,0
Software,380000.0,USA,2,9,61,15248,15309,0
Comparison Shopping|Curated Web|Search|Social Buying,400000.0,USA,2,2,577,14245,14822,0
Accounting|Finance Technology|Information Technology|Software,40000.0,USA,1,1,0,16222,16222,0
Android|Games,10454545.0,CHN,3,4,974,14975,15949,1
Nonprofits,3400000.0,USA,1,1,0,16153,16153,0
Games,600000.0,IND,4,5,1095,15461,16556,0
Web Hosting,267500.0,CAN,1,1,0,13020,13020,0
Software,5930000.0,FRA,2,5,729,12879,13608,0
Public Relations,4510000.0,THA,1,1,0,14561,14561,0
Digital Media|High Schools|K-12 Education,10000.0,IND,1,2,0,15564,15564,0
Application Platforms|Mobile|Web Development,50000.0,PER,1,1,0,15645,15645,0
Information Services|Property Management|Real Estate,3960000.0,JPN,3,6,762,15994,16756,0
Finance|Financial Exchanges|Financial Services|Stock Exchanges,100900000.0,USA,4,20,1047,15520,16567,0
Exercise|Fitness|Health and Wellness,379892.0,GBR,2,3,257,14245,14502,0
Travel & Tourism,14000000.0,USA,4,8,790,10897,11687,1
Consumer Internet|Curated Web|Mobile|Productivity Software,38500000.0,USA,3,21,971,15340,16311,0
EdTech|Education|Games,9300000.0,USA,2,8,280,15847,16127,0
Chat|Marketing Automation|Software|Telecommunications,76508268.0,USA,12,25,3870,12784,16654,0
Advertising|E-Commerce|Loyalty Programs|Retail|Social Games|Virtual Goods,11000000.0,USA,2,9,281,14872,15153,0
Social Media,29360000.0,CHN,2,2,1037,13573,14610,0
Analytics|Big Data Analytics|Hardware + Software|Indoor Positioning|Location Based Services|M2M|Mobile|Navigation|Proximity Internet|Public Transportation|Retail Technology|Sales and Marketing|Sensors|Wireless,1000000.0,POL,1,1,0,16296,16296,0
Health and Wellness,7973872.0,TWN,3,6,289,16130,16419,0
Entertainment,30000000.0,MYS,1,1,0,16548,16548,0
Finance,29000000.0,IND,1,1,0,16160,16160,0
Finance,25000000.0,IND,1,3,0,16660,16660,0
Finance,5000000.0,IND,1,1,0,16002,16002,0
Celebrity|E-Commerce|Entertainment|Fashion|Lifestyle|Local|Music|Retail|Sports|Wine And Spirits,15000000.0,USA,2,19,86,15920,16006,0
Delivery|Mobile Commerce|Restaurants,61860000.0,BRA,5,6,1399,15188,16587,0
Web Hosting,5000000.0,USA,3,3,1041,13580,14621,0
Business Services,21500000.0,USA,2,2,244,10957,11201,1
Crowdfunding|Financial Services|FinTech|Real Estate,4020000.0,USA,4,1,324,16265,16589,0
Mobile Software Tools,1975152.0,KOR,1,3,0,16262,16262,0
News,10000.0,IND,1,1,0,15340,15340,0
Software|Technology,100000000.0,IND,1,1,0,11943,11943,1
Advertising,20000000.0,KOR,3,4,2299,14031,16330,0
Advertising|Games,51357500.0,USA,4,13,1596,13180,14776,0
Brand Marketing|CRM|Internet Marketing|Internet of Things|Social Media Marketing|Social + Mobile + Local,80900.0,HKG,2,2,167,16252,16419,0
Biotechnology,77500918.0,USA,6,12,1821,14774,16595,0
Games|Virtual Worlds,4500000.0,USA,2,4,304,13880,14184,0
Collaboration|Content|File Sharing|Internet|SaaS|Social Network Media|Software|Web Tools,9000000.0,CAN,2,4,1365,14000,15365,0
Games,410423.0,GBR,1,1,0,15141,15141,0
Search|Semantic Search|Semantic Web,1100000.0,HUN,3,1,997,13757,14754,0
Big Data|Storage|Technology,23600000.0,USA,1,4,0,16196,16196,0
Advertising|Analytics|App Marketing|Big Data Analytics|Data Mining|Internet Marketing|Market Research|Mobile,77093.0,GBR,1,2,0,16486,16486,0
Development Platforms|Intelligent Systems|Systems,3800000.0,GBR,1,2,0,12536,12536,0
Clean Technology,5014644.0,GBR,1,1,0,15463,15463,0
Android|Blogging Platforms|E-Commerce|iPhone|Mobile|Software|Web Design,50000.0,IND,1,3,0,15926,15926,0
Advertising,4000000.0,ISR,2,4,364,14635,14999,0
Finance|Incubators|Startups,2661559.0,GBR,2,10,970,15156,16126,0
Games,14025457.0,USA,4,2,356,15021,15377,0
Advertising,11900000.0,USA,1,1,0,13773,13773,0
Information Technology|Services|Utilities,150000.0,USA,1,1,0,14197,14197,0
Analytics|Business Analytics|CRM|Market Research,300000.0,USA,1,1,0,16692,16692,0
Biotechnology|Health Care,173500000.0,USA,7,5,1050,15705,16755,1
Mobile,109565.827148951,USA,1,2,0,16587,16587,0
Messaging,2240000.0,USA,2,4,224,13665,13889,0
Games,40000.0,CHL,1,1,0,15446,15446,0
Home Renovation|Marketplaces|Mobile Commerce|Service Providers,4650000.0,ARG,2,3,303,16405,16708,0
Software,15000000.0,ISR,1,2,0,16764,16764,0
Curated Web,1170000.0,USA,3,3,405,14279,14684,0
Mobile,1597878.0,CHN,2,2,395,15492,15887,0
E-Commerce,11000000.0,CHN,1,2,0,14971,14971,0
Health and Wellness,25000000.0,USA,1,1,0,16332,16332,0
Health Care,7795000.0,USA,3,7,1788,14610,16398,0
Fitness|Health and Wellness|Internet,51728.0,GBR,1,1,0,15887,15887,0
Games,19150100.0,USA,4,1,1611,13879,15490,0
Software,2087997.0,USA,3,5,1557,14985,16542,0
Software,2297181.0,USA,2,1,478,16182,16660,0
Mobile,620000000.0,GBR,3,1,45,16132,16177,0
E-Commerce,43000000.0,CHN,2,3,326,14822,15148,0
Financial Services,173000000.0,IND,1,1,0,16732,16732,0
Internet|Networking|Open Source|SaaS|Software,63217039.0,USA,8,10,1781,14975,16756,0
Insurance,20352.0,EST,1,1,0,16272,16272,0
Analytics,17704186.0,USA,3,7,762,14880,15642,0
Business Intelligence|Business Travelers|Travel,13500000.0,USA,3,7,4563,11495,16058,1
Content Delivery|Delivery|Media|Storage,8000000.0,USA,1,4,0,11407,11407,0
Health and Wellness|Health Care,125000000.0,CHN,2,5,2008,13818,15826,1
Telecommunications|Web Hosting,47500000.0,USA,2,8,2057,11547,13604,1
Software,90000000.0,USA,3,14,2117,12242,14359,0
Biotechnology,344947203.0,USA,3,4,1618,12900,14518,1
Enterprise Software,147492730.0,USA,3,1,1457,14628,16085,1
Analytics|Public Transportation,1390000.0,USA,2,2,2289,13020,15309,0
Biotechnology,380000.0,ESP,1,1,0,13665,13665,0
E-Commerce,49180.0,TUR,1,2,0,15950,15950,0
Software,9500000.0,USA,1,6,0,11512,11512,0
Dental|Innovation Management|Software,30000.0,CAN,1,1,0,16495,16495,0
Education,175000.0,PAK,1,1,0,15340,15340,0
Lead Generation|Predictive Analytics|Productivity Software|Software,700000.0,FRA,1,1,0,15100,15100,0
Semiconductors,20700000.0,USA,4,6,1129,13677,14806,0
Consumer Electronics|Electronics|Semiconductors|Technology,1061520.0,IRL,1,2,0,15253,15253,0
Biotechnology,35205000.0,USA,3,5,1752,13803,15555,0
Curated Web,100000.0,USA,1,1,0,15248,15248,0
Clean Technology,1878750.0,ESP,1,1,0,14196,14196,0
Health Care|Social Entrepreneurship|Software,115000.0,IND,1,3,0,16138,16138,0
SaaS|Software,276686.0,USA,1,1,0,15461,15461,0
E-Commerce,500000.0,IND,1,1,0,16701,16701,0
Enterprise Software,965000.0,USA,2,4,214,15219,15433,1
Software,6000000.0,USA,1,3,0,14802,14802,1
Technology,10000000.0,USA,1,3,0,11694,11694,1
Artists Globally|Social Media,16500000.0,USA,3,7,1461,11688,13149,1
Logistics|Shipping,7600000.0,USA,1,2,0,11138,11138,0
Consumer Goods|Manufacturing|Public Safety,3475000.0,USA,3,4,612,15902,16514,0
Development Platforms|Game|Gamification,1060000.0,SWE,1,2,0,12900,12900,0
Business Services|SaaS|Sales and Marketing|Sales Automation,680000.0,USA,2,1,130,16622,16752,0
Health Care,36000000.0,USA,4,10,2008,13602,15610,0
Data Centers|Enterprise Software|Security|Software,142500000.0,USA,3,17,820,15719,16539,0
Agriculture|Architecture|Energy|Energy Efficiency|Hardware + Software,79835051.0,USA,11,25,2687,13971,16658,0
Business Intelligence|Software,3000000.0,GBR,1,2,0,14184,14184,0
Analytics|Big Data|Machine Learning,400000.0,GBR,2,5,822,15918,16740,0
Network Security,27000000.0,ISR,2,6,133,16595,16728,0
Consumer Internet|Information Services|SaaS,606156.0,NLD,2,1,87,15797,15884,0
Messaging,8500000.0,USA,1,6,0,12432,12432,1
Hardware + Software,25000000.0,USA,1,1,0,16010,16010,0
Collectibles|Crowdsourcing|Games|Social Network Media,1978262.0,ESP,4,1,396,15279,15675,0
Biotechnology,2573200.0,ITA,1,1,0,15887,15887,0
Medical,1021834.0,PRT,1,1,0,15996,15996,0
Biotechnology,5450000.0,USA,1,2,0,14296,14296,0
Clinical Trials|Health Care|Software,5200000.0,GBR,1,2,0,16555,16555,0
Internet,6490000.0,USA,2,2,906,15584,16490,0
Web Hosting,18000.0,USA,2,1,1210,13779,14989,0
Health Care|Health Care Information Technology|Mobile Health|Software,400000.0,USA,1,1,0,16507,16507,0
Advertising|Crowdsourcing|Curated Web|Photography,1450000.0,USA,2,2,441,15784,16225,0
Art|Artists Globally|Curated Web|Digital Media|Photography|Printing,2600000.0,USA,2,7,421,13149,13570,1
Apps|Mobile|Photography|Photo Sharing|Social Media,1310600.0,DEU,2,2,382,13497,13879,0
Biotechnology,40000000.0,USA,1,3,0,15266,15266,0
Web Hosting,10000000.0,USA,1,2,0,13634,13634,0
Advertising|Big Data|Computer Vision|Content|Image Recognition|Machine Learning|Software,7519000.0,USA,4,5,1525,14610,16135,0
Big Data|Image Recognition|Machine Learning|Photography|Startups|Visual Search,310000.0,BGR,2,2,1277,14610,15887,0
Internet,366567.0,SWE,1,2,0,16602,16602,0
Biotechnology|Health Diagnostics,33500000.0,USA,2,7,772,15426,16198,0
Software,40000.0,IND,1,1,0,15562,15562,0
Semiconductors,103139678.477403,GBR,6,5,3341,13422,16763,1
Software|Video|Video Streaming,34700000.0,USA,4,9,1935,12784,14719,1
Employment|Health Care,41000000.0,USA,2,3,223,16252,16475,0
Apps|B2B|E-Commerce|Hospitality|Hotels|Internet|Mobile|Sales and Marketing|Travel,2600000.0,USA,1,3,0,16392,16392,0
Software,1265400.0,GBR,1,4,0,13410,13410,0
Biometrics|Databases|Technology,12000000.0,USA,1,5,0,11716,11716,0
Advertising|Analytics|Big Data|Credit|Finance Technology|FinTech|Human Resources|Media|Psychology|Surveys,28550000.0,GBR,3,4,1682,13658,15340,0
Comics|E-Commerce|Entertainment|Life Sciences|News|Publishing,15000000.0,USA,1,3,0,13368,13368,1
Health and Wellness,4200000.0,CAN,1,3,0,16058,16058,0
Bio-Pharm|Biotechnology|Medical,26500000.0,USA,1,4,0,16374,16374,0
Analytics|Manufacturing|Market Research,11633057.0,USA,4,7,2542,11956,14498,1
Crowdsourcing|Mobile|Publishing|Software,20000.0,USA,1,1,0,15949,15949,0
Medical Devices,5100000.0,USA,1,4,0,13784,13784,0
Analytics,20769647.0,USA,4,2,5382,11373,16755,1
Enterprise Software|Internet Marketing|Semantic Web|Video Streaming|Web Development,999950.0,ESP,1,1,0,15218,15218,1
Algorithms|Information Technology|Services|Technology,20000000.0,USA,1,3,0,16370,16370,0
Semiconductors,15000000.0,USA,1,3,0,14347,14347,1
Education,1785830.0,KOR,4,6,561,15722,16283,0
Advertising|Business Services|Events|Internet|Public Relations,20000000.0,ITA,1,2,0,15533,15533,0
Games|Kids,150000.0,HKG,1,1,0,15918,15918,0
Health Care|Mobile|PaaS|SaaS,600000.0,USA,2,2,0,15955,15955,0
Music|Photography|Video,27132127.0,USA,6,12,1795,12662,14457,1
Finance,3084832.0,CYM,1,1,0,15126,15126,0
Media|Social Media|Software,153439.0,ESP,1,2,0,12296,12296,1
Health Care,7000000.0,ISR,1,1,0,15759,15759,0
Clean Technology,25000000.0,USA,3,9,3217,13409,16626,0
Information Technology|Services,3500000.0,USA,1,3,0,16729,16729,0
Health and Wellness|Medical|Medical Devices|Pharmaceuticals,9526833.0,DEU,2,4,125,16371,16496,0
Internet Infrastructure|Web Tools,7164000.0,USA,4,21,1489,15095,16584,0
Communities|Content Creators|Photography|Social Media|Social News,40000000.0,USA,1,2,0,16163,16163,0
Hardware + Software|Technology,1427030.0,ESP,1,1,0,15838,15838,0
Mobile,26000000.0,IND,3,4,1458,13103,14561,1
Software,5124996.0,USA,3,3,562,15425,15987,0
Hardware + Software,130000.0,CHE,1,1,0,14579,14579,0
Curated Web|Semantic Web,500000.0,USA,2,2,486,13514,14000,0
Bio-Pharm|Biotechnology|Independent Pharmacies|Manufacturing|Pharmaceuticals,178843287.0,DEU,5,23,3808,12459,16267,0
Biotechnology,60000000.0,USA,2,2,0,16680,16680,0
Semiconductors,20892857.0,USA,3,1,677,16077,16754,0
Business Productivity|Email|SaaS|Sales and Marketing,2550000.0,USA,3,27,641,15922,16563,0
EdTech|Education|Technology,2038317.0,GBR,2,8,1180,15050,16230,0
Education,475617.0,USA,3,1,325,16292,16617,0
Advertising,25000000.0,USA,1,3,0,13903,13903,1
Health Care|Medical|Pharmaceuticals,11300000.0,USA,1,4,0,12978,12978,1
Biotechnology|Health Care|Therapeutics,99031500.0,USA,5,14,2166,14067,16233,1
Biotechnology,700000.0,AUS,1,1,0,12852,12852,0
Biotechnology,20320961.397607397,GBR,2,8,975,13710,14685,1
Cloud Computing|IT and Cybersecurity|Security|Software,2000000.0,USA,2,3,670,13879,14549,1
Biotechnology,8064000.0,USA,5,2,1042,15097,16139,0
Biotechnology,150000.0,USA,1,1,0,13249,13249,0
Biotechnology,735000.0,USA,3,1,2249,13816,16065,0
Biotechnology,6080000.0,USA,2,1,734,15343,16077,0
Biotechnology|Health Diagnostics,6000000.0,USA,1,1,0,16134,16134,0
Biotechnology,9000000.0,USA,1,1,0,16016,16016,0
Diagnostics|Health Care|Health Diagnostics|Medical Devices,53750000.0,USA,2,5,769,11474,12243,1
Information Security|IT and Cybersecurity|Network Security|Security,2700000.0,CAN,1,3,0,16548,16548,0
Health and Wellness,1120000.0,USA,2,2,894,15373,16267,0
Health Care|New Product Development|Services,1200000.0,USA,1,1,0,16664,16664,0
Hospitality,32470645.0,USA,4,1,1990,14712,16702,0
Biotechnology|Market Research,320000000.0,GBR,1,3,0,16632,16632,0
Biotechnology,1341116.0,USA,3,1,495,14680,15175,1
Biotechnology,4009487.0,USA,8,1,1979,14498,16477,0
Biotechnology,6245999.0,USA,4,4,1488,14696,16184,0
Biotechnology,3050123.0,USA,4,3,1720,14741,16461,0
Biotechnology|Health Diagnostics,40000.0,CHL,1,1,0,16052,16052,0
Biotechnology|Pharmaceuticals,12000000.0,ISR,1,2,0,15359,15359,0
Biotechnology|Health Diagnostics,32000000.0,USA,2,2,1105,15321,16426,0
Biotechnology,3099458.0,USA,3,2,1214,15451,16665,0
Big Data|Data Integration|Data Security,1500000.0,USA,1,4,0,16632,16632,0
Biotechnology,1980000.0,USA,3,2,260,15201,15461,0
Local Based Services|Service Providers,50000.0,USA,1,1,0,16307,16307,0
Big Data Analytics|Entertainment Industry|Investment Management,70000.0,USA,1,2,0,16191,16191,0
Apps|Mobile,2000000.0,USA,1,2,0,16301,16301,0
Analytics|Customer Service|E-Commerce|Finance|Financial Services|Internet|Real Estate Investors,6500000.0,MYS,3,7,478,15860,16338,0
Advertising|Advertising Platforms|Monetization|Software,1900000.0,ISR,2,5,619,15848,16467,0
Big Data|Enterprise Software|Health Care Information Technology|Human Computer Interaction|Market Research|Software|Universities|Usability,4300000.0,DNK,2,3,544,13202,13746,0
Hardware + Software|Video,5717561.0,USA,5,3,3352,12600,15952,1
Advertising|Performance Marketing,8500000.0,USA,2,2,540,14083,14623,0
Games,250000.0,USA,2,2,134,13811,13945,1
Messaging,1000000.0,USA,1,2,0,13403,13403,0
Design|Media|Sales and Marketing,1950000.0,IRL,1,1,0,14809,14809,0
Automated Kiosk|Document Management|Services,800000.0,BRA,1,1,0,11657,11657,0
Biotechnology,4200000.0,USA,3,3,2812,11808,14620,1
Analytics|Big Data|Electronics|Hardware + Software|Mobile|Sensors|Sports,490196.0,CAN,1,1,0,15782,15782,0
Location Based Services|Logistics|Marketplaces|Transportation,40000.0,USA,1,1,0,16223,16223,0
Sales and Marketing|Software,17000000.0,USA,1,1,0,16505,16505,0
Education,4099999.0,IND,1,1,0,16468,16468,0
Web Hosting,3020000.0,CAN,1,2,0,14049,14049,0
Biotechnology,5000000.0,USA,1,2,0,13481,13481,0
Health Care,3470389.0,USA,5,4,2092,14630,16722,0
Biotechnology,4000000.0,GBR,1,2,0,14635,14635,0
Web Hosting,2000000.0,ISR,1,2,0,12801,12801,0
Education|Technology,500000.0,GBR,1,1,0,16288,16288,0
Security,9000000.0,USA,2,15,143,15152,15295,1
Security|Software,49000000.0,USA,3,10,1771,12206,13977,1
Software,10000000.0,USA,1,2,0,14186,14186,0
Internet of Things|RFID|Semiconductors|Software,86281952.0,USA,5,30,2414,13133,15547,0
Health Care,8521872.0,DEU,4,7,1589,14781,16370,0
Biotechnology,84403715.5553728,FRA,6,17,2376,13634,16010,0
Health and Wellness,21553000.0,USA,4,5,1774,14445,16219,0
Enterprise Software,25000000.0,USA,1,1,0,13318,13318,1
B2B|Big Data Analytics|Data Mining|Direct Sales|Predictive Analytics|Sales and Marketing,500000.0,DEU,1,1,0,16468,16468,0
Software,3300000.0,USA,1,1,0,16100,16100,0
Finance|Social Network Media,630969.0,ESP,4,2,1772,14572,16344,0
Big Data|Software,4300000.0,GBR,2,12,541,15776,16317,0
Hospitality,183000000.0,USA,2,6,357,16357,16714,0
Mobile,120000.0,USA,1,1,0,16267,16267,0
Health Care,5303000.0,USA,2,4,2715,12041,14756,0
Software,10000000.0,USA,1,5,0,13038,13038,0
B2B|E-Commerce|Marketplaces,62000000.0,USA,1,5,0,10919,10919,0
Manufacturing,1246443.0,GBR,2,2,542,15788,16330,0
Apps|B2B|Business Services|Design|Information Technology|Internet|Small and Medium Businesses|Software|Technology|Web CMS|Web Development,257320.0,LTU,1,1,0,15895,15895,0
Biotechnology,22946180.0,USA,2,1,1099,15468,16567,1
Energy|Energy Efficiency|Energy Management|Material Science,6000000.0,USA,3,6,745,15492,16237,0
Security,23910000.0,USA,2,7,792,13185,13977,1
Cloud Computing|Games|Software|Technology,22094860.0,GBR,1,2,0,16518,16518,0
E-Commerce|Hospitality|Mobile|Mobile Commerce|Restaurants|Wholesale,4000000.0,USA,2,3,351,16296,16647,0
Android|Art|Concerts|Events|iOS|Location Based Services|Mobile|Online Reservations|Sports|Theatre|Ticketing|Vertical Search,1400000.0,USA,3,4,820,15392,16212,0
Finance|FinTech|Mobile,50000.0,USA,3,2,659,15033,15692,1
Analytics|Computer Vision|Market Research,3016969.0,USA,7,18,675,14975,15650,1
Health Diagnostics|Medical Devices,2255893.0,GBR,1,2,0,16371,16371,0
Hardware + Software,1794902.0,SWE,1,2,0,13054,13054,0
Manufacturing,27444900.0,USA,1,2,0,15335,15335,0
Biotechnology,22000000.0,USA,2,4,1096,11688,12784,0
Biotechnology|Medical Devices,18339710.0,USA,10,2,2302,14447,16749,0
Digital Media|Music,12000000.0,BRA,3,3,2862,11017,13879,0
Digital Entertainment|Entertainment|Music|Musicians,3118891.0,CHE,3,6,506,15857,16363,0
3D|Entertainment|Games|Social Media|Virtual Currency,29000000.0,USA,4,9,1086,13180,14266,0
Internet,1000000.0,USA,1,2,0,16494,16494,0
Audio|Audiobooks|Publishing,13586.1361028923,GBR,1,1,0,15853,15853,0
Audio|Electronics|Hardware + Software,516160.0,IRL,1,2,0,15616,15616,0
Mobile,5639000.0,CAN,2,1,1784,12784,14568,1
Biotechnology,271199.0,NLD,1,1,0,16239,16239,0
Advertising,583000.0,JPN,1,1,0,14872,14872,0
Sports,51731.0,GBR,2,2,81,16154,16235,0
Software,1700000.0,USA,1,1,0,13514,13514,0
Health Care,4114060.0,FRA,1,1,0,16128,16128,0
Games,15280000.0,GBR,1,1,0,13675,13675,0
Finance,10180000.0,BEL,1,1,0,14862,14862,0
3D|Curated Web|Graphics|Presentations|Real Time,32500.0,USA,1,1,0,15714,15714,0
Advertising|Mobile Advertising,17000000.0,USA,3,7,1637,14245,15882,0
Hospitality,40000.0,GBR,1,1,0,15643,15643,0
B2B|Internet|Software,160000.0,ISR,1,1,0,15560,15560,0
Networking,12000000.0,USA,1,3,0,11122,11122,0
Health and Wellness,17110000.0,USA,2,4,631,15985,16616,0
Cyber Security|IT and Cybersecurity|Online Identity,8500000.0,USA,1,1,0,12789,12789,0
Android|iOS|Mobile,23835000.0,USA,2,3,267,16252,16519,0
Customer Service|E-Commerce|Semantic Search|Virtual Workforces,2000000.0,USA,2,2,15,16162,16177,0
Education,138172.05170935302,BRA,1,4,0,16504,16504,0
Biotechnology|Health Diagnostics,2492429.0,ESP,1,1,0,15519,15519,0
Apps|Artificial Intelligence|CRM,2600000.0,USA,1,4,0,16084,16084,0
Enterprise Software,2500000.0,USA,1,5,0,15660,15660,0
Developer APIs|Email|Social Media,8000000.0,USA,1,5,0,16462,16462,0
Biotechnology,984913.0,GBR,1,1,0,16103,16103,0
Manufacturing,2587000.0,IND,1,1,0,14209,14209,0
Biotechnology,5876977.0,USA,3,1,923,15630,16553,0
Entertainment Industry|Payments|Recruiting,49407.0,USA,1,1,0,16236,16236,0
Public Relations|Retail|Sales and Marketing,3980000.0,USA,2,3,519,14733,15252,1
Enterprise Software,500000.0,USA,1,1,0,15826,15826,0
Biotechnology,20000000.0,USA,3,1,947,15301,16248,0
Health Care,4700000.0,USA,1,2,0,15994,15994,0
Semiconductors|Technology,1400500.0,ESP,1,1,0,14239,14239,0
Hardware + Software,745000.0,USA,4,15,980,15279,16259,0
Software,160000.0,IND,1,2,0,16022,16022,0
Android|Games|iPad|iPhone|Mobile|Technology,5705000.0,USA,3,19,563,15229,15792,0
Enterprise Software,84700000.0,USA,5,27,1787,12142,13929,0
E-Commerce,2000000.0,TUR,2,4,418,15849,16267,0
Biotechnology,64940000.0,USA,3,6,644,14601,15245,1
Health and Wellness,1380000.0,USA,3,2,1248,14761,16009,0
Portals,160000.0,ARG,2,2,141,16051,16192,0
Web Hosting,1049336.0,SWE,1,2,0,15565,15565,0
Hardware + Software,659000.0,DEU,1,1,0,14732,14732,0
Machine Learning|Mobile|Mobile Video,6000000.0,USA,2,8,595,15783,16378,0
Social Media,40000.0,USA,1,1,0,15440,15440,0
Software,20943220.0,USA,5,22,1535,14774,16309,0
Finance Technology|FinTech|Mobile Payments|SaaS,178686.0,ARG,5,4,518,15949,16467,0
Automotive,15000000.0,IND,1,1,0,16689,16689,0
Curated Web|Internet|Marketplaces|Startups|Travel,2610000.0,GBR,3,8,798,15763,16561,0
Software,500000.0,USA,1,1,0,14000,14000,0
Health Care Information Technology,3001250.0,USA,3,3,1007,15351,16358,0
Software,7300000.0,USA,1,2,0,13370,13370,1
Games|Mobile|Video Games,1350000.0,POL,3,4,182,15340,15522,0
Curated Web|Search,5000000.0,USA,1,3,0,12996,12996,1
Biotechnology,1400000.0,CAN,1,3,0,15092,15092,0
Health Care,12800000.0,USA,3,3,338,16223,16561,0
Assisted Living|Curated Web,20450000.0,USA,9,8,1639,14865,16504,0
Software,480500.0,USA,3,1,690,15338,16028,0
Enterprise Software,7000000.0,USA,1,5,0,16028,16028,0
Biotechnology,31319064.0,SWE,2,5,1131,14995,16126,0
SaaS|Search,1600000.0,USA,1,5,0,15082,15082,1
E-Commerce,19000000.0,IND,2,5,224,15834,16058,0
Colleges|Curated Web|Search,652594.0,USA,2,4,213,15917,16130,0
Curated Web,75776000.0,IND,3,4,498,16176,16674,0
Finance|FinTech,7500000.0,IND,1,2,0,13321,13321,0
Financial Services,1000000.0,IND,2,4,90,16623,16713,0
Designers|E-Commerce|Fashion|Online Shopping,10000000.0,IND,2,2,249,16320,16569,0
Analytics|Big Data|Business Intelligence|Internet|Mobile|Sales and Marketing,2000000.0,USA,1,13,0,16357,16357,0
Software,6000000.0,USA,1,3,0,13250,13250,1
SaaS|Software,6000000.0,CAN,1,2,0,14552,14552,0
Cloud Data Services|Developer APIs|Developer Tools|Machine Learning|Small and Medium Businesses,3179000.0,USA,3,15,316,16071,16387,0
Debt Collecting|Finance|Financial Services,4000000.0,USA,1,1,0,16231,16231,0
Finance,56500000.0,USA,7,33,2300,13910,16210,0
Health Diagnostics|Software,10348250.0,USA,2,1,1239,14985,16224,0
E-Commerce|Fashion|Printing,31208.0,GBR,1,1,0,14822,14822,0
Security,3795746.0,USA,6,1,1023,14651,15674,0
Software,8217000.0,USA,3,24,1723,14761,16484,0
Enterprise Software|Software|Systems,6447280.0,ESP,3,3,2061,13612,15673,1
Software,1000000.0,IND,1,1,0,13259,13259,0
Analytics|Big Data|Retail|Retail Technology|Search|Software|Visualization,30889930.0,USA,5,8,1355,15254,16609,0
Music,200000.0,USA,1,2,0,15208,15208,0
E-Commerce,17250000.0,CAN,4,7,2635,13149,15784,0
Indoor Positioning|Mobile,17540000.0,USA,4,5,841,15796,16637,0
Clean Technology,3900000.0,USA,4,12,836,15503,16339,0
Biotechnology,2000000.0,CAN,1,1,0,16500,16500,0
Business Productivity|E-Commerce|EdTech|Software|Training,1714640.0,IRL,2,3,425,15980,16405,0
B2B|Corporate Training|Enterprise Software|Human Resources|Mobile|SaaS,100000.0,USA,1,1,0,16071,16071,0
Lifestyle|Restaurants|Specialty Foods,2000000.0,IND,1,5,0,16534,16534,0
Investment Management,23000000.0,USA,1,1,0,16759,16759,0
Clean Technology|Energy Efficiency|Industrial,1100000.0,USA,1,2,0,15250,15250,0
Software,750000.0,USA,2,6,149,16209,16358,0
Biotechnology,120000.0,USA,2,2,182,16405,16587,0
Games,5000000.0,USA,1,2,0,16160,16160,0
Curated Web,8500000.0,USA,2,1,280,13223,13503,0
Business Services|Distributors|E-Commerce|Industrial|Online Shopping|Shopping|Supply Chain Management|Wholesale,11000000.0,IND,2,3,197,16491,16688,0
Software,7500000.0,USA,1,5,0,12082,12082,0
Educational Games|Kids|Robotics,1010000.0,GBR,2,1,142,16344,16486,0
Media|News|Technology|Video Streaming,7100.0,USA,2,2,275,14335,14610,0
Financial Services|Information Technology|SaaS,7500000.0,CAN,1,3,0,12565,12565,1
Games|Social Games|Technology,50000.0,SLV,1,1,0,14744,14744,0
Semiconductors,43321001.0,USA,4,11,748,15821,16569,0
Social Media,453513.0,GBR,3,2,921,15597,16518,0
Advertising,400000.0,USA,1,1,0,13480,13480,0
Real Estate,2500000.0,USA,2,5,274,10834,11108,1
Point of Sale|Software,350000.0,CAN,2,1,1259,14628,15887,0
Clean Technology|New Technologies|Waste Management,9149004.0,GBR,4,8,1344,13238,14582,0
Hardware + Software,5765000.0,BEL,3,9,539,13405,13944,0
Biotechnology,75964876.0,USA,6,2,3407,13217,16624,0
Accounting|Finance Technology|Financial Services|FinTech|Mobile,1000000.0,POL,1,3,0,16077,16077,0
Artificial Intelligence|EdTech|Education|Machine Learning|Technology,2333428.0,ESP,4,10,798,15638,16436,0
Health Care|Medical Devices|Therapeutics,400000.0,USA,1,1,0,16302,16302,0
Design,750000.0,USA,1,2,0,13514,13514,0
CRM|Enterprise Software|Predictive Analytics,35000000.0,USA,2,6,597,15818,16415,0
Artificial Intelligence|Health Care|Machine Learning|mHealth|Software,310000.0,POL,2,1,518,15492,16010,0
Games,20000.0,USA,1,1,0,15764,15764,0
Chemicals|Health and Wellness|Water,19299.0,NLD,1,1,0,16020,16020,0
Finance,2750000.0,FRA,1,3,0,13434,13434,0
Apps|App Stores|Mobile|Mobile Software Tools,1100000.0,MYS,1,1,0,15065,15065,0
Telecommunications|Web Hosting,112000000.0,USA,4,23,1803,12006,13809,1
Software,30000000.0,USA,2,5,395,14736,15131,0
Clean Energy|Clean Technology,147863878.0,USA,11,18,2684,13149,15833,1
Databases|Data Security|Storage,230000000.0,ISR,2,1,848,15706,16554,0
Software,19069999.0,USA,5,3,3327,12784,16111,0
Software,24000000.0,USA,3,10,715,15340,16055,0
File Sharing|Mobile|Mobile Software Tools|Peer-to-Peer|Privacy|Storage,2240000.0,FRA,3,4,834,15384,16218,0
Networking,3400000.0,USA,2,3,1008,15694,16702,0
Android|DIY|iPhone|Mobile|Web Development,1000000.0,SGP,2,3,818,14975,15793,0
Clean Technology,85325657.0,USA,8,21,2435,13397,15832,0
Information Technology,600000.0,IND,1,2,0,16627,16627,0
Software,7500000.0,ISR,2,3,373,16160,16533,1
Games|Mobile,500000.0,THA,1,1,0,16420,16420,0
Biotechnology,181040191.0,USA,4,2,3203,12425,15628,1
Chat|Messaging|Social Media,952380.0,CAN,1,1,0,15940,15940,0
Curated Web|Lead Generation|Payments|Polling|Surveys,118000.0,USA,2,3,90,13149,13239,1
Clean Technology,9905200.0,USA,4,1,1479,14657,16136,0
Health and Wellness,37972639.0,GBR,1,1,0,15789,15789,0
Analytics|Big Data|Identity|Search,30000000.0,USA,1,2,0,14853,14853,0
Communities|Marketing Automation|Social CRM|Social Media Marketing,41589001.0,CAN,3,28,1063,15561,16624,0
B2B|Customer Service|Startups,250000.0,AUS,1,2,0,16132,16132,0
Analytics|Databases|Internet|Visualization,8892000.0,USA,2,5,551,15861,16412,0
Search,8400000.0,USA,1,1,0,12723,12723,0
Enterprise Software|Finance|Market Research,170000.0,USA,2,2,194,15896,16090,0
Android|Browser Extensions|Internet|iOS|iPad|iPhone|iPod Touch|Mobile|Search|Social Media|Social Network Media|Web Browsers,5400000.0,USA,4,12,2675,13969,16644,0
Career Management|Financial Services|Health Care|Software,1771014.0,GBR,2,2,415,12655,13070,0
Biotechnology,27174043.0,USA,6,18,966,15686,16652,0
Social Media,7000000.0,USA,2,1,2482,13427,15909,0
News,300000.0,USA,1,5,0,15840,15840,0
Security|Technology,30000000.0,USA,1,5,0,12898,12898,1
Analytics,21000000.0,CAN,3,7,730,13149,13879,0
Databases|Data Mining|Enterprises|Enterprise Software|Social Network Media|Software,5650000.0,USA,11,18,994,14866,15860,1
Cyber Security|Network Security,700000.0,USA,2,1,187,16200,16387,0
Software,457000.0,GBR,2,5,410,13643,14053,0
Consulting|Information Technology|Insurance|Retail,63000000.0,USA,1,7,0,16659,16659,0
Advertising|Mobile|Telecommunications,5000000.0,ISR,1,1,0,13149,13149,0
Facebook Applications|Software,4200000.0,USA,1,4,0,11956,11956,1
Data Visualization|Graphics|SaaS|Software,2802788.0,LVA,2,3,714,15400,16114,0
Infrastructure|Software|Technology,41000000.0,USA,2,12,181,11486,11667,1
Advertising,2500000.0,USA,2,2,306,13970,14276,0
Enterprise Software,3000000.0,USA,1,1,0,14677,14677,1
Software,20659.0,GRC,1,1,0,15284,15284,0
Fitness|Sensors|Sports,4016000.0,USA,3,1,1456,14551,16007,0
Software,4470000.0,CHE,1,1,0,13300,13300,0
Big Data|Big Data Analytics|Event Management|Indoor Positioning|Information Technology|Mobile Commerce|Mobile Coupons|Mobile Shopping|Mobile Social|Retail Technology|Social + Mobile + Local,250000.0,TUR,1,2,0,16102,16102,0
Software,40514852.0,USA,5,14,1920,12592,14512,0
Information Services|Property Management|SaaS,40000.0,CHL,1,1,0,16222,16222,0
Software,454575.0,GBR,1,1,0,16044,16044,0
Curated Web|Journalism|Media|Semantic Web,29330000.0,USA,4,5,1970,13192,15162,0
Enterprise Software,6000000.0,USA,1,4,0,12797,12797,1
Health and Wellness|Health Care|Information Technology|Medical,6000000.0,USA,1,2,0,15765,15765,0
Finance,1000000.0,USA,1,1,0,13361,13361,1
Advertising,9500000.0,USA,3,18,2656,10917,13573,1
Biotechnology,9155000.0,USA,4,1,2409,13879,16288,0
Big Data|Health Care|Mobile Health,4405915.0,USA,3,15,612,15950,16562,0
Advertising,1000000.0,USA,1,3,0,15120,15120,0
Enterprise Software,10000000.0,GBR,1,4,0,13446,13446,0
Mobile,1300200.0,ITA,1,1,0,15618,15618,0
Software|Web Development,200000.0,JPN,1,2,0,10470,10470,1
Software,5000000.0,USA,1,1,0,12990,12990,0
Software,340000.0,CHN,1,1,0,8978,8978,0
Consulting,32755000.0,USA,4,6,1806,12020,13826,1
Advertising|Email Marketing|Internet|Search,10000000.0,USA,1,1,0,10952,10952,0
Services,9710767.0,USA,2,2,131,16576,16707,0
Curated Web|Social Media,305000.0,ARG,2,1,1918,11596,13514,0
E-Commerce|E-Commerce Platforms|Internet|Services,5983000.0,BRA,4,6,571,15628,16199,0
Hardware + Software,39900.0,USA,2,1,3640,11323,14963,0
Health Care,91625000.0,USA,6,3,1316,14623,15939,1
Cloud Computing|Cloud Management|Enterprise Software|Homeland Security|Network Security|Security|Software|Storage,25049964.0,USA,4,3,1251,14975,16226,0
Software,24800000.0,IND,1,1,0,13705,13705,1
Security,6760000.0,USA,2,3,1300,13336,14636,0
Clean Technology,14413622.0,USA,4,1,669,16013,16682,0
Enterprise Software|Entrepreneur|Small and Medium Businesses|Telephony,3000000.0,USA,1,2,0,15559,15559,0
Enterprises|Enterprise Software|Software,6200000.0,USA,1,2,0,12227,12227,1
Software,20450000.0,USA,2,5,412,12159,12571,0
CRM|Email Marketing|Internet Marketing|Marketing Automation|Small and Medium Businesses|Software,127900000.0,USA,5,10,2545,13803,16348,0
Enterprises|Enterprise Software,1637554.0,CHN,1,1,0,16010,16010,0
Electronic Health Records|Health Care|Mobile Health|Startups,7267192.0,USA,3,1,1009,15622,16631,0
Enterprises|Network Security|Public Relations|Security|Telecommunications|Unifed Communications,5800000.0,SWE,1,1,0,12557,12557,0
Content Syndication|Curated Web|Facebook Applications|Publishing|Search|Social Media|Twitter Applications,1775000.0,USA,2,3,46,14518,14564,0
Clean Technology|Water,14997712.9480056,DEU,2,8,839,13593,14432,0
Big Data|Data Mining|Education|Natural Language Processing|Neuroscience|Software,416477.763324908,SVK,3,2,560,16183,16743,0
Biotechnology,2201920.0,ESP,1,2,0,15030,15030,0
All Students|EdTech|Education|Teachers,100000.0,FRA,1,1,0,15119,15119,0
Hardware + Software|Information Services|Information Technology|Mobile Payments,8280000.0,FRA,1,4,0,13444,13444,0
E-Commerce|E-Commerce Platforms|Lead Generation|Online Shopping,42000000.0,USA,1,11,0,11241,11241,0
Cloud Infrastructure|Diagnostics|Health Care|Health Diagnostics|Medical Professionals,6450000.0,USA,5,6,2005,14439,16444,1
Biotechnology,15400000.0,USA,1,4,0,14791,14791,1
Analytics|Services|Universities,19299.0,NLD,1,1,0,16020,16020,0
Angels|Finance|FinTech|Humanitarian|Incubators|News|Payments|SaaS|Venture Capital|Virtual Currency,500000.0,USA,1,5,0,15155,15155,0
Technology|Video Games|Virtual Worlds|Wearables,30000.0,GEO,1,1,0,16283,16283,0
Finance,15093046.0,USA,2,2,542,15985,16527,0
Apps|Taxis|Travel,31331233.0,AUS,6,8,637,15945,16582,0
Analytics|Social Commerce|Social Media|Travel,20000.0,USA,1,1,0,16177,16177,0
Advertising Platforms|Computer Vision|Online Video Advertising,150000.0,USA,1,1,0,16240,16240,0
Biotechnology,30000000.0,USA,1,4,0,15953,15953,0
Privacy|Security,51400000.0,USA,3,12,1154,11737,12891,1
Software,77000.0,USA,2,1,291,15293,15584,0
Online Rental|Real Estate,14000.0,USA,1,1,0,15126,15126,0
Coupons|Facebook Applications|Flash Sales|Games|Gamification|Retail|Social Buying,1300000.0,USA,2,2,609,14822,15431,0
Biotechnology,61250000.0,USA,3,6,2816,11729,14545,1
Biotechnology,1890000.0,GBR,1,1,0,13469,13469,0
Human Resources|Recruiting|SaaS|Startups,415008.0,SVK,1,2,0,16189,16189,0
Technology,135000.0,USA,2,2,61,16130,16191,0
Farming,3200000.0,IND,1,1,0,16524,16524,0
Clean Technology,4000000.0,USA,1,1,0,13664,13664,0
Biotechnology,28155227.0,CAN,3,16,1427,12605,14032,0
Security|Software|Web Development,4704437.65166886,IRL,2,4,0,14872,14872,0
Analytics|Data Visualization|Internet of Things|SaaS|Software,1541851.0,USA,2,1,317,16153,16470,0
Banking|Enterprise Software|Games|Governments|Health Care|Hospitality|Insurance|Services,31000000.0,USA,2,9,130,14053,14183,1
Biotechnology,6540899.0,GBR,1,3,0,16336,16336,0
Big Data Analytics|Education,500000.0,USA,1,1,0,16435,16435,0
Design|E-Commerce|Marketplaces|Printing,5600000.0,USA,3,23,1030,14123,15153,0
E-Commerce,1760000.0,CHN,1,1,0,14031,14031,0
Software,20000.0,USA,2,2,306,13208,13514,0
Android|Cloud Infrastructure|Corporate Training|Digital Media|Enterprise Software|iOS|Mobile|Publishing|Software,77124999.0,USA,8,32,1951,14610,16561,0
E-Commerce|Fashion|Marketplaces|Printing,250000.0,IND,1,4,0,16657,16657,0
Computers|Networking|Systems,56300000.0,USA,2,9,650,11275,11925,0
Design|Manufacturing|Retail,1500000.0,USA,1,7,0,16407,16407,0
Crowdfunding|Media|Publishing,1180000.0,USA,2,4,156,16066,16222,0
Digital Media|E-Commerce,390000.0,USA,2,2,595,15340,15935,0
Cloud Computing|Enterprise Software|Open Source|Software|Storage|Web Hosting,14400000.0,USA,2,2,241,15594,15835,1
Online Scheduling|Software,25000.0,USA,1,1,0,16102,16102,0
Web Hosting,22400000.0,USA,3,11,1140,12990,14130,1
Enterprise Software|Software,35856605.0,USA,5,6,3510,12398,15908,1
Enterprise Software,7000000.0,USA,2,2,670,13848,14518,0
E-Commerce,10000000.0,CHN,1,2,0,16102,16102,0
Advertising|Mobile,320600000.0,USA,6,9,3193,13514,16707,0
Digital Media|Mobile|Mobile Video|Soccer|Sports|Video,4445000.0,USA,5,4,1064,15674,16738,0
Advertising|Messaging|Mobile,2750000.0,USA,3,2,310,16252,16562,0
Enterprise Software,1251000.0,USA,2,2,486,15339,15825,0
Advertising,5000000.0,CHN,1,1,0,13483,13483,0
Online Reservations|Online Travel|Property Management|SaaS,555975.0,GBR,2,4,180,16134,16314,0
Analytics|Big Data|Big Data Analytics|Information Technology,107474.0,ITA,1,1,0,16542,16542,0
Hardware + Software,4880000.0,USA,1,1,0,14756,14756,0
Health and Wellness|Health Care|Medical,170000.0,USA,2,4,817,15735,16552,0
Biotechnology,134407592.0,FRA,5,19,5209,11036,16245,1
Cooking,1660000.0,IND,1,12,0,16702,16702,0
Advertising|App Marketing,11500000.0,USA,3,7,1256,14843,16099,0
Hardware + Software,50000000.0,USA,1,2,0,13543,13543,0
Communities|Gamification|Service Providers,118000.0,USA,1,1,0,16643,16643,0
Mobile,27000000.0,USA,4,16,2683,11897,14580,1
Outsourcing|Software,12960000.0,USA,2,4,1021,12891,13912,1
Advertising|Social Media Advertising,686268.0,CAN,2,3,473,15614,16087,0
Biotechnology,34800000.0,USA,2,4,1587,15121,16708,0
Curated Web|Hotels|Sustainability|Travel,185000.0,USA,1,1,0,16166,16166,0
Big Data|Enterprise Software|SaaS,300000.0,ISR,3,2,507,15334,15841,0
Games,398000.0,SWE,1,2,0,13840,13840,0
Education|Innovation Management|Internet,10600000.0,CHN,1,1,0,16324,16324,0
Manufacturing|Medical|Medical Devices,754466.0,DNK,1,2,0,15946,15946,0
Game,281158.0,KOR,1,1,0,15995,15995,0
Collaboration|Crowdsourcing|Enterprise Software,30300000.0,USA,4,6,2070,13181,15251,0
Pharmaceuticals,36000000.0,USA,2,1,125,16414,16539,0
Batteries|Services,2000000.0,USA,1,1,0,12542,12542,0
Bio-Pharm|Health Care|Medical,3000000.0,CAN,1,1,0,14454,14454,0
Manufacturing|Mobile|Television,20000000.0,CHN,3,3,854,13695,14549,0
Biotechnology|Health Diagnostics,9560000.0,BEL,1,1,0,13075,13075,1
Software,25107.0,NLD,1,1,0,16375,16375,0
Analytics|Business Intelligence|Internet|SaaS|Search|Software|Visualization,16500000.0,USA,4,8,2008,14092,16100,1
Apps|Digital Media|Mobile,41250.0,HKG,1,1,0,16071,16071,0
Content|Enterprise Software|Mobile|NFC|QR Codes,100000.0,CAN,1,1,0,16252,16252,0
Cloud Computing|Data Centers|Design,39000000.0,CHN,2,3,633,15706,16339,0
Semiconductors,22346760.0,DEU,2,10,781,13314,14095,0
Software,5000000.0,SWE,1,2,0,16205,16205,0
Medical,50000.0,USA,2,2,1056,15149,16205,0
Security,25000.0,USA,1,1,0,14036,14036,0
iPhone|Mobile|Mobile Devices|Mobile Security|Wireless,38500000.0,USA,3,7,878,12430,13308,0
Biotechnology,43000000.0,USA,3,4,712,15310,16022,1
Electrical Distribution|Electronics|Manufacturing,11525.0,DNK,1,1,0,16395,16395,0
Software,4000000.0,USA,1,1,0,12512,12512,0
Analytics|Big Data|Internet of Things|Mobile|Retail|SaaS|Software,2037451.37471372,ESP,1,1,0,16718,16718,0
Game|Mobile|Mobile Games,8200000.0,KOR,2,4,855,15785,16640,0
Automotive|Clean Technology|Incubators|Internet|Mobile|Social Media|Software|Technology,10000000.0,USA,1,1,0,16671,16671,0
Enterprise Software|Project Management,23734059.0,USA,6,5,2022,13409,15431,0
Hardware + Software,27000000.0,USA,1,3,0,13521,13521,1
Content|SEO,2100000.0,JPN,1,3,0,16315,16315,0
Semiconductors,10994000.0,FRA,2,7,622,12794,13416,0
Mobile,482786.0,SGP,1,1,0,15645,15645,0
Clean Technology|Energy Efficiency|Manufacturing,74341484.0,USA,6,24,1377,13797,15174,1
Data Visualization|Engineering Firms|Innovation Engineering,40000.0,CHL,1,1,0,15748,15748,0
Semiconductors,6220000.0,USA,1,4,0,13606,13606,0
Health and Wellness,4049516.0,USA,5,3,1547,15084,16631,0
Clean Technology,15500000.0,USA,1,3,0,14035,14035,0
Web Hosting,1052000.0,DEU,2,2,1040,12875,13915,0
Biotechnology,100000.0,USA,1,1,0,13788,13788,0
Biotechnology,20166221.0,USA,5,7,2484,12929,15413,0
E-Commerce,250000.0,USA,1,1,0,15201,15201,0
Manufacturing|Service Providers|Services,17000000.0,USA,1,3,0,12815,12815,0
Health and Wellness|Health Care|Health Care Information Technology,20600000.0,USA,2,8,144,15603,15747,0
Semiconductors,47000000.0,USA,3,9,1344,12478,13822,0
Health Care,18000000.0,USA,1,2,0,14130,14130,1
Health Care,13106945.0,CAN,3,2,356,15679,16035,0
Chat|Messaging,180000.0,PAN,1,2,0,14975,14975,0
Advertising,1790000.0,USA,1,2,0,13755,13755,1
Consulting|Enterprise Software,1900000.0,USA,1,2,0,15392,15392,1
Biotechnology,125000000.0,CHN,2,9,797,15660,16457,0
Ad Targeting|Advertising|Advertising Platforms|Internet TV|Technology|Video,37600000.0,USA,5,14,2642,13879,16521,0
Clean Technology,987056.0,GBR,1,1,0,13676,13676,0
Finance,6600000.0,IND,2,3,487,16149,16636,0
Hotels|Software,18561214.0,USA,7,4,2259,14245,16504,0
Clean Technology,40000.0,CHL,1,1,0,15779,15779,0
Hardware|Information Technology|Oil and Gas,15152514.0,GBR,1,1,0,15959,15959,0
Biotechnology,4633581.0,CAN,3,5,491,15978,16469,0
Health Care|Manufacturing,51645996.0,USA,3,6,1880,13562,15442,1
Biotechnology,69900000.0,USA,4,18,3453,12522,15975,1
Biotechnology,23158800.0,FRA,1,2,0,16146,16146,0
Sports,5400000.0,PAK,1,1,0,16738,16738,0
Aerospace,120000.0,USA,1,2,0,16591,16591,0
Health Care|Health Services Industry|Medical Devices,38065772.0,USA,4,3,1911,14508,16419,0
Human Resources|Payments|Service Providers,7100000.0,USA,4,5,1074,15156,16230,0
Computers|Mobile Enterprise|Software|Technology,237591.0,GBR,2,4,136,16202,16338,0
E-Commerce|Sales and Marketing|Trading,1500000.0,IDN,3,13,756,16000,16756,0
Sports,19310714.0,GBR,1,1,0,15474,15474,0
Pharmaceuticals,565962.0,FRA,1,1,0,16476,16476,0
Biotechnology,108300000.0,USA,2,1,567,16133,16700,0
Clean Technology,3831975.0,USA,3,3,1707,14225,15932,0
Hardware + Software|Manufacturing|Semiconductors|Software|Testing,34000000.0,USA,2,8,992,11474,12466,1
Finance,81393.0,CHL,2,2,86,15553,15639,0
Hardware|Storage|Web Hosting,67100000.0,USA,3,18,1854,12025,13879,0
Semiconductors,45795665.0,USA,4,8,3436,11354,14790,1
Internet|Wireless,56000000.0,USA,1,1,0,12233,12233,1
Advertising,1507400.0,ITA,1,1,0,14101,14101,0
Collaboration|Consumer Internet|Curated Web|Q&A|Semantic Search|Social Media|Social Opinion Platform|Social Search,527865.0,TUR,3,7,910,14669,15579,0
E-Commerce|Machine Learning,1250000.0,USA,1,9,0,15105,15105,0
Nanotechnology,125000.0,USA,1,1,0,16526,16526,0
Manufacturing,13160000.0,USA,3,5,1265,14975,16240,0
Biotechnology|Health Care,205000.0,BRA,3,2,789,15126,15915,0
Knowledge Management|Software,9250000.0,USA,1,4,0,12261,12261,1
Health and Wellness|Health Care|Tech Field Support,597001.0,USA,2,2,306,15428,15734,0
Software,765203.0,GBR,1,3,0,15803,15803,0
Curated Web|Real Estate,100000.0,USA,1,1,0,16531,16531,0
Curated Web|Diabetes|Health and Wellness|Medical|Mobile|Nutrition,437000.0,USA,5,4,864,15845,16709,0
Distribution|Fashion|Manufacturing|Retail|Wholesale,13059337.8528769,SWE,2,5,646,15930,16576,0
Analytics|Big Data|Crowdsourcing|Public Transportation|SEO,143100018.0,USA,9,13,3586,12884,16470,0
EdTech|Education|iPad|Software,2504936.0,GBR,4,4,772,15553,16325,0
Finance,4500000.0,CAN,1,1,0,15611,15611,0
Content|Service Providers,3000000.0,USA,1,1,0,12471,12471,0
Information Services|Information Technology|Telecommunications,6000000.0,USA,1,2,0,12468,12468,0
EdTech|Education,488140.0,KOR,1,1,0,16217,16217,0
E-Commerce|Photo Sharing,133130.0,BGR,3,3,365,15949,16314,0
Electronics|Embedded Hardware and Software|Hardware + Software|Sensors,3045000.0,USA,2,2,240,16463,16703,0
Mobile,5000000.0,ISR,1,3,0,16454,16454,0
Software,500000.0,USA,2,2,773,14033,14806,0
Messaging,1145000.0,GBR,4,1,2706,13545,16251,0
Software,94734880.0,FRA,5,30,1632,13102,14734,1
Analytics|Curated Web|Internet|Optimization|Social Media Marketing,2245000.0,USA,3,1,114,15922,16036,1
B2B|Consumers|Content|E-Commerce|Enterprises|Information Technology|Media|Publishing|Retail|Technology,320000.0,USA,1,1,0,15796,15796,0
Business Services|Curated Web|Local|Reviews and Recommendations,8500000.0,USA,1,3,0,13208,13208,1
Finance,40000.0,CHL,1,1,0,15811,15811,0
Big Data Analytics|Enterprise Software|Lead Management|Machine Learning|Predictive Analytics|SaaS|Sales and Marketing|Sales Automation,201200024.0,USA,4,20,950,15562,16512,0
Education,5750000.0,USA,3,3,3115,13088,16203,0
Enterprise Software|Retail Technology,75962000.0,USA,7,20,2981,13665,16646,0
Software,8300000.0,USA,3,1,957,13723,14680,0
Energy|Oil|Utilities,100000000.0,USA,1,1,0,11954,11954,0
Curated Web,3000000.0,USA,2,1,820,14762,15582,0
Internet of Things|Robotics,4000000.0,HKG,3,1,1962,14411,16373,0
Health Care|Medical Devices,119900000.0,USA,3,9,2572,13847,16419,0
Business Services|Market Research|Search Marketing,6500000.0,USA,2,4,275,15608,15883,1
Enterprise Search|Networking|Social Media,250000.0,USA,1,1,0,15949,15949,0
Security,6000000.0,ISR,1,1,0,13720,13720,0
Business Services|Software,13000000.0,USA,2,6,345,15615,15960,0
Marketing Automation|Social Media|Social Media Marketing|Software,4500000.0,USA,3,6,603,15742,16345,0
Biotechnology,19962500.0,USA,5,2,669,15999,16668,0
Crowdsourcing|Government Innovation|Innovation Management,80000.0,ISR,2,1,343,14905,15248,0
Analytics,4300000.0,USA,1,3,0,15428,15428,1
Analytics|Business Intelligence|CRM|Software,27000000.0,USA,4,16,1383,15008,16391,0
Hospitality,1310692.0,GBR,1,4,0,16008,16008,0
Financial Services,120500000.0,USA,6,37,878,15765,16643,0
Semiconductors,30063363.0,USA,3,7,2034,12531,14565,0
Bioinformatics|Genetic Testing|SaaS,1520000.0,BEL,2,2,116,15649,15765,0
Biotechnology|Diagnostics|Medical|Semiconductors|Testing,13000000.0,USA,1,2,0,16365,16365,0
Health Care,2290612.0,USA,4,1,867,14629,15496,0
Software,16815000.0,USA,1,1,0,16463,16463,0
Mobile,25952539.0,USA,6,3,1876,14013,15889,0
Software,10250000.0,USA,2,7,561,11065,11626,1
Design|Virtualization|Virtual Worlds,120000.0,USA,1,1,0,16405,16405,0
Aerospace|Manufacturing,21330000.0,USA,1,2,0,13853,13853,0
Advertising,3207612.0,GBR,1,1,0,15635,15635,0
Information Technology,20352.0,GBR,1,1,0,16272,16272,0
Health Care,13881227.0,USA,2,3,569,13936,14505,1
Curated Web,3721004.0,USA,4,1,904,14195,15099,0
Biotechnology,25021504.0,CHE,3,3,1801,14823,16624,0
Restaurants,394809.0,GBR,1,1,0,15737,15737,0
E-Commerce,11470000.0,FRA,2,3,309,13848,14157,0
Lifestyle|Travel|Vacation Rentals,79700000.0,USA,5,10,1244,15092,16336,0
Clean Energy|Clean Technology|Consumer Internet|Energy|Energy Efficiency|Renewable Energies|Residential Solar,8200000.0,USA,2,7,536,15950,16486,0
Biotechnology|Hardware|Health Care,57000000.0,USA,2,11,1781,14424,16205,0
Business Services,15295019.0,GBR,2,5,833,11250,12083,0
Health Care,24983103.0,ISR,6,1,1557,14827,16384,1
Health Care|Healthcare Services|Hospitals,8020000.0,USA,1,6,0,12496,12496,1
Travel & Tourism,3000000.0,USA,1,1,0,16611,16611,0
Hardware + Software,500000.0,USA,2,2,493,13885,14378,0
Health Care,350000.0,USA,1,1,0,15453,15453,0
Nanotechnology|Startups,570966.0,SWE,1,1,0,14914,14914,0
Financial Services,445958.0,RUS,2,1,702,15614,16316,0
Application Platforms|Big Data Analytics|Cloud Computing|Cloud Data Services,3770000.0,USA,2,3,84,16594,16678,0
Electronics|Hardware|Hardware + Software,100000.0,LBN,3,4,854,15218,16072,0
Mobile|Wireless,4000000.0,SWE,2,5,322,16358,16680,0
iOS|Mobile|Software,300000.0,EGY,1,6,0,16040,16040,0
E-Commerce|Groceries|Local Businesses,274800000.0,USA,5,25,942,15492,16434,0
Curated Web,30000.0,IND,1,1,0,16102,16102,0
Apps|Mobile|Reviews and Recommendations|Sports|Video,233536.0,IRL,1,1,0,16121,16121,0
Education|Tutoring,5100000.0,USA,2,19,441,15490,15931,0
Marketplaces|SaaS|Software|Staffing Firms|Temporary Staffing,70484.0,DEU,2,2,39,16152,16191,0
Education,47619.0,CAN,1,1,0,15887,15887,0
Mobile|Photo Editing|Photography|Photo Sharing|Social Media|Social Network Media,57500000.0,USA,3,12,762,14673,15435,1
Software,1308756.0,IND,1,1,0,14335,14335,1
Software,2000000.0,USA,1,1,0,13354,13354,0
Advertising Networks|Advertising Platforms|Mobile Advertising|Monetization,675529.0,ITA,1,1,0,16102,16102,0
Information Technology,120000.0,IND,1,3,0,16496,16496,0
Meeting Software|Software|Virtualization,11499997.0,ISR,2,2,634,14102,14736,1
Advertising,500000.0,USA,2,6,379,15340,15719,0
Technology,21000000.0,USA,1,1,0,11915,11915,0
Banking|Cloud Computing|Finance|FinTech|Health Care|Technology,79209599.0,USA,15,14,3503,12904,16407,0
Curated Web|Media,4000000.0,IND,1,1,0,14861,14861,0
Finance|Marketplaces|Payments|Social Commerce,500000.0,IND,3,11,865,15522,16387,0
Entertainment|Identity|Match-Making|Mobile|Online Dating|Psychology|Video,105000.0,USA,2,1,242,15967,16209,0
Cloud Computing|Developer APIs|Software,105000.0,USA,3,4,396,15706,16102,0
Apps,2130000.0,USA,2,7,156,16587,16743,0
Biotechnology,875000.0,USA,1,1,0,15534,15534,0
Enterprise Software|Information Services|Information Technology|Mobile|Reviews and Recommendations,235650.0,IRL,3,2,492,15218,15710,0
Software,8800000.0,USA,1,3,0,13285,13285,1
Market Research|Mobile|Surveys,29540000.0,USA,4,8,1931,13970,15901,0
Business Services,25000.0,RUS,1,1,0,16040,16040,0
Finance,550000.0,BRA,1,1,0,15248,15248,0
Big Data Analytics|Business Analytics|Data Integration|Location Based Services,150000.0,USA,1,2,0,15854,15854,0
Audio|Mobile|Real Time,300000.0,CAN,2,5,403,15949,16352,0
Content Delivery|E-Commerce|Mobile,95000000.0,USA,4,18,1197,15371,16568,0
Internet,2000000.0,IND,2,3,74,16664,16738,0
Finance Technology|Investment Management,120000.0,USA,2,2,275,16130,16405,0
Consumer Electronics|iPhone|iPod Touch|Mobile|Music,1420698.0,USA,4,3,1068,14031,15099,1
Advertising,12000000.0,USA,1,1,0,15491,15491,0
Finance|SaaS|Software,330000.0,USA,4,2,243,15614,15857,0
Advertising,2142981.0,USA,3,2,787,14333,15120,0
Social Media,1000000.0,CHN,1,1,0,15248,15248,0
Colleges|EdTech|Education|Enterprise Software|High Schools|Software,79100000.0,USA,4,13,1816,14669,16485,1
Biotechnology|Health Care,68500000.0,USA,3,17,937,11542,12479,1
Enterprises,16150000.0,USA,3,4,639,10987,11626,1
Insurance,31000000.0,USA,2,3,1938,14791,16729,0
Software,6000000.0,USA,1,1,0,13173,13173,1
Insurance,8199999.0,USA,1,1,0,11478,11478,0
Software,10000000.0,TWN,1,1,0,15300,15300,0
Software,12399999.0,USA,3,4,1580,13149,14729,0
Accounting|Cloud Computing|Enterprise Software|Finance|SaaS|Software,139800000.0,USA,9,31,2830,13289,16119,0
Health Care,62437496.0,USA,5,5,1177,15392,16569,0
Analytics|Big Data|Point of Sale|Retail|SaaS,2950000.0,USA,2,4,911,15826,16737,0
Apps|Cloud Computing|Enterprise Software|Mobile,39617282.0,SGP,6,15,4063,11631,15694,1
Software,7900800.0,GBR,3,7,1420,13356,14776,0
Biotechnology,852305937.0,USA,11,27,4499,12053,16552,0
Consulting|Outsourcing,21900000.0,IND,2,2,702,13802,14504,0
Biotechnology,5000000.0,ISR,1,2,0,15936,15936,1
Computers|Electronics|Recycling|Services,52500000.0,USA,4,15,632,13024,13656,1
Analytics|Biotechnology|Health Diagnostics,88200000.0,USA,5,19,2946,13389,16335,0
Enterprise Software,11000000.0,SGP,1,2,0,14396,14396,0
Semiconductors,16000000.0,USA,1,3,0,13672,13672,0
Advertising|Big Data Analytics|Digital Media|Internet,116750070.0,USA,6,10,2124,14523,16647,0
Advertising|Big Data|Games|Predictive Analytics|Television|Video,50000.0,USA,1,1,0,15636,15636,1
Security,850000.0,USA,2,1,379,15706,16085,0
Software,46750000.0,USA,6,14,1624,14957,16581,0
Enterprise Software,14750000.0,USA,2,9,758,12026,12784,0
Biotechnology|Diagnostics|E-Commerce|Fashion|Health Care|Health Diagnostics,89050000.0,USA,7,16,3211,12978,16189,0
Software,1300000.0,GBR,1,1,0,12993,12993,0
Hardware|Manufacturing|Material Science,8800000.0,USA,1,3,0,13116,13116,1
Health Care,3000000.0,USA,2,1,188,14671,14859,0
Business Services|Mobile Devices|Services,3538027.0,USA,1,1,0,15377,15377,0
Finance|FinTech,9000000.0,USA,1,1,0,13612,13612,0
Semiconductors,11000000.0,USA,2,6,779,12459,13238,1
Manufacturing|Mobile|Video,13000000.0,USA,1,5,0,12879,12879,0
Software,2000000.0,USA,1,1,0,13432,13432,0
Enterprise Software,36518951.0,USA,5,11,2279,12461,14740,1
Business Services|Productivity Software|Software,5500000.0,USA,1,2,0,13944,13944,0
Advertising|Lead Generation,13250000.0,USA,2,3,934,14627,15561,1
Hardware|Hardware + Software|Health and Wellness|iPhone|Mobile|Mobile Software Tools|Wearables,508573.0,POL,2,1,376,15706,16082,0
Biotechnology,7000000.0,USA,1,2,0,13678,13678,1
Enterprise Software|Service Providers|Unifed Communications|VoIP,41102097.0,USA,4,6,1672,14194,15866,0
Big Data Analytics|Business Intelligence|Knowledge Management|Market Research|Payments,100000.0,POL,1,1,0,13422,13422,0
Video on Demand|VoIP|Web Hosting,6389987.0,USA,4,1,1233,14335,15568,0
Developer APIs|Logistics|SaaS,400000.0,BRA,1,1,0,16162,16162,0
Telecommunications,12000000.0,USA,1,4,0,13210,13210,1
Curated Web,31000000.0,USA,1,1,0,16630,16630,1
Enterprise Software,44000000.0,USA,4,16,1377,13860,15237,0
Finance,4500000.0,IND,1,2,0,16134,16134,0
Biotechnology,85000000.0,USA,2,11,287,16392,16679,0
Web Hosting,22000000.0,USA,1,1,0,15538,15538,0
Information Services|Services,9900000.0,USA,1,1,0,11410,11410,0
Hardware + Software,4500000.0,USA,2,1,1202,14882,16084,1
Biotechnology,24844672.0,USA,4,9,899,15831,16730,0
Software,105000000.0,USA,4,9,1909,11746,13655,1
Health Care|Hospitals|Medical,12000280.0,USA,2,1,751,13584,14335,0
Agriculture|Farmers Market,20000.0,USA,1,2,0,16556,16556,0
Android|Apps|Automotive|iOS|iPad|iPhone|Mobile|Real Time,13017000.0,DEU,4,10,1035,14883,15918,1
Beauty|E-Commerce|Fashion,43000000.0,USA,2,2,318,13774,14092,0
Biotechnology|Health Care|Medical,353000.0,USA,1,2,0,13965,13965,1
Clean Technology,166570000.0,GBR,6,3,3175,12978,16153,1
Fitness|Health and Wellness|Health Care,463289.458105764,GBR,1,1,0,16725,16725,0
Analytics|Business Intelligence|RFID|Software,5161000.0,USA,3,2,1228,14949,16177,0
Automotive,4000000.0,CAN,1,1,0,15914,15914,0
Mobile,500000.0,USA,2,3,388,15384,15772,0
Real Time|SEO|Service Providers,15000.0,GBR,1,1,0,16594,16594,0
Advertising,2603474.0,GBR,1,1,0,16340,16340,0
Health Care|Medical Devices|Software,2094510.0,GBR,1,1,0,16351,16351,0
Clean Technology,40000.0,CHL,1,1,0,15667,15667,0
Analytics,3590727.0,USA,3,2,521,14593,15114,0
Clean Technology,250000.0,USA,1,3,0,15897,15897,0
Biotechnology,85000000.0,USA,3,7,1613,13665,15278,1
Hardware + Software,5302500.0,USA,2,4,1302,13454,14756,0
Biotechnology,2300000.0,USA,1,1,0,16489,16489,0
Collaboration|Productivity Software|Project Management|Social Business,4800000.0,USA,2,2,351,15733,16084,0
Security|Software,4000000.0,ISR,1,3,0,13446,13446,1
Security,750000.0,HUN,2,2,671,14335,15006,0
Business Services|Consulting|Information Technology,8500000.0,USA,1,3,0,13614,13614,0
Business Services|Customer Service|Risk Management,37500000.0,USA,1,1,0,12545,12545,0
Health Care,2202375.0,USA,4,2,1491,14600,16091,0
Business Services|Mobile|Software|Telecommunications|Training|Web Hosting,100000.0,UGA,1,1,0,14245,14245,0
Technology,17000000.0,USA,2,2,3260,12811,16071,0
Software,708000.0,GBR,1,1,0,13482,13482,0
Enterprise Software,10300000.0,USA,2,4,917,12156,13073,1
Clean Technology,3230000.0,GBR,1,2,0,14620,14620,0
Software,3000000.0,CAN,1,1,0,15294,15294,0
Intelligent Systems|Surveys|Video,5530000.0,USA,1,4,0,12318,12318,0
Hardware + Software|Internet of Things,2120000.0,USA,4,5,720,15568,16288,0
Colleges|CRM|Enterprise Software|Event Management|Marketing Automation|Networking|SaaS,23950000.0,USA,5,10,1977,12828,14805,1
Software,200000.0,IND,1,3,0,16110,16110,0
Semiconductors,66000000.0,USA,3,29,970,12513,13483,1
Software,60000.0,UGA,1,3,0,16567,16567,0
Manufacturing,40700000.0,USA,4,10,1940,13472,15412,0
Health Care|Neuroscience,1200000.0,ISR,2,3,478,16104,16582,0
Semiconductors,20644950.0,GBR,2,6,969,11922,12891,0
Blogging Platforms|Curated Web|Finance|FinTech|Opinions|Reputation,515000.0,USA,2,3,61,13726,13787,1
Curated Web|Fitness|Health and Wellness|Psychology,250000.0,USA,1,1,0,13910,13910,0
Analytics|Interest Graph|Personalization|Software,13197215.0,GBR,2,4,335,16191,16526,0
Advertising|Big Data|E-Commerce,50985000.0,USA,4,4,2562,13710,16272,0
Biotechnology,25000.0,USA,1,1,0,16083,16083,0
Geospatial|Maps|Software,70202607.0,USA,5,7,1672,14202,15874,1
Entertainment|Games,220000.0,PAK,1,1,0,16581,16581,0
Computer Vision|Manufacturing|Software,1510072.0,FRA,1,2,0,10957,10957,1
Enterprise Software|Speech Recognition,71950000.0,USA,4,8,1825,14712,16537,0
Software,13621199.0,USA,5,2,930,14225,15155,1
Hardware + Software,29300000.0,USA,3,9,887,13588,14475,0
Finance,2880000.0,GBR,1,1,0,15019,15019,0
Messaging|Software,1000000.0,URY,1,1,0,13525,13525,1
Game|Social Games|Software,583340.0,ITA,3,3,1102,15095,16197,0
Cloud Computing|Enterprise Software,15500000.0,USA,2,8,645,13165,13810,1
Software,12560000.0,USA,2,5,524,13151,13675,1
Analytics|Business Analytics,28199999.0,USA,2,11,106,16350,16456,0
Hardware + Software,17200000.0,CAN,4,13,1154,15408,16562,0
Finance|FinTech,40000000.0,USA,1,1,0,13713,13713,0
News,12000000.0,ISR,2,3,225,13494,13719,0
Mobile|Social Network Media|Wireless,17500000.0,USA,2,5,636,13004,13640,1
Biotechnology,72000000.0,AUT,2,6,928,11323,12251,1
Biotechnology|Health Care,418400000.0,USA,4,2,2437,14089,16526,1
Web Hosting,5000000.0,FRA,1,3,0,16359,16359,0
Software,65750000.0,USA,5,27,1309,15364,16673,0
Biotechnology,22811685.0,GBR,2,6,731,12265,12996,0
Biotechnology,32000000.0,CAN,5,4,2226,14222,16448,0
Mobile|Web Development,317000.0,USA,2,5,260,16191,16451,0
Software,10000000.0,USA,1,1,0,13644,13644,0
E-Commerce,2700000.0,USA,1,1,0,16382,16382,0
All Students|Collaboration|Colleges|EdTech|Education|Employment|Human Resources|SaaS|Universities,926349.0,USA,2,6,1687,14160,15847,0
Curated Web,108000.0,ESP,1,1,0,13647,13647,0
Design|E-Commerce|Furniture|Home & Garden,4160000.0,USA,2,6,465,15825,16290,0
Biotechnology,65184732.0,USA,4,12,1249,13525,14774,0
Health Care,23000000.0,USA,2,5,778,13654,14432,1
Computers|Networking|Web Hosting,20000000.0,USA,1,2,0,10938,10938,0
Health and Wellness,25000000.0,USA,4,5,904,15523,16427,1
Software,17500000.0,USA,1,2,0,10987,10987,1
Network Security,10350000.0,USA,2,9,831,11971,12802,0
Entertainment|Games|Media|Product Development Services|Video,18250000.0,USA,3,8,995,15006,16001,0
Clean Technology,9866928.0,DEU,1,1,0,14257,14257,0
P2P Money Transfer|Services,2500000.0,USA,1,1,0,12573,12573,0
Semiconductors,62619999.0,USA,3,7,1632,13411,15043,1
Career Management|Human Resources|Recruiting|Software,280200.0,GBR,1,1,0,16411,16411,0
Charter Schools|Networking,2000000.0,USA,1,1,0,14245,14245,0
Education,40000.0,COL,1,1,0,15308,15308,0
Clean Technology,60000000.0,USA,2,3,516,14219,14735,0
Games,172153.0,CAN,2,1,0,15675,15675,0
Nanotechnology,8500000.0,USA,1,1,0,16598,16598,0
Non Profit|Pharmaceuticals,60000000.0,USA,1,1,0,12143,12143,0
Entertainment|Internet|Mobile|Sports,5380000.0,ESP,1,2,0,14336,14336,0
Enterprise Software,3200000.0,USA,2,1,87,13583,13670,0
Fraud Detection|Identity|Security|Spam Filtering,8000000.0,USA,1,1,0,16014,16014,0
E-Commerce,88615600.0,CZE,2,3,15,14018,14033,0
Advertising|Internet Marketing|Small and Medium Businesses,100000.0,AUS,1,1,0,14245,14245,0
Finance|FinTech,7228704.0,USA,5,2,1210,14734,15944,0
Software,104434998.0,USA,3,5,1338,14032,15370,1
Web Hosting,58000000.0,USA,2,4,291,13287,13578,0
E-Commerce,39945000.0,DEU,1,1,0,15433,15433,0
Software,213000.0,BEL,1,1,0,13122,13122,0
All Students|Career Management|Colleges|Curated Web|Education|Employment|Social Media,9633503.0,USA,7,12,1505,14902,16407,0
Bio-Pharm,4000000.0,CAN,1,3,0,11600,11600,0
Entertainment|Games,980000.0,USA,1,1,0,14685,14685,1
Health Care,20900000.0,USA,4,3,1616,14789,16405,0
Internet|Software|Technology,25600000.0,USA,2,10,378,11442,11820,1
Technology,3000000.0,USA,1,2,0,11620,11620,0
Software,3890000.0,DNK,1,1,0,13532,13532,0
Analytics|Big Data|Software,20000000.0,FRA,1,1,0,16379,16379,0
Health Care,79328131.0,USA,3,10,852,14910,15762,1
Health and Wellness|Health Care|Medical|Medical Devices,5000000.0,USA,1,2,0,13481,13481,0
Big Data|Machine Learning|Predictive Analytics,10000000.0,CAN,1,2,0,16512,16512,0
Hardware + Software,1000000.0,RUS,1,2,0,15999,15999,0
Digital Media|Marketplaces|Services,21300000.0,USA,2,4,655,11596,12251,1
Curated Web,149799.0,ITA,1,2,0,16044,16044,0
Biotechnology,14130942.0,USA,4,1,1077,15379,16456,0
Software,10000000.0,USA,1,1,0,12822,12822,0
Health Care,10700000.0,USA,3,3,1609,14651,16260,0
Biotechnology,28749109.0,USA,3,4,2093,13664,15757,0
Curated Web,250000.0,CAN,1,2,0,15743,15743,0
Employment|Human Resources|Services,2000000.0,USA,1,7,0,16707,16707,0
Human Resources|Internet|Recruiting|SaaS,750000.0,USA,1,1,0,16478,16478,0
Curated Web,200000.0,USA,1,3,0,15107,15107,0
Career Management|Human Resources|Recruiting,182335.0,ARG,2,2,273,15949,16222,0
Software,7981405.0,USA,2,2,1767,13263,15030,0
Software,9000000.0,USA,1,3,0,13368,13368,0
Web Hosting,6356500.0,FRA,1,3,0,13419,13419,1
Enterprise Software,29600000.0,USA,2,5,553,15722,16275,0
Software,970773.0,GBR,2,1,365,15737,16102,0
Manufacturing,4775000.0,USA,2,2,415,14915,15330,0
Design|Developer Tools|Technology,14000000.0,USA,1,4,0,11666,11666,0
Software,8850000.0,USA,2,1,632,14896,15528,0
Finance Technology|SaaS|Small and Medium Businesses,25000.0,ARG,1,1,0,15218,15218,0
Fashion,2000000.0,USA,1,2,0,15968,15968,0
Software,1220000.0,FRA,1,1,0,13066,13066,0
Finance,1359215.0,BRA,7,10,608,15918,16526,0
Software,20000.0,AUS,1,1,0,16357,16357,0
Medical Devices,10100000.0,USA,4,7,2574,12128,14702,0
Health Care,24100000.0,USA,3,5,2345,13027,15372,0
Biotechnology,75289893.0,USA,2,2,107,15842,15949,0
Software,13199258.0,USA,4,2,904,15841,16745,0
Biotechnology|Health and Wellness,37400000.0,USA,2,13,778,13473,14251,1
Services,12000000.0,USA,1,2,0,12859,12859,0
Software,1230000.0,GBR,1,2,0,13277,13277,0
Application Platforms|Internet|Networking,15000.0,USA,1,1,0,14726,14726,0
Internet|Security|Storage|Video,61693854.0,USA,13,31,4830,10702,15532,0
Biotechnology,143922827.0,USA,6,11,3330,12613,15943,0
Enterprise Software|Services|Software,11500000.0,USA,1,4,0,10903,10903,1
Training,4250000.0,USA,2,5,3926,12465,16391,0
Biotechnology,344000000.0,USA,7,8,3543,12920,16463,1
Security,6623861.0,NLD,1,2,0,15434,15434,0
Medical Devices,4450000.0,USA,1,1,0,16280,16280,0
Health Care,67856490.0,USA,4,3,2558,13773,16331,0
Manufacturing,4550000.0,USA,2,1,394,15971,16365,0
Semiconductors,35500000.0,USA,2,5,746,13906,14652,1
Curated Web|Employment|Networking|Social Media|Startups,75000.0,USA,1,2,0,15126,15126,0
SaaS|Sales and Marketing|Software,10600000.0,USA,5,11,1285,15340,16625,0
Advertising Networks|CRM|Professional Networking|Social Media|Social Network Media,250000.0,USA,1,1,0,15918,15918,0
Social Media,2781000.0,USA,2,1,772,13634,14406,0
Enterprise Software|Flash Storage|Storage,20900000.0,USA,3,3,1856,13796,15652,1
Oil & Gas,822000.0,RUS,1,1,0,15392,15392,0
Software,18100000.0,USA,3,8,923,12528,13451,0
Architecture|Network Security|Real Time,36140000.0,USA,2,7,40,11931,11971,1
Cyber Security|Information Technology|Services,1800000.0,ISR,1,1,0,16719,16719,0
Enterprise Software,39500000.0,USA,2,2,1976,14641,16617,0
Education|iPad,3250000.0,USA,1,1,0,16105,16105,0
Mobile,8500000.0,ISR,2,2,310,14695,15005,1
Software,1619221.0,FRA,1,2,0,15248,15248,0
Medical Devices,475000.0,SGP,1,1,0,15765,15765,0
Health Care|Medical Devices,124402778.0,USA,10,22,2012,14614,16626,0
Web Hosting,50250000.0,IRL,2,10,785,13734,14519,0
Fashion|Internet|Marketplaces,3850000.0,USA,2,8,514,16031,16545,0
Software,3600000.0,GBR,1,1,0,12551,12551,0
Games|Television,18560000.0,GBR,2,3,852,13149,14001,1
Education,4897824.0,IND,1,1,0,16373,16373,0
Advertising|Search|Technology,4200000.0,USA,1,5,0,14628,14628,0
Curated Web|Events|Internet|Media|Search,712133.0,SWE,1,3,0,15340,15340,0
Curated Web,46750000.0,USA,2,6,1637,14587,16224,0
Semiconductors,6000000.0,USA,1,2,0,13167,13167,1
Biotechnology,3100000.0,USA,1,1,0,14890,14890,0
Manufacturing,28000000.0,USA,1,4,0,16149,16149,0
Clean Technology,534400000.0,USA,5,2,2085,14265,16350,0
Curated Web|Personalization,483333.0,USA,1,1,0,15015,15015,0
Software,5500000.0,GBR,3,4,505,15908,16413,0
E-Commerce|Mobile|QR Codes|Software,1100000.0,USA,4,1,579,15033,15612,0
Semiconductors,38000000.0,USA,3,7,1579,12418,13997,1
E-Commerce|Marketplaces,10000000.0,USA,3,8,2078,14636,16714,0
Android|Customer Service|iPhone|Mobile|Software|Windows Phone 7,40000.0,RUS,1,1,0,15939,15939,0
Finance|FinTech,25250000.0,USA,4,1,492,15853,16345,1
Automated Kiosk|Customer Service|Digital Signage|Information Technology|Retail|Video Chat,801156.0,ITA,1,2,0,16535,16535,0
Design|Services|Systems,1715011.0,DNK,2,3,540,15855,16395,0
Credit|Financial Services|Information Technology|Mobile|Mobile Commerce|Social Entrepreneurship|Telecommunications,11200000.0,USA,3,10,735,15946,16681,0
Software,15264925.0,USA,2,5,49,16631,16680,0
Clean Technology,7000000.0,USA,2,1,1717,13745,15462,0
Collaboration|Crowdfunding|Design|E-Commerce|Startups,73336.0,ESP,1,1,0,15857,15857,0
Health Care|Health Diagnostics,163400000.0,USA,2,1,98,14530,14628,1
E-Commerce|Fashion,1600000.0,SGP,1,3,0,15754,15754,0
Finance|FinTech,16504889.0,USA,2,2,574,14223,14797,0
Cloud Management|Software,54060000.0,USA,3,5,1866,14850,16716,0
Crowdfunding|Curated Web|Nonprofits|Startups,1755000.0,USA,3,22,336,15309,15645,0
Collaboration|Financial Services|Investment Management,334654.0,SGP,2,1,510,16085,16595,0
Brokers|Commodities|Finance|Financial Services|FinTech|Stock Exchanges,10000000.0,HKG,1,2,0,15408,15408,0
Crowdfunding|Finance|Small and Medium Businesses,19724.0,EST,1,1,0,16312,16312,0
Finance|FinTech,340000.0,SGP,3,3,700,14975,15675,0
Broadcasting,15000000.0,USA,1,6,0,11120,11120,0
Entrepreneur|Investment Management|Startups,52723.0,IRL,1,1,0,16310,16310,0
Crowdfunding,86676.0,DEU,2,2,0,15431,15431,0
Android|Apps|Messaging|Mobile,5100000.0,USA,4,12,979,15658,16637,0
E-Commerce,9649500.0,CZE,2,2,2088,13879,15967,0
Public Relations,200000.0,USA,1,1,0,13004,13004,0
Advertising|Internet Marketing|SEO|Web Design,301000.0,USA,1,1,0,13879,13879,0
Biotechnology,1880000.0,IND,1,2,0,15853,15853,0
Software,132250000.0,USA,6,28,2536,12542,15078,0
Curated Web|E-Commerce|Fashion|Music,25000.0,USA,1,1,0,15857,15857,0
Hardware + Software|Video,1786426.0,USA,2,4,530,14945,15475,0
Software,45500000.0,USA,4,8,1853,14315,16168,0
E-Commerce|Flash Sales|Wine And Spirits,3150000.0,USA,3,12,694,15187,15881,0
Biotechnology,15000000.0,USA,1,4,0,14523,14523,1
Semiconductors,98000000.0,USA,5,25,1401,15019,16420,0
Internet|Retail|Wine And Spirits,600000.0,RUS,2,1,315,15737,16052,0
Analytics|Big Data|CRM|Machine Learning|Marketing Automation|Mobile|Mobile Software Tools,1200000.0,USA,2,4,230,16344,16574,0
Enterprise Software,1500000.0,USA,1,2,0,13348,13348,0
Software,44616400.0,USA,4,4,1101,13942,15043,0
Design|Interface Design|New Product Development|Product Design|Project Management|Rapidly Expanding|Software|User Experience Design|Web Development|Web Tools,80200000.0,USA,5,14,1238,15392,16630,0
Web Hosting,5000000.0,USA,1,2,0,13179,13179,1
Health Care|Medical|Medical Devices,3812244.0,USA,3,9,301,15924,16225,0
Consulting,7500000.0,USA,2,6,518,12293,12811,0
Biotechnology,195502111.0,USA,5,20,1489,14867,16356,1
Curated Web|Hospitality|Travel & Tourism,5193000.0,USA,5,3,1582,14669,16251,0
Advertising,5000000.0,USA,3,10,731,13848,14579,1
Software,4900000.0,USA,4,3,1598,14351,15949,0
Biotechnology,13000000.0,USA,1,1,0,14946,14946,0
Health and Wellness,13098401.0,USA,2,1,1214,13149,14363,1
Information Technology,4000000.0,CAN,1,1,0,16735,16735,0
Advertising|Enterprise Software|Internet Marketing|Marketing Automation|Telecommunications,30750000.0,USA,4,13,1686,14397,16083,0
E-Commerce|Public Relations|Video,10449354.0,USA,2,4,316,14118,14434,0
Mobile|Software|Technology,50000000.0,USA,3,6,581,16161,16742,0
Curated Web,18500000.0,USA,4,6,2936,12156,15092,0
Web Hosting,59445249.0,USA,3,2,1292,14959,16251,0
B2B|Business Services|Consulting|Design|Enterprises|Sales and Marketing|Software|Startups,10000.0,USA,1,2,0,12570,12570,0
Facebook Applications|Social Media Marketing|Social Network Media|Software,12645126.0,USA,6,6,1444,13452,14896,0
Games,206325.0,ESP,2,2,273,15584,15857,0
Business Services|Cloud Computing|Software|Startups,450000.0,GBR,3,4,559,16038,16597,0
Health Care,96200000.0,USA,5,19,1688,14791,16479,1
Business Development|Optimization|Productivity Software,50000.0,USA,1,1,0,15271,15271,0
Identity Management|Security,780000.0,USA,1,1,0,15810,15810,0
Software,22000000.0,USA,1,4,0,11962,11962,0
Video Conferencing|Video Streaming|Virtual Workforces,10313287.0,USA,2,1,1113,14509,15622,0
Games,1298000.0,SGP,2,5,355,16044,16399,0
Lifestyle|Restaurants|Travel,120000.0,USA,1,2,0,16405,16405,0
Technology,190671.0,GBR,1,1,0,16283,16283,0
Software,7750000.0,USA,1,2,0,15083,15083,1
E-Commerce,3394145.0,GBR,1,1,0,16239,16239,0
Biotechnology,35000000.0,USA,1,1,0,14803,14803,1
Analytics|Data Visualization|Pharmaceuticals,2500000.0,USA,2,10,58,16071,16129,0
Biotechnology,54000000.0,USA,1,3,0,12055,12055,1
Semiconductors,4490000.0,FRA,1,2,0,14246,14246,0
3D Printing|Printing|Technology,10000000.0,GBR,1,2,0,16252,16252,0
Biotechnology,200249935.0,USA,2,1,1597,12761,14358,0
Biotechnology,59864364.0,USA,2,1,133,14540,14673,1
Finance|Software|Technology|Trading,42261684.0,GBR,1,1,0,12580,12580,0
Data Security|Security,77440001.0,USA,5,37,1218,15484,16702,0
Renewable Energies,2833289.0,NLD,1,1,0,16692,16692,0
Energy|Sensors|Technology,3123210.0,GBR,1,2,0,16633,16633,0
Health Care|Medical|Pharmaceuticals,15900000.0,GBR,1,2,0,12251,12251,1
Software|VoIP,30000.0,USA,1,1,0,14176,14176,0
Mobile,150000.0,ISR,1,1,0,15779,15779,0
Nanotechnology,1379972.80641823,GBR,1,1,0,13733,13733,0
Games,12035610.0,DEU,2,2,36,13879,13915,0
Medical Devices,7200000.0,ISR,1,1,0,16765,16765,0
Health and Wellness,48250000.0,USA,3,10,1190,15271,16461,0
Consulting,1610000.0,FRA,1,3,0,14781,14781,0
Computers|Data Security|Hardware,2500000.0,USA,1,1,0,16119,16119,0
Clean Technology,15996199.0,USA,3,10,1226,14190,15416,0
Technology,28000.0,EST,1,1,0,15737,15737,0
Innovation Engineering|Manufacturing|Semiconductors,813000.0,CHN,1,1,0,15743,15743,0
Hardware + Software|Internet of Things|Tracking|Wireless,3095000.0,USA,3,14,652,15928,16580,0
Curated Web,2649001.0,CAN,2,1,2036,13818,15854,0
Fraud Detection|Identity Management|Security,16000000.0,USA,2,4,454,13965,14419,0
Analytics,584440.0,GBR,2,7,1385,14245,15630,0
Clean Technology,69000000.0,USA,4,11,1130,15037,16167,0
Software,39683329.0,GBR,5,16,2364,13220,15584,0
Cloud Computing|Developer APIs|Software|Web Hosting,44028672.0,USA,4,8,1599,13970,15569,0
Internet|Service Providers|Telecommunications,20000000.0,USA,1,3,0,11796,11796,0
Software,1500000.0,USA,1,2,0,13236,13236,0
Enterprise Software,7000000.0,USA,2,2,2390,11719,14109,0
E-Commerce|Finance|Small and Medium Businesses,8000000.0,USA,2,2,744,15034,15778,0
Mobile|Mobile Payments,9278374.0,DEU,3,1,943,14975,15918,0
Home Automation,2850000.0,USA,1,2,0,15720,15720,0
Enterprise Software,4982000.0,CAN,4,4,1909,14105,16014,0
Hospitality|Mobile,1000000.0,TWN,1,1,0,15095,15095,0
Mobile,3330000.0,FRA,1,2,0,13598,13598,0
Analytics,3650000.0,USA,2,2,2199,14215,16414,0
Enterprise Software,10000000.0,USA,2,2,412,13132,13544,1
Semiconductors,6000000.0,USA,1,2,0,12919,12919,0
Health Care,35400000.0,USA,2,3,1270,14666,15936,0
Entertainment|Film|Film Distribution|Film Production,500000.0,IND,1,1,0,16205,16205,0
Digital Rights Management|Monetization|Software|Television,5180000.0,DEU,1,1,0,13543,13543,0
Hardware + Software,2500000.0,CAN,1,1,0,14790,14790,1
Biotechnology,74170000.0,USA,4,14,1519,14433,15952,1
Mobile Commerce|Mobile Payments|Wireless,8000000.0,USA,1,6,0,12009,12009,0
Advertising,98000000.0,CHN,3,4,1699,15074,16773,0
Security,15400000.0,USA,1,1,0,13313,13313,1
Cloud Data Services|Collaboration|Messaging|Security|Virtualization,1500000.0,USA,1,2,0,12962,12962,0
Mobile,1350700.0,FRA,1,1,0,14327,14327,0
Design|Manufacturing|Telecommunications,11000000.0,USA,1,4,0,11607,11607,0
Security,44000000.0,IND,2,9,89,13060,13149,0
E-Commerce,881803.0,DNK,1,1,0,16316,16316,0
E-Commerce,24300000.0,USA,3,4,1324,13465,14789,0
Software,2460000.0,FRA,1,3,0,12936,12936,0
Internet,550000.0,MYS,1,4,0,16576,16576,0
E-Commerce,30800000.0,USA,3,7,702,10175,10877,0
Education,15000000.0,IND,2,5,1059,15034,16093,0
Curated Web,2473474.0,GBR,1,2,0,14503,14503,0
Biotechnology,12700000.0,FIN,2,5,297,12876,13173,0
Artificial Intelligence|Legal|Machine Learning,54250.0,HKG,2,1,299,15953,16252,0
Enterprises|Networking|Technology,6000000.0,USA,1,2,0,12159,12159,0
Internet|Services|Video,6540000.0,USA,1,2,0,13825,13825,0
Mobile,1651520.0,FIN,1,3,0,14844,14844,1
Analytics|Test and Measurement,2370000.0,GBR,2,2,245,15888,16133,0
Broadcasting,2755266.2321918,GBR,1,1,0,16737,16737,0
Mobile,31580000.0,GBR,3,3,1941,13166,15107,1
Finance|Financial Services|Intellectual Property|Technology,10000000.0,USA,1,2,0,15321,15321,0
Augmented Reality|Image Recognition|Photography,3800000.0,USA,1,2,0,15516,15516,1
Enterprise Software|Search|Video,9000000.0,USA,2,2,1439,15260,16699,0
Services|Software|Taxis|Wireless,500000.0,USA,1,1,0,16222,16222,0
Nonprofits,7700000.0,RUS,4,10,601,15461,16062,0
Health Care|Payments|SaaS,450000.0,USA,2,2,125,16005,16130,0
Photography,350000000.0,CHN,2,3,1724,14669,16393,0
Analytics|Big Data|Real Time,2000000.0,IND,1,1,0,16637,16637,0
Software,75000000.0,USA,2,2,305,16346,16651,0
Software,8700000.0,USA,1,5,0,12696,12696,0
Software,3000000.0,USA,2,2,205,12346,12551,0
Mobile,5720000.0,FIN,2,3,316,13173,13489,0
Early-Stage Technology|Finance|Finance Technology|Financial Services|FinTech|Personal Finance|Technology,1500000.0,USA,2,1,1261,15145,16406,0
Hotels|Software,100000.0,USA,1,1,0,15323,15323,0
News,278767.0,SWE,1,2,0,14865,14865,0
3D|Design|Software|Technology,1913654.0,CHE,2,3,454,15737,16191,0
Hardware + Software,13424242.1996313,NLD,2,4,643,13137,13780,0
Mobile|Mobile Emergency&Health|SEO,150000.0,SWE,1,4,0,15784,15784,0
Biotechnology,133171781.0,USA,11,23,2959,13552,16511,0
Advertising,3163478.0,JPN,2,3,611,15188,15799,0
Software,5000000.0,USA,1,2,0,12884,12884,0
Advertising|Web Tools,713140.0,ESP,2,3,442,14039,14481,0
Mobile,5500000.0,USA,2,11,480,16002,16482,0
Delivery|Optimization|Public Relations,1000000.0,USA,1,2,0,16575,16575,0
Manufacturing,2000000.0,FRA,1,2,0,14358,14358,0
Advertising|Analytics|Content|Curated Web|Monetization|Optimization|Publishing|Reviews and Recommendations|Service Providers|Software|Video,7000000.0,USA,2,6,621,15982,16603,0
Product Design|Software|User Experience Design|Visualization,35800000.0,USA,2,5,1137,12802,13939,0
Enterprise Software|Health Care Information Technology|Hospitality|Internet|Retail Technology,375976.0,NLD,4,11,246,16248,16494,0
3D|Architecture|Construction|Design|Engineering Firms,3715000.0,USA,2,7,86,16623,16709,0
Discounts|Entertainment|Games|Gps|iPhone|iPod Touch|Location Based Services|MMO Games|Mobile|Mobile Games|Online Reservations|Social Games|Virtual Goods,25000.0,AUS,1,1,0,14958,14958,0
Electronics,2204719.20145071,FRA,1,3,0,16741,16741,0
Biotechnology,700000.0,USA,1,1,0,15817,15817,0
Curated Web,1250632.0,USA,4,2,1412,15218,16630,0
Emerging Markets|Mobile|Mobile Payments,819010.0,FIN,3,6,271,16114,16385,0
Entertainment|Video Streaming,16000000.0,NGA,2,3,615,15441,16056,0
Biotechnology,75000000.0,USA,1,1,0,16030,16030,0
Games|Internet|MMO Games,1060955.0,ESP,2,2,316,15396,15712,0
Entertainment|Internet|Online Gaming,911000.0,USA,3,5,797,15492,16289,0
Cloud Computing|Enterprise Software|Infrastructure,13500000.0,USA,3,18,1379,15315,16694,0
Security,3280000.0,ESP,2,2,713,13468,14181,0
Network Security,32500000.0,USA,1,2,0,16733,16733,0
E-Commerce,140041914.0,USA,7,2,6103,10592,16695,0
Security,61500000.0,USA,2,8,853,11863,12716,1
Messaging|Mobile,1200000.0,SWE,1,1,0,15238,15238,0
Software,105000000.0,ISR,2,2,198,16293,16491,0
Health Care,459000000.0,USA,8,8,5123,10592,15715,1
Software,4304503.0,USA,4,9,1116,15306,16422,0
Biotechnology,5700000.0,GBR,1,1,0,14889,14889,0
Software,9100000.0,USA,1,3,0,12366,12366,0
Hardware + Software,9200000.0,USA,1,4,0,15869,15869,0
Mobile|Retail|Sales Automation,150000.0,ISR,1,1,0,15653,15653,0
Biotechnology,95217403.0,DEU,7,15,3646,12538,16184,0
Mobile,1750000.0,USA,2,1,307,14579,14886,0
Education,2000000.0,USA,1,1,0,15672,15672,0
Biotechnology,36682695.0,USA,5,14,997,14369,15366,0
Biotechnology,22000000.0,USA,2,9,745,12128,12873,0
Electronic Health Records|Human Resources|Recruiting|Software,9533642.38410596,CAN,2,5,413,13598,14011,0
Health Care,10443323.0,USA,9,8,1310,15049,16359,0
Software,6000000.0,USA,1,4,0,12907,12907,1
Mobile,117059.0,IRL,1,1,0,15493,15493,0
Biotechnology,1500000.0,USA,1,1,0,14991,14991,0
Financial Services|FinTech|Media|Social Media|Startups,5130000.0,USA,2,2,294,16051,16345,0
Consulting,55000000.0,USA,2,4,1520,13676,15196,0
Digital Signage|Sports,25000.0,USA,1,1,0,15340,15340,0
Business Services,43500000.0,USA,2,13,451,10935,11386,0
Hardware + Software|Internet of Things,2200000.0,USA,4,3,885,15409,16294,0
Security,46298276.0,USA,3,1,488,15952,16440,0
Finance Technology|Internet,11233343.179271901,AUS,3,3,992,15746,16738,1
Web Hosting,43400000.0,USA,4,10,1927,11426,13353,1
E-Commerce,400000.0,USA,1,4,0,13665,13665,1
Biotechnology,212250000.0,USA,2,1,674,15579,16253,1
Hardware + Software,2710000.0,DEU,2,2,1091,13208,14299,0
Consumer Electronics|Digital Media|Internet of Things,2000000.0,FRA,1,4,0,16439,16439,0
Mobile,32200000.0,USA,3,12,709,13481,14190,1
Craft Beer,725000.0,USA,2,1,362,15766,16128,0
Analytics|SaaS|Social Media|Social Media Monitoring,20500000.0,USA,4,8,1141,13577,14718,1
Clean Technology,6970156.0,GBR,1,1,0,16167,16167,0
Social Media|Social Media Marketing,1400000.0,USA,2,3,518,15692,16210,0
Manufacturing,4311170.0,FRA,1,1,0,15082,15082,0
Advertising|All Markets|Developer APIs|PaaS|Sales and Marketing,15104119.0,USA,4,29,1628,14483,16111,1
Home Automation,300000.0,FIN,2,2,1157,14648,15805,0
Design|Software,357000.0,ESP,1,3,0,13195,13195,0
Technology,46500000.0,CHN,4,11,2192,12418,14610,1
Enterprise Software,31600000.0,USA,3,1,561,14880,15441,0
Biotechnology,212000.0,USA,3,3,1492,13330,14822,0
Biotechnology,4000000.0,USA,4,5,358,16226,16584,0
Heavy Industry,8000000.0,USA,1,2,0,12025,12025,0
Consumer Electronics,8702589.0,FRA,1,2,0,16266,16266,0
Hardware + Software,8131857.0,GBR,3,4,979,15440,16419,0
Dietary Supplements|Health and Wellness|Nutrition,2200000.0,USA,2,1,277,16364,16641,0
Technology,400000.0,USA,1,1,0,12283,12283,0
Advertising|Analytics|Brand Marketing|Real Time|Television,27800000.0,USA,3,11,1042,15532,16574,0
Advertising|Media|Software|Tablets,50000.0,THA,1,1,0,14975,14975,0
Apps|Curated Web|News|Publishing|SaaS,20250000.0,USA,2,3,2720,13545,16265,0
Computers|Software,10000000.0,USA,1,2,0,11975,11975,1
Education,1506705.0,IND,3,4,943,15805,16748,0
Health Care,5146400.0,BEL,1,3,0,16030,16030,0
Biotechnology,29947298.0,USA,6,4,2713,13728,16441,0
Curated Web,2300000.0,USA,1,1,0,14180,14180,1
Apps|Kids|Media|Publishing|Software|Textbooks,2000000.0,USA,1,2,0,15196,15196,0
Facebook Applications|Games|iPhone,2396740.0,JPN,1,1,0,14883,14883,1
Games|Video Streaming,15000000.0,USA,3,8,805,15117,15922,1
Business Analytics|Consulting|Product Design,30442772.0,USA,4,10,3128,11640,14768,1
Career Management|Education|Skill Assessment,800000.0,SGP,1,1,0,15887,15887,0
Market Research|Software,995928.0,NLD,2,2,365,14245,14610,0
Software,3200000.0,USA,1,1,0,14858,14858,0
Travel,100000000.0,USA,1,5,0,13171,13171,1
Software,5533127.0,DEU,1,3,0,12697,12697,0
Curated Web|Intellectual Asset Management,1340000.0,USA,2,5,1786,13388,15174,0
E-Commerce|Fashion|Made in Italy|Marketplaces,1100000.0,USA,3,1,216,16252,16468,0
Mobile,250000.0,USA,1,1,0,15999,15999,0
Medical Devices,28400000.0,ISR,1,1,0,16674,16674,0
Software,3000000.0,JPN,1,3,0,16034,16034,0
Information Technology|SaaS|Services,2500000.0,USA,1,4,0,11376,11376,0
Bitcoin|Finance|FinTech,28250000.0,USA,2,12,543,16020,16563,0
Financial Services,54000000.0,USA,1,4,0,12446,12446,0
Hardware + Software,2085935.0,USA,7,6,1321,14092,15413,0
E-Commerce,3250000.0,USA,4,10,1126,15279,16405,0
Software,4000000.0,USA,1,3,0,12116,12116,0
Email Marketing|Enterprise Software|Marketing Automation|Mobile Software Tools,1200000.0,USA,2,10,649,15826,16475,0
Enterprise Software,1200000.0,USA,1,1,0,13818,13818,0
Consumer Goods|E-Commerce|Energy|Government Innovation|Manufacturing|Media|Retail|Transportation,950000.0,USA,2,1,160,16102,16262,0
Energy,66000000.0,GBR,1,1,0,16717,16717,0
Social Media|Sports,16221.0,GBR,1,1,0,14610,14610,0
Health and Wellness,450000.0,USA,1,1,0,16644,16644,0
EdTech|Education|Medical Professionals,200000.0,USA,2,1,39,11386,11425,0
Business Information Systems|Clean Energy|CRM|Energy|Energy IT|Enterprise Software|Smart Grid|Software|Utilities,20936100.0,BEL,2,4,542,16020,16562,0
Software,10964643.0,USA,3,3,2905,10836,13741,1
China Internet|Crowdfunding|Databases|Enterprise Software|Investment Management,2000000.0,CHN,2,1,298,16077,16375,0
Manufacturing,15152514.0,GBR,2,1,3592,12509,16101,1
Software,19000000.0,USA,3,14,1382,12363,13745,1
Software,387973.0,RUS,2,2,0,15810,15810,0
Software,892990.0,FRA,1,1,0,14184,14184,0
Clean Technology,1700000.0,USA,1,1,0,15559,15559,0
Networking|Opinions|Reviews and Recommendations|Social Network Media|Web Hosting,205000.0,USA,1,1,0,13920,13920,0
Information Technology|Technology,20000000.0,USA,2,3,230,16045,16275,0
Web Hosting,17840000.0,USA,2,5,2165,12543,14708,1
Android|Apps|iPhone|Mobile|Technology,235000.0,USA,2,2,1155,14245,15400,0
Travel,1000000.0,IND,1,1,0,16482,16482,0
Public Transportation,5750000.0,USA,1,2,0,16147,16147,0
Application Platforms|Education|SaaS,6950000.0,NOR,2,3,1008,14757,15765,0
Mobile,40830000.0,EGY,1,1,0,13358,13358,0
Software,375000.0,USA,1,1,0,15391,15391,0
Enterprise Software,20000.0,USA,1,1,0,15918,15918,0
iOS|Online Dating|Photo Sharing|Social Media,80000.0,USA,1,3,0,16105,16105,0
Ediscovery|Entertainment|Games|Hospitality|Identity|Mobile|Music|Music Venues|Nightlife|Real Time|Social Media|Social Network Media,100000.0,USA,1,1,0,14975,14975,0
Analytics|Brand Marketing|Celebrity|Curated Web|Mobile|QR Codes|Social Media|Sports,75000.0,USA,1,2,0,15804,15804,0
Mobile,40057776.0,USA,8,5,1899,14417,16316,0
Electrical Distribution|Semiconductors|Solar,2581800.0,ITA,1,1,0,15669,15669,0
Enterprise Software,6500000.0,IND,1,1,0,12760,12760,0
Finance|Hardware + Software|Meeting Software|Security,1298773.0,SGP,2,4,84,14728,14812,1
Social Media|Social Network Media,25000.0,USA,1,1,0,14033,14033,0
Consulting|Employment|Search,4000000.0,USA,1,2,0,13571,13571,0
Gift Card,25000000.0,IND,2,2,2517,13798,16315,0
Internet|Legal|Privacy|Software,100000.0,ITA,1,5,0,15138,15138,0
Social Media,2841648.0,KOR,2,3,516,14610,15126,0
Information Technology,21000000.0,USA,1,1,0,11332,11332,1
Biotechnology,1187674.0,USA,2,2,714,15512,16226,0
Software,4444200.0,USA,1,1,0,15099,15099,0
Analytics,18600000.0,USA,2,1,648,15215,15863,1
Health and Wellness,88264989.0,USA,5,19,1211,15125,16336,0
Biotechnology,1300000.0,USA,1,2,0,16703,16703,0
Mobile,860000.0,RUS,3,4,161,15684,15845,0
Medical Devices,42000000.0,USA,1,5,0,16679,16679,0
Security|Service Providers,21000000.0,USA,1,1,0,13886,13886,0
Education|Internet,7302839.0,DEU,5,11,2113,14610,16723,0
Games|Video,43500000.0,RUS,2,6,1110,15593,16703,0
Advertising|Email,9700000.0,FRA,3,3,1180,14315,15495,1
Cloud Infrastructure|Cloud Security|SaaS|Software|Video|Video Streaming,4000000.0,USA,1,1,0,16594,16594,0
Health and Wellness,7189674.0,USA,3,3,1047,15281,16328,0
Hardware|Manufacturing|Networking|Storage,49000000.0,USA,7,25,2075,11534,13609,1
Computers|Network Security|Security|Testing,7400000.0,USA,4,4,1887,13057,14944,1
Artists Globally|Entrepreneur|Professional Networking|Social Media|Technology,5000000.0,USA,3,6,1581,14975,16556,0
Android|Apps|Email|Information Technology|iPhone|Messaging|Mobile|Sales and Marketing|SMS|Wireless,4758319.0,USA,5,1,1392,14981,16373,0
Service Providers|Storage,270862.0,ESP,1,1,0,16233,16233,0
Manufacturing,41200000.0,USA,5,13,4173,11592,15765,1
Data Centers|Networking|Web Hosting,33521971.0,CAN,6,8,793,13325,14118,1
Advertising,50000.0,EGY,1,1,0,14245,14245,0
Software,13060000.0,FRA,3,8,631,12940,13571,0
Advertising|Networking|Sales and Marketing|SNS|Social Media|Web Tools,4100000.0,USA,1,2,0,14279,14279,1
Software,11200000.0,USA,2,5,3025,11477,14502,1
Real Estate,270000000.0,CHN,2,4,190,16562,16752,0
Finance|FinTech,31452688.0,GBR,3,9,938,15708,16646,0
Telecommunications,2600000.0,RUS,1,1,0,15490,15490,0
Hardware + Software,15000000.0,USA,2,6,884,11974,12858,1
Web Hosting,100000000.0,USA,1,4,0,16498,16498,1
Finance|FinTech,157000.0,GBR,1,1,0,13543,13543,0
Computers|Hardware + Software|Information Technology|Tech Field Support,85600000.0,IND,5,15,2684,13514,16198,0
E-Commerce,9000000.0,TUR,3,12,685,15896,16581,0
Hardware + Software,5000000.0,USA,1,1,0,14215,14215,0
Advertising|Advertising Platforms|Brand Marketing|Marketing Automation,34900000.0,USA,4,8,3242,13422,16664,1
Big Data Analytics|Cloud Data Services|Data Visualization|Software,3000000.0,USA,1,2,0,16290,16290,0
Health Care,1313111.0,FRA,1,1,0,15370,15370,1
Mobile Payments|Software,244044164.442339,SWE,9,36,1456,15265,16721,0
E-Commerce|Internet|Marketplaces,250000.0,IND,2,1,252,16419,16671,0
Games,12000000.0,USA,1,1,0,15955,15955,0
E-Commerce,1330000.0,CHN,2,4,365,14944,15309,0
Biotechnology,20000000.0,USA,1,2,0,14348,14348,1
Software,1350000.0,JPN,1,1,0,16402,16402,0
Consumer Goods,6350000.0,USA,1,2,0,12802,12802,0
Content|Content Creators|Content Delivery|Education|Facebook Applications|Software,1345291.0,BRA,1,1,0,15979,15979,0
Biotechnology,27400000.0,USA,2,1,260,15966,16226,0
E-Commerce|Fashion|Retail,26037513.0,USA,5,5,1531,14092,15623,0
Software,9029507.0,USA,6,12,1118,15400,16518,0
Mobile,76630500.0,USA,5,1,1030,13892,14922,0
Beauty|Fashion|Jewelry|Online Shopping|Shoes|Toys,27500000.0,IND,1,1,0,16106,16106,1
Software,13700000.0,USA,2,8,642,12949,13591,0
Hospitality,575000.0,USA,3,4,818,14713,15531,0
E-Commerce|Fashion,11750000.0,USA,3,9,383,15948,16331,0
Enterprises|Music|Software|Web Development,25999968.0,USA,5,13,1774,13158,14932,1
Advertising|News|Photography|Search|Sports|Video|Web Development|Web Tools,9000000.0,USA,3,4,761,13392,14153,1
Mobile,12000000.0,USA,4,8,1476,12599,14075,1
Fitness,3240907.0,IRL,1,2,0,12145,12145,0
E-Commerce|Gambling|Mobile,2750000.0,USA,4,5,496,16071,16567,0
Curated Web|Gambling,16700000.0,USA,1,4,0,13910,13910,0
Clean Technology,17700000.0,USA,1,1,0,15817,15817,0
Software,1330000.0,USA,1,2,0,14768,14768,0
Clean Technology,10000000.0,CHN,1,1,0,14223,14223,0
Coupons|Curated Web|Lifestyle|Loyalty Programs|Online Shopping|Travel,38000.0,SGP,1,1,0,14730,14730,0
Fitness|Medical Devices,30000.0,USA,1,1,0,15361,15361,0
Advertising|Design|Sales and Marketing,200000.0,USA,1,1,0,14245,14245,0
Mobile,7540000.0,GBR,1,3,0,12899,12899,0
Consumer Goods|E-Commerce|Marketplaces,8000000.0,ARE,2,2,1401,15340,16741,0
E-Commerce,11364385.0,GBR,1,1,0,16157,16157,0
Health and Wellness,4412500.0,USA,4,1,420,16107,16527,1
Fitness|Gamification|Health and Wellness|Lifestyle|Software,1000000.0,HKG,1,1,0,16416,16416,0
Open Source|Portals|Software|Web CMS,22500000.0,CHE,1,1,0,16476,16476,0
Audio|Mobile|Telephony|VoIP,33000000.0,USA,4,4,1096,13208,14304,1
E-Commerce,75000000.0,USA,1,1,0,16160,16160,0
Automotive|Hospitality,2500.0,BGR,1,1,0,16183,16183,0
Semiconductors,11300000.0,USA,1,6,0,13193,13193,0
Software,33000000.0,USA,2,6,588,15936,16524,0
E-Commerce,430000.0,ARE,3,8,330,14948,15278,0
Music Services|Social Media,600000.0,USA,1,1,0,16252,16252,0
E-Commerce|Facebook Applications|Finance|Internet|Social Media|Virtual Currency|Virtual Goods,6000000.0,USA,2,5,381,14092,14473,1
Enterprise Software,4500000.0,USA,2,2,951,12233,13184,1
Curated Web,19000000.0,USA,3,10,1008,11382,12390,1
Software,30000000.0,USA,1,2,0,16048,16048,0
Music,3894581.0,USA,5,6,1305,14771,16076,0
Software,800000.0,USA,2,2,173,16288,16461,0
Games|Mobile|Music,2000000.0,USA,2,2,626,13970,14596,1
Musical Instruments|Music Services|Software,191082.0,DNK,1,2,0,15221,15221,0
Advertising|Analytics|Concerts|Events|Music|Ticketing,615000.0,USA,2,2,276,15480,15756,0
App Marketing|Apps|Facebook Applications|Games|Mobile|Mobile Advertising|Social Games|Video Games,7550000.0,GBR,2,7,1091,15400,16491,0
Software,800000.0,ISR,2,3,113,15706,15819,0
Health Care,3470147.0,USA,1,1,0,15142,15142,0
Mobile,36675008.0,USA,5,2,1890,14544,16434,0
Finance|FinTech,85000000.0,IND,2,2,727,15931,16658,0
Software,2300000.0,USA,1,2,0,13720,13720,0
Audio|Email|Messaging,9000000.0,USA,2,9,546,12784,13330,0
Identity Management|Social Media,52753793.0,USA,4,12,1134,14585,15719,0
Big Data|Career Management|Employment|Enterprise Software|Recruiting|SaaS|Semantic Web,6940000.0,CHE,9,33,2187,14400,16587,0
Software,463000.0,CHE,1,1,0,13943,13943,0
Emerging Markets|Enterprise Software|Mobile|Mobile Software Tools|SaaS|Technology|Translation,118000.0,USA,1,1,0,16388,16388,0
Real Estate,125700.0,USA,2,1,620,15622,16242,0
Hardware + Software,13630000.0,USA,3,9,3239,12192,15431,1
Cloud Computing|Internet of Things|M2M|Mobile|SaaS,205300000.0,USA,6,15,3241,12935,16176,0
Analytics|Business Intelligence|Open Source|Software|Web Development,43500000.0,USA,4,22,2186,12983,15169,1
Software,100210000.0,USA,4,28,636,16063,16699,0
Enterprises|Software,50000.0,USA,1,1,0,13422,13422,0
Consumer Electronics|Fitness|Hardware + Software|Mobile Software Tools|Personal Health|Wearables,818799995.0,USA,12,21,3058,13497,16555,0
Games|iOS|Real Time,3485000.0,USA,2,3,141,15400,15541,0
Mobile|VoIP,22500000.0,USA,4,10,556,13497,14053,1
Industrial Automation,250000.0,IND,1,2,0,16553,16553,0
E-Commerce|Marketplaces,375000.0,IND,1,2,0,15221,15221,0
Consumer Electronics|Distribution|Manufacturing|Mobile,2000000.0,SWE,1,1,0,13879,13879,1
Biotechnology|Health Care,376999998.0,USA,3,9,2084,12501,14585,1
Optical Communications|Semiconductors|Wireless,60000000.0,USA,1,1,0,11960,11960,0
Semiconductors,2030000.0,USA,2,2,194,13021,13215,1
Messaging,8000000.0,USA,1,2,0,14031,14031,0
Industrial|Manufacturing|Textiles,150000000.0,IND,1,1,0,16647,16647,0
Clean Technology,17604102.0,GBR,1,1,0,14127,14127,0
Developer Tools|Software,10000000.0,USA,1,2,0,12468,12468,1
Design|Interior Design,2500000.0,IND,2,2,114,16468,16582,0
Consumer Goods|E-Commerce|Internet|Online Shopping|Retail|Wholesale,446000000.0,CHN,5,4,872,13738,14610,1
Manufacturing,162866.0,CHN,1,1,0,15918,15918,0
Advertising|Internet Marketing,3301994.0,USA,5,9,1025,15737,16762,0
Analytics|Business Intelligence|Software,15911107.0,DEU,3,3,366,13879,14245,0
Information Technology|PaaS|Software|Web Hosting,8067000.0,USA,5,8,962,14956,15918,0
Brand Marketing|Messaging,21350000.0,USA,6,11,915,10803,11718,1
Advertising|Advertising Platforms|Broadcasting|Enterprise Software,37600000.0,USA,5,23,1993,14616,16609,0
Social Games,1500000.0,ISR,1,1,0,16010,16010,0
Advertising|Analytics,6600000.0,USA,1,4,0,14015,14015,0
Software,265297.0,KOR,2,2,426,15461,15887,0
Social Media,5000000.0,USA,1,2,0,13422,13422,1
Internet Marketing|Personalization|SaaS|Software,5000000.0,USA,1,1,0,13879,13879,0
Consumer Internet|Finance|FinTech|Investment Management|Wealth Management,15000000.0,USA,3,1,2102,13879,15981,0
Nanotechnology,907900.0,DEU,2,7,1003,15625,16628,0
Hardware + Software,112533998.0,DEU,4,25,1971,14683,16654,0
Biotechnology,46050006.0,USA,5,1,1343,14505,15848,0
Mobile,29000000.0,DEU,1,2,0,13685,13685,0
Beauty|Consumer Goods|Hardware + Software,4898097.0,USA,4,1,1212,14956,16168,0
Bio-Pharm|Pharmaceuticals|Technology,58131358.8640056,DEU,2,10,252,12577,12829,1
Digital Media|Software|Sports,372450.0,USA,2,1,546,16071,16617,0
E-Commerce|Online Shopping|Retail,570000000.0,USA,4,27,483,16280,16763,0
Online Travel|Travel,3788905.0,USA,3,2,1163,15495,16658,0
Travel,1700000.0,USA,3,4,490,16071,16561,0
Analytics|Big Data|Software,12600000.0,ISR,2,3,832,15763,16595,0
Big Data|E-Commerce|Email Marketing|Enterprise Software|Machine Learning|Marketing Automation|Reviews and Recommendations,7000000.0,USA,3,11,744,15886,16630,0
Marketplaces|Mobile Commerce|Transportation,400000.0,USA,1,1,0,16315,16315,0
Travel,2400000.0,USA,1,3,0,15533,15533,1
Finance|FinTech,10000000.0,USA,1,1,0,15989,15989,1
Aerospace|Startups|Transportation,26200000.0,USA,3,5,969,15670,16639,0
Finance|Incubators,3050000.0,SGP,2,16,903,15243,16146,0
Enterprise Software|Software|Web Development,11500000.0,ISR,3,3,2022,14245,16267,0
Environmental Innovation|Farming|Organic,938270.0,GBR,1,1,0,16038,16038,0
Clean Technology|Energy Efficiency|Waste Management,1212770.0,GBR,1,1,0,15792,15792,0
Biotechnology,80600000.0,CHN,2,4,326,16240,16566,0
Manufacturing,167988023.0,CHN,4,3,2982,13514,16496,0
Software,10000000.0,CHN,1,1,0,13422,13422,0
Semiconductors,82000000.0,CHN,1,4,0,13483,13483,1
Manufacturing,6386470.0,CHN,2,1,638,14031,14669,0
Social Media,162364.0,CHN,1,2,0,15765,15765,0
Employment|Enterprise Software|Networking|Recruiting|Search|Social Recruiting,40875000.0,USA,5,25,1520,14690,16210,0
Chat|File Sharing|Media|Mobile|Social Media,9100000.0,USA,2,1,2173,13514,15687,1
Games,17900000.0,USA,3,5,929,13322,14251,0
Artificial Intelligence|Robotics,38600000.0,USA,5,14,538,16226,16764,0
Health and Insurance|Health and Wellness|Internet|iPad|Medical|Mobile|Tablets|Wearables,50100000.0,USA,4,13,1632,14944,16576,0
Apps|Internet of Things|Mobile|Mobile Payments|Public Transportation|Sensors|Transportation,315700.0,EST,2,1,88,16467,16555,0
Analytics|B2B|Direct Sales|Event Management|Events|Meeting Software|Online Scheduling|Sales and Marketing|Sales Automation|Software,6000000.0,USA,2,4,985,15675,16660,0
E-Commerce|Gift Card|Registrars|Retail|Weddings,6800000.0,USA,3,6,794,15915,16709,0
Collaboration|SEO|Software,800000.0,GBR,1,1,0,13726,13726,0
Finance,163309.0,CHN,1,1,0,15979,15979,0
EdTech|Education,22000000.0,CHN,2,3,570,15765,16335,0
Android|Apps|Facebook Applications|iPhone|Mobile|Search|Social Media|Twitter Applications,650000.0,SRB,1,2,0,15187,15187,0
Curated Web|Infrastructure Builders|Internet|Web Development,27775617.0,USA,2,1,3080,13514,16594,0
Manufacturing,16343750.0,CHN,3,3,1430,13978,15408,0
Advertising|Mobile,88651133.0,USA,7,19,1549,13057,14606,1
Databases|Music|Search,900000.0,USA,1,3,0,14753,14753,0
Android|Big Data|Mobile|Sensors,733615.0,BEL,2,2,456,14975,15431,0
Clean Technology,23200000.0,CHN,2,4,123,14000,14123,0
Location Based Services|Logistics|Mobile,2290420.94228017,GBR,4,8,465,16272,16737,0
Ad Targeting|Personalization|Semantic Search|Video on Demand,7500000.0,ISR,3,4,1100,13879,14979,0
Real Estate,60000000.0,CHN,1,2,0,13549,13549,0
Health and Wellness,6300000.0,CAN,3,2,823,15663,16486,0
E-Commerce|Marketplaces|Social Media,148976.0,NLD,2,1,458,15156,15614,0
Analytics,7000000.0,USA,2,5,554,14963,15517,0
Clean Technology,3840300.0,FRA,1,1,0,14865,14865,0
VoIP,20190000.0,USA,1,1,0,16160,16160,0
Social Media|Software|Technology|Web Development|Web Tools,69426794.0,USA,5,5,2102,13726,15828,1
Advertising|Marketing Automation|Media|Mobile Advertising|Web Development,27400000.0,USA,5,11,2157,13948,16105,0
Automotive|Electric Vehicles|Public Transportation,290956.0,GBR,1,1,0,16006,16006,0
Concerts|Entertainment|Mobile|Music|Software,800000.0,KOR,1,1,0,15675,15675,0
Mobile,164744.0,CHN,1,1,0,16071,16071,0
Manufacturing,9700000.0,USA,1,1,0,15184,15184,0
Mobile,7500000.0,USA,2,3,969,13906,14875,0
Apps|Software,7750000.0,NLD,1,1,0,14544,14544,1
Social Network Media,641736.0,CHN,1,1,0,15309,15309,0
Curated Web|Human Resources|Marketplaces|Mobile|Recruiting,11300000.0,USA,3,8,573,15645,16218,0
Career Management|Employment|Facebook Applications|Networking|Social Media,43731330.0,ESP,5,13,2337,14245,16582,0
Enterprise Software,4000000.0,USA,2,2,1911,13817,15728,0
Marketplaces,902241.024259245,EST,2,16,306,16373,16679,0
Employment|Human Resources|Recruiting|Search,2814814.0,IRL,2,6,209,16491,16700,0
Curated Web|Human Resources|Services,40000.0,BRA,2,2,756,15176,15932,0
Analytics|Human Resources,300000.0,USA,1,3,0,16444,16444,0
Search,5000000.0,USA,1,3,0,12416,12416,1
Curated Web,42000000.0,USA,4,7,1728,12874,14602,1
Curated Web|Human Resources|Recruiting|Software,2902275.0,USA,7,1,487,15948,16435,0
Classifieds|Employment|Recruiting|Search,1342546.0,FRA,1,1,0,14698,14698,0
Consulting|Recruiting,643300.0,ITA,1,1,0,16167,16167,0
Career Management|Employment|Human Resources|Marketplaces|Recruiting|Search,300000.0,RUS,1,1,0,15706,15706,0
Software,28762500.0,GBR,3,3,3013,10957,13970,1
Employment,10200000.0,KOR,2,3,214,16228,16442,0
Apps|Employment,2000000.0,USA,2,14,362,16268,16630,0
Employment|Human Resources|Portals|Services,1535000.0,USA,3,24,390,16191,16581,0
Consulting,795507.0,GBR,1,1,0,15974,15974,0
Curated Web,5550000.0,USA,2,2,751,12418,13169,1
Collaboration|Construction|Mobile|SaaS,50000.0,USA,1,1,0,16495,16495,0
Software,262000.0,IND,1,5,0,16680,16680,0
Search,52500000.0,USA,4,13,1210,12784,13994,1
Analytics,2015000.0,USA,2,3,608,15293,15901,0
Internet,3474132.0,FRA,1,1,0,16456,16456,0
Human Resources|Internet|Recruiting,4550000.0,CHN,1,1,0,16352,16352,0
Human Resources|Recruiting|Social Media|Software,55450000.0,USA,4,10,2502,13848,16350,0
Marketplaces|Recruiting|Search,40000.0,CHL,1,1,0,15775,15775,0
Human Resources|Portals|Real Time,224482.0,CHE,1,1,0,16071,16071,0
All Students|Career Management|College Campuses|Colleges|Employment|Human Resources,30000.0,USA,2,1,638,14123,14761,0
Curated Web,1200000.0,USA,1,4,0,14361,14361,0
Social Media|Video|Video Processing,120000.0,USA,1,1,0,16251,16251,0
Hospitality,30000000.0,USA,1,3,0,15917,15917,0
Trading,41250.0,HKG,1,1,0,16071,16071,0
Sports,142268.0,BGR,4,3,334,16071,16405,0
Enterprise Software|Social Network Media,746013.0,BRA,5,6,518,15522,16040,0
Communities|Information Technology|Social Media,270862.0,ESP,1,1,0,16233,16233,0
Social Media,15000.0,USA,1,1,0,16289,16289,0
E-Commerce,98104.0,PER,2,3,335,15979,16314,0
Automotive|E-Commerce|Mobile|Technology,494769311.915804,ESP,2,4,851,15905,16756,0
Internet|Location Based Services|Parking|Software,65000.0,CHL,2,1,413,15566,15979,0
Cloud Computing|Enterprise Software|Web Development|Web Tools,4200000.0,FRA,1,2,0,14433,14433,0
Lifestyle|Limousines|Mobile|Software|Transportation|Travel,75000.0,USA,3,1,1349,15340,16689,0
Beauty|Discounts|E-Commerce|Internet,1428500.0,GBR,1,1,0,15218,15218,1
Education|Internet|Training,51704.0,GBR,1,1,0,15857,15857,0
Automotive|Internet|Marketplaces,3200000.0,USA,1,1,0,13825,13825,0
Manufacturing,35000000.0,USA,1,1,0,12363,12363,0
Android|Apps|iPhone|Messaging|Mobile,7660498.0,FIN,3,8,770,15603,16373,0
Startups|Travel,80000.0,HUN,1,1,0,14245,14245,1
Curated Web|Gift Card|Kids|Parenting,100000.0,IND,1,1,0,15706,15706,0
E-Commerce,500000.0,SGP,1,1,0,15778,15778,0
Browser Extensions|Search,100000.0,ISR,1,1,0,14179,14179,0
E-Commerce,575001.0,USA,2,1,113,14518,14631,0
Maps|Social Media|Social Network Media,300000.0,BRA,2,1,61,15645,15706,0
Software,15000.0,USA,1,1,0,16289,16289,0
Advertising|App Marketing|Facebook Applications|Mobile|Small and Medium Businesses|Social Media,20323.0,NLD,1,1,0,15991,15991,0
Fashion,20071510.0,USA,3,19,737,15174,15911,0
Games|Television|Video,45000000.0,USA,1,5,0,13642,13642,1
Advertising|Social Media|Social Network Media|Web Tools,700000.0,MYS,1,1,0,15960,15960,0
Artists Globally|Event Management|Gamification|Mobile|Music|Music Venues,325000.0,USA,2,3,409,16334,16743,0
Professional Services|Recruiting|Services,1000000.0,USA,1,2,0,16495,16495,0
Hardware + Software,11000000.0,ISR,1,1,0,13803,13803,1
Internet of Things|Software,134935.0,FRA,1,2,0,15248,15248,0
Health and Wellness,10800000.0,USA,1,1,0,15364,15364,0
Media|Social Media,500000.0,IDN,1,1,0,15646,15646,0
Software,5200000.0,USA,1,2,0,12631,12631,1
Messaging,6400000.0,USA,2,6,151,13493,13644,1
Messaging,1200000.0,USA,1,5,0,16595,16595,0
Advertising Platforms|Artificial Intelligence|Big Data|Big Data Analytics|Content|Interest Graph|Internet|Machine Learning|Natural Language Processing|News,1210000.0,USA,2,2,0,16612,16612,0
Cloud Data Services|Optimization|Professional Services|SaaS,30000.0,ITA,1,1,0,15492,15492,0
Clean Technology,190000000.0,USA,4,2,1840,14726,16566,0
Consumer Electronics|Consumer Goods|Gadget|Hardware,50000.0,CAN,1,1,0,16375,16375,0
Enterprise Software,18700000.0,USA,2,7,435,14700,15135,1
Biotechnology,103000000.0,USA,2,9,798,15750,16548,0
Travel & Tourism,25000.0,USA,1,1,0,16107,16107,0
Biotechnology,3906450.0,USA,4,2,553,16203,16756,0
Curated Web|Travel|Virtual Worlds,600000.0,ISR,1,1,0,13634,13634,0
Apps|Kids|Video,500000.0,ISR,1,4,0,16313,16313,0
News,20000000.0,CHN,2,2,700,12965,13665,0
Education|Technology|Video Games,799686.0,BRA,1,2,0,16617,16617,0
iPhone,5000000.0,USA,1,3,0,16534,16534,0
Health Care,10100000.0,USA,2,5,245,16512,16757,0
Organic,1000000.0,IND,1,2,0,16637,16637,0
Apps,2400000.0,JPN,1,1,0,16576,16576,0
Apps|Automotive|Cloud Computing|Enterprise Software|Facebook Applications|Infrastructure|Open Source|Software|Web Hosting,130999998.0,USA,8,17,3590,12784,16374,0
E-Commerce,137614.0,TUR,2,2,270,15848,16118,0
Games,15000000.0,TUR,1,1,0,15828,15828,0
Entertainment|Events|Lifestyle|Mobile|Reviews and Recommendations|Sales and Marketing,40000.0,USA,1,4,0,15501,15501,0
Games|Mobile Games,11000000.0,CHN,2,2,854,15248,16102,0
Audio|Automotive|Cars|Entertainment|Games|Mobile,1000000.0,USA,1,3,0,15789,15789,0
Mobile,18000000.0,CHN,1,1,0,16772,16772,0
Sports,32472.0,CHN,2,1,151,15614,15765,0
Games|Mobile Games|Startups|Video Games,25000.0,USA,1,2,0,15126,15126,0
Audio|EdTech|Education|Games|Music|SaaS,7000000.0,ISR,3,13,954,15340,16294,0
E-Commerce,43400000.0,USA,3,14,1403,15187,16590,0
Mobile,16000000.0,CHN,1,1,0,13321,13321,0
Social Media,10000000.0,CHN,1,1,0,15218,15218,0
Finance|FinTech|Social Media,15000.0,USA,1,1,0,13726,13726,0
Energy Efficiency,17000.0,USA,1,1,0,16191,16191,0
Analytics|Law Enforcement|Legal|SaaS|Technology,7800000.0,USA,2,8,168,15685,15853,0
Mobile|Mobile Payments,14341792.0,GBR,2,1,535,15901,16436,0
Curated Web|Databases|Internet|Search,10500000.0,USA,2,3,488,12600,13088,0
EdTech|Education,1000000.0,CHN,2,1,481,16040,16521,0
Apps|Social Business|Software,8000000.0,IND,2,3,165,16591,16756,0
Apps|Entertainment|Games,195780.0,ESP,1,4,0,15809,15809,0
Curated Web|Parenting,6000000.0,USA,1,1,0,15127,15127,0
Games,2500000.0,USA,1,6,0,16281,16281,0
Mobile|Social Network Media,15300000.0,USA,5,9,974,12874,13848,0
Consumer Electronics|E-Commerce,20000.0,USA,1,1,0,16163,16163,0
E-Commerce,110000.0,USA,2,2,21,15685,15706,0
Entertainment|Games|Music|Video,829990.0,GBR,1,2,0,16314,16314,0
Concerts|iPhone|Music|Music Services,11300000.0,USA,4,27,657,15896,16553,0
Digital Entertainment|Digital Media|TV Production,5900000.0,USA,5,7,455,16174,16629,0
Beauty|Cosmetics|E-Commerce|Retail,62635285.5798046,USA,6,18,3243,13514,16757,0
Advertising|Android|iPhone|Mobile,39674923.0,USA,5,6,4239,11925,16164,0
E-Commerce,10000000.0,CHN,3,3,853,14518,15371,1
E-Commerce,211000000.0,EGY,3,2,630,15770,16400,0
Software,36713881.0,USA,5,6,1287,14874,16161,0
Charity|Humanitarian|Social Media|Social Network Media,3500000.0,USA,2,2,1836,14914,16750,0
E-Commerce,5000000.0,AUS,1,1,0,14930,14930,1
Design|Entertainment|Games|Startups,20265.0,EST,1,1,0,16102,16102,0
Mobile,3025000.0,USA,3,14,1026,14975,16001,0
Photography,2700000.0,USA,1,2,0,15974,15974,0
Educational Games,257320.0,BGR,1,1,0,15869,15869,0
All Students|Communities|Education,110000.0,USA,1,1,0,15522,15522,0
Big Data Analytics|Business Analytics,22000000.0,USA,1,1,0,16568,16568,1
Advertising|Internet|Market Research,22000000.0,USA,1,1,0,16582,16582,0
Education,13000000.0,USA,1,1,0,16163,16163,0
Software,1700000.0,SWE,1,3,0,15952,15952,0
Advertising|Mobile,121500000.0,USA,7,27,2680,12843,15523,1
Advertising|Brand Marketing|Distribution|Facebook Applications|Media|Mobile|Video|Video Streaming,33000000.0,USA,3,5,1326,15320,16646,0
Big Data|Enterprise Software,1240000.0,USA,3,5,946,14907,15853,0
Software,7500000.0,USA,1,1,0,13528,13528,0
Electronics,7000000.0,USA,1,4,0,16595,16595,0
E-Commerce|Online Shopping,1500000.0,USA,1,1,0,14904,14904,0
Distribution|Information Services|Media,5500000.0,ISR,1,3,0,12304,12304,1
Health Care,7500000.0,USA,1,2,0,13222,13222,0
Art|Curated Web|E-Commerce|Fashion|Home Decor,3184934.0,DEU,3,7,294,16111,16405,0
Biotechnology|Health and Wellness|Health Care,1159803496.0,USA,4,6,588,16042,16630,1
E-Commerce,40000.0,CHL,1,1,0,15440,15440,0
Entertainment Industry|Kids|Parenting,50223.0,ESP,1,1,0,15584,15584,0
FinTech|Software,4699397.0,USA,2,1,390,15882,16272,0
Internet,33043.0,DEU,2,2,334,15949,16283,0
Analytics|Big Data|Legal,1817000.0,USA,6,11,556,15884,16440,0
B2B|Small and Medium Businesses,50000.0,AUS,1,1,0,16449,16449,0
Biotechnology|Consumer Goods|Diabetes|Health and Wellness,100000.0,CHE,1,1,0,16650,16650,0
Mobile|Mobile Payments,6307600.0,ITA,3,4,393,15400,15793,0
E-Commerce|Home & Garden|Toys,1065500.0,USA,3,1,690,14568,15258,0
Biotechnology,15000000.0,USA,1,3,0,16699,16699,0
Local Search|Search,67000000.0,IND,2,4,387,15131,15518,0
Discounts|E-Commerce,88988375.8410255,GBR,4,9,1445,14439,15884,1
Advice|All Markets|Curated Web|Customer Service|Q&A|Social Commerce,50700000.0,USA,2,5,111,15510,15621,0
E-Commerce|Fashion|Lifestyle|Online Shopping|Retail|Shoes,254000000.0,USA,6,17,1072,15238,16310,0
Mobile,5795661.0,USA,3,1,763,15589,16352,0
Music,1700000.0,GBR,1,2,0,16051,16051,0
Chat|Games|Video,8000000.0,USA,3,4,214,13573,13787,0
Finance,1136438.0,GBR,1,4,0,16027,16027,0
Mobile|Mobile Advertising|Social Media Platforms|Social Network Media,4325000.0,USA,6,14,1160,14975,16135,0
Analytics|Big Data,4150000.0,USA,5,8,1433,15002,16435,0
Cars,3000000.0,IND,2,7,115,16651,16766,0
Machine Learning|Product Development Services,14800000.0,USA,1,1,0,16121,16121,1
Search|Twitter Applications,765000.0,DNK,2,6,485,14061,14546,1
Human Resources,20000000.0,USA,3,7,580,15994,16574,0
Analytics|Big Data|Enterprise Application|Enterprise Software,20000000.0,USA,1,3,0,16016,16016,0
Biotechnology,63130000.0,USA,5,5,1390,13518,14908,0
Biotechnology,41000000.0,USA,4,11,2415,14152,16567,0
Android|Apps|iOS|Messaging|Mobile|Social Media,1700000.0,USA,2,7,1315,15279,16594,0
E-Commerce|Retail Technology,100000000.0,CHN,1,3,0,16464,16464,0
Advertising|Software|Video|Video Streaming|Web Development,25600000.0,USA,3,6,2238,14092,16330,0
Enterprise Software|Industrial Automation|Internet of Things,35000.0,USA,1,1,0,16327,16327,0
Recruiting,28000.0,USA,1,1,0,15522,15522,0
EdTech|Education,15000000.0,IND,2,4,785,14860,15645,0
Software,2684000.0,USA,2,1,3577,13080,16657,0
Games,6600000.0,USA,1,1,0,15251,15251,0
Education,20000000.0,USA,1,1,0,12145,12145,1
Software|Technology|Web Development,153496208.0,USA,1,1,0,16528,16528,0
Legal,23352129.0,USA,4,3,1718,14822,16540,0
EdTech|Education,1300000.0,IND,1,1,0,15996,15996,0
Services|Software|Technology|Web Development,1900000.0,USA,1,2,0,16720,16720,0
Clean Technology|Lighting|Semiconductors,8500000.0,USA,2,1,285,14153,14438,0
Apps|Data Integration|Enterprise Software|Information Technology|Internet|Real Time,37015021.0,GBR,4,4,1814,13998,15812,0
Games|Networking|Social Games|Social Media|Web Development,244500000.0,USA,6,15,2525,13757,16282,0
E-Commerce|Marketplaces,20000.0,UKR,1,1,0,15803,15803,0
Credit|Finance|FinTech|Technology,600363500.0,USA,11,35,2099,14623,16722,0
Mobile|Price Comparison,9007955.0,GBR,2,6,414,15614,16028,0
Consulting,5000000.0,USA,1,1,0,15848,15848,0
E-Commerce|Shopping,5000000.0,USA,3,11,730,12843,13573,1
3D Printing|Cloud Computing|Consulting|E-Commerce,11400000.0,JPN,3,5,537,16227,16764,0
Software,11000000.0,USA,3,4,920,12989,13909,1
Mobile|Mobile Coupons,2450000.0,USA,2,8,872,15442,16314,0
Mobile Devices,2600000.0,USA,1,2,0,12003,12003,0
Enterprise Software|Information Technology|Services,7500000.0,USA,1,4,0,12016,12016,0
Biotechnology,15600000.0,USA,2,7,1970,12458,14428,0
Audio|Mobile|Music|SMS|Web Tools,9500000.0,USA,2,2,0,13879,13879,0
Beauty|Cosmetics|Social Commerce,40000.0,CHL,1,1,0,16222,16222,0
E-Commerce|Payments|Transaction Processing,500000.0,COL,3,3,242,16010,16252,0
Customer Service|Restaurants|Services,5500000.0,HKG,1,1,0,16722,16722,0
Analytics|Big Data Analytics|Data Mining|News|Predictive Analytics,11000000.0,USA,1,9,0,15280,15280,0
Services|Technology|Telecommunications,7500000.0,USA,1,2,0,12094,12094,1
Biotechnology,4950000.0,ISR,2,1,456,15501,15957,0
Analytics|Internet|Marketing Automation|Mobile,58000000.0,USA,4,33,1169,15497,16666,0
Biotechnology|Medical,52000000.0,USA,2,11,880,12390,13270,1
Software,3200000.0,SGP,1,2,0,16184,16184,0
Semiconductors,72002285.0,USA,5,9,1301,15034,16335,0
Software,4300000.0,FRA,1,6,0,12116,12116,0
Biotechnology,83000000.0,ISR,2,6,882,15069,15951,0
Photography,21647446.0,CHN,2,3,59,16071,16130,0
Web Hosting,4500000.0,ISR,1,5,0,13166,13166,0
Software,300000.0,USA,1,1,0,16755,16755,0
Enterprises|Face Recognition|Mobile|SaaS,3295000.0,USA,6,9,1174,15462,16636,0
Biotechnology|Health Diagnostics,7400000.0,USA,1,1,0,16287,16287,0
Social Media,124000000.0,CHN,3,5,1156,14092,15248,0
Advertising|Analytics|Optimization|Personalization|Sales and Marketing|Startups,9800000.0,USA,3,7,612,15937,16549,0
Education|Internet|Teachers,900000.0,USA,2,8,800,15831,16631,0
Mobile,65931050.0,USA,4,9,1222,13766,14988,0
Software,92136875.0,KOR,3,6,915,15217,16132,0
Consumer Goods|Farmers Market|Social Network Media|Technology,820000.0,USA,2,5,159,16406,16565,0
Software,3493737.0,GBR,1,1,0,11443,11443,0
Biotechnology,53243204.0,USA,6,14,2064,14602,16666,0
Biotechnology,165000000.0,USA,2,1,678,15489,16167,0
Enterprise Software|Technology,8787500.0,USA,3,10,1527,15201,16728,0
Bio-Pharm|Medical|Pharmaceuticals,1500000.0,CAN,1,3,0,16594,16594,0
Employment|Recruiting|Skill Assessment,2770000.0,USA,4,7,808,15704,16512,0
Biotechnology,15000626.0,USA,3,6,417,14923,15340,0
Big Data Analytics|Business Intelligence|Information Services|Mobile Devices|Software,56600000.0,USA,5,13,2125,12247,14372,0
Analytics,1300000.0,FRA,1,1,0,14859,14859,1
Kids|Parenting|Services,175000.0,GBR,1,1,0,16539,16539,0
Biotechnology|Health Care,73000000.0,USA,5,27,3204,12227,15431,1
Semiconductors,10900000.0,USA,1,4,0,13319,13319,0
Analytics|Apps|Big Data|Cloud Computing|Collaboration|Content|Developer Tools|Education|Enterprise Software|Media|Mobile|Music|Open Source|SaaS|Software|Video|Video Editing|Web CMS|Web Tools,116100000.0,USA,6,23,2478,13634,16112,0
Biotechnology,46207305.0,GBR,2,7,1429,15209,16638,0
Jewelry,200000000.0,IND,1,1,0,16308,16308,0
Games|Mobile|Mobile Games,27270000.0,USA,6,48,923,15492,16415,0
Software,40000.0,CHL,1,1,0,16028,16028,0
Software,486133.0,JPN,1,1,0,16132,16132,0
Enterprise Software,108000000.0,USA,4,16,1361,15096,16457,0
Craft Beer,807732.0,GBR,2,2,458,15248,15706,0
Credit Cards|Payments|Rental Housing,14050.0,IND,2,1,42,16664,16706,0
Analytics|Reviews and Recommendations,1000000.0,ISR,1,1,0,14245,14245,0
Collaboration|Health and Wellness|Project Management|SaaS|Software|Startups,339996.0,USA,3,2,365,15857,16222,0
Enterprise Software|Mobile,20000000.0,CHN,1,2,0,15271,15271,1
Entertainment,7734982.0,USA,1,1,0,16260,16260,0
Health Care|Medical,58470000.0,CHN,4,4,1492,13330,14822,0
Apps|Crowdsourcing|Curated Web|Enterprise Software|SaaS,1750000.0,USA,2,2,320,16120,16440,0
Consumers|Mobile|Parenting|Private Social Networking,100000.0,USA,1,2,0,16174,16174,0
Online Travel|Travel & Tourism,79265.0,AUT,1,1,0,16619,16619,0
Reviews and Recommendations|Services|Travel & Tourism,3950000.0,USA,1,1,0,14062,14062,0
Software,10000000.0,CHN,3,3,1492,13330,14822,0
Health Diagnostics|Nanotechnology,456463.0,GBR,1,1,0,15675,15675,0
Information Technology|Services|Software,30000000.0,USA,1,5,0,11562,11562,1
Software|Web Tools,326000000.0,CHN,5,10,3748,12418,16166,1
Consumer Electronics|Electronics|Semiconductors,6400000.0,JPN,1,1,0,16454,16454,0
Finance,440000.0,JPN,1,3,0,15881,15881,0
Biotechnology|Cannabis|Pharmaceuticals,1500000.0,USA,2,2,785,15771,16556,0
Hardware + Software,16500000.0,GBR,2,2,501,16058,16559,0
News,44896100.0,CHN,2,1,761,15218,15979,0
B2B|Enterprise Software|Finance Technology|Financial Services|FinTech|Small and Medium Businesses,21120454.0,GBR,4,17,1426,15156,16582,0
Lifestyle|Mobile|Photography|Photo Sharing|Social Media,3436500.0,USA,5,20,823,15303,16126,1
Internet,4550000.0,MYS,2,6,277,16480,16757,0
Education,634786.0,CHN,1,1,0,13453,13453,0
App Marketing|B2B|Computers|Software,6400000.0,USA,1,2,0,11702,11702,0
Software,199000.0,GBR,1,1,0,13879,13879,0
Finance|FinTech|Investment Management,20300000.0,USA,2,5,1251,14869,16120,0
Content|Software,18950000.0,USA,6,23,1745,14822,16567,0
B2B|Events|Internet|Marketplaces,1600000.0,USA,1,6,0,15678,15678,0
Big Data|Data Integration|Enterprise Software|Software,19743770.0,USA,3,5,1807,12815,14622,1
Mobility|Security,100000.0,USA,1,1,0,15740,15740,0
Software|Technology,675000.0,USA,1,5,0,16294,16294,0
Hardware + Software|Wearables,900000.0,USA,2,2,797,15765,16562,0
Education,2300000.0,IND,1,2,0,16756,16756,0
Software,453390.0,USA,1,1,0,15603,15603,0
Music,145740.0,PER,4,4,617,15574,16191,0
Health Care|Information Technology|SaaS|Software,18916000.0,USA,3,2,962,13514,14476,0
Cloud Computing|Health Care Information Technology|Medical|Software|Startups,151299999.0,USA,10,26,3746,12898,16644,0
E-Commerce,27500000.0,CHN,4,8,1525,14992,16517,0
E-Commerce,115030.0,TUR,1,1,0,16084,16084,0
Solar,17000.0,TAN,1,1,0,16191,16191,0
Educational Games|Entertainment|Kids,355727.0,USA,3,2,225,15949,16174,0
E-Commerce|Enterprise Software|Point of Sale|Web CMS|Web Development,409475.0,BGD,3,1,294,15146,15440,0
Mobile,2304999.0,USA,3,7,1052,14975,16027,1
Internet Service Providers|Mobile|Telecommunications,7662250.0,USA,6,17,1308,15413,16721,0
Games,4835597.0,GBR,2,5,99,15860,15959,0
Collaborative Consumption|Reputation,800000.0,USA,1,13,0,16283,16283,0
Apps|Internet|Software,1600000.0,GBR,1,1,0,16315,16315,0
Advertising|Collaboration|Crowdfunding|Crowdsourcing|Humanitarian|Mobile|Non Profit|Nonprofits|Project Management,30000.0,ARE,1,2,0,16084,16084,0
Curated Web,150040.0,CAN,3,3,283,15482,15765,0
Fashion,32000000.0,USA,2,2,685,15588,16273,0
Diagnostics|Medical|Services,5300000.0,USA,1,1,0,16442,16442,0
Analytics|Big Data|Software,15999999.0,USA,4,13,1268,14692,15960,1
Payments,7700000.0,USA,2,5,918,15706,16624,0
Online Gaming|Social Media|Social Network Media,1204795.0,DEU,3,9,386,13643,14029,0
Education|High School Students|Internet,1514912.0,FRA,1,2,0,16374,16374,0
Digital Media|Graphics|Photography,70000.0,UKR,1,1,0,15845,15845,0
E-Commerce|SaaS,2000000.0,IND,2,4,455,15909,16364,0
Biotechnology,7600000.0,GBR,1,4,0,15589,15589,0
Biotechnology|Health Care,248700000.0,USA,7,4,1335,14916,16251,1
Software,26000000.0,USA,2,8,579,12607,13186,1
Mobile Payments|Payments,2000000.0,USA,1,5,0,16378,16378,0
E-Commerce|Finance|Personal Finance|Recycling,9000000.0,USA,2,1,828,14181,15009,0
Mobile Payments,557933.641588839,SGP,3,2,334,16314,16648,0
3D|Printing,25000.0,USA,1,1,0,16202,16202,0
Entertainment|Games|Television,10000000.0,USA,1,1,0,13906,13906,0
Networking|Social Media|Social Search,5000000.0,USA,1,2,0,14903,14903,1
3D Printing|Digital Signage|Printing,38000000.0,USA,1,7,0,16328,16328,0
Consumer Electronics|Hardware|Robotics,120000.0,USA,2,3,326,16265,16591,0
Business Information Systems|Chat|Knowledge Management|Messaging,1878000.0,USA,2,5,80,15838,15918,0
Distributors|Manufacturing,24000000.0,USA,1,1,0,16538,16538,0
E-Commerce|Lifestyle|Online Shopping|Retail,3200000.0,USA,2,4,323,16071,16394,0
Advertising|Internet|Real Time,6740930.0,JPN,2,4,391,14987,15378,0
Real Time|Security|Technology,16800000.0,USA,2,6,568,11666,12234,1
Search|Travel,235024070.0,USA,6,15,3151,12418,15569,1
High Tech|Knowledge Management|Professional Services|Sales and Marketing|Software,8850000.0,USA,2,1,401,15675,16076,0
Software,8580000.0,FRA,2,4,618,13139,13757,0
Mobile|Networking|Social Media|Web Development,7575000.0,USA,3,4,762,15034,15796,0
Software,48000000.0,USA,3,10,1498,12857,14355,1
Banking|E-Commerce|Payments,200000.0,UKR,1,1,0,16185,16185,0
Financial Services|Investment Management|Technology|Venture Capital,1000000.0,USA,1,1,0,14716,14716,0
Ediscovery|Legal|Software,125000000.0,USA,1,1,0,16469,16469,0
Software,13000000.0,FRA,1,2,0,13067,13067,0
Business Services|Consulting|Finance,6800000.0,USA,3,2,1950,12326,14276,0
Clean Technology,38000000.0,USA,3,4,843,13879,14722,0
Enterprise Software|Health and Wellness|Human Resources,32900000.0,USA,4,9,1928,14396,16324,0
Fashion,18853099.0,USA,5,12,897,15706,16603,0
Advertising,13200000.0,CHN,2,3,1333,14610,15943,0
Android|Apps|Corporate Training|EdTech|Education|Enterprises|iOS|iPad|iPod Touch|Mobile,175000.0,USA,3,4,790,15281,16071,0
Software,2520000.0,ITA,1,1,0,13913,13913,0
Android|Hardware|Hardware + Software|Robotics,1150000.0,FRA,3,4,864,15836,16700,0
Android|iPhone|Networking|Social Media,35500000.0,CAN,4,9,1128,15252,16380,0
Messaging|Networking|Social Media|Video on Demand,135905.0,SWE,1,2,0,16040,16040,0
Artificial Intelligence|E-Commerce|Optimization|Software,922350.0,GBR,1,3,0,15553,15553,0
Android|Consumer Goods|Games|iPad|iPhone|Product Development Services|Sports,1940850.0,BEL,1,2,0,15340,15340,0
Analytics|Automotive|Big Data|Cloud Computing|Databases|Data Visualization|Developer APIs|Infrastructure|Plumbers|Software,14518000.0,USA,5,40,912,15340,16252,0
Embedded Hardware and Software|Energy Efficiency|Hardware|Hardware + Software|Home Automation|Internet of Things|Smart Building|Wireless,1640000.0,USA,2,10,329,16043,16372,0
Cloud Infrastructure|CRM|E-Commerce|Enterprise Software|Printing|SaaS,3350000.0,USA,5,6,2204,13879,16083,0
Art|Consumer Goods|Consumers|Content Discovery|EdTech|Education|Entertainment|Information Technology|Media|Technology,87000.0,USA,1,3,0,16104,16104,0
Curated Web|Social Media,31389.0,BGR,1,1,0,15584,15584,0
Advertising|Coupons|Curated Web|E-Commerce|Email|Fashion|Internet|Internet Marketing|Shopping|Social Commerce,47150000.0,USA,3,19,1657,14853,16510,0
Mobile,1300000.0,USA,2,3,234,15883,16117,0
Accounting|Cloud Data Services,528189.9371013821,SVK,1,1,0,15706,15706,0
Curated Web,185000.0,USA,2,1,555,14641,15196,0
Curated Web|E-Commerce|Facebook Applications|Peer-to-Peer|Social Commerce|Twitter Applications,255000.0,USA,1,3,0,15187,15187,0
Security,4100000.0,USA,2,6,505,15397,15902,0
Curated Web|Real Time|Social Media,20000.0,USA,1,1,0,14730,14730,1
Big Data Analytics|CRM|Mobile|Quantified Self,1000000.0,USA,1,1,0,16525,16525,0
Public Transportation,10300000.0,USA,2,6,850,15887,16737,0
Big Data Analytics|Developer APIs|Health Care Information Technology|Health Diagnostics|Kids|mHealth,30000.0,ARE,1,1,0,16467,16467,0
Curated Web|FinTech|Kids|Lifestyle Businesses|Messaging|Mobile|Parenting|Photography|Photo Sharing|Social Media,1100000.0,USA,1,8,0,15993,15993,0
Application Platforms|Social Media,30000.0,ARE,1,1,0,16467,16467,0
Content|Software,5000000.0,USA,1,2,0,13634,13634,1
Hardware + Software,500000.0,GBR,1,1,0,13865,13865,0
Content|Direct Marketing|Location Based Services|Reviews and Recommendations|Social Media|Social Search,5560000.0,BRA,4,8,1029,14683,15712,0
Automotive|Cars|Manufacturing,2873563.0,BRA,1,1,0,13826,13826,0
E-Commerce,10000000.0,CHN,1,1,0,15126,15126,0
Ticketing|Training|Travel,246560.0,FRA,1,2,0,14791,14791,0
E-Commerce,1956300.0,FRA,1,1,0,14319,14319,0
Health and Wellness,2314005.0,FRA,2,2,427,15824,16251,0
E-Commerce|Search,3000000.0,GBR,1,2,0,10592,10592,1
Enterprise Software,9690000.0,GBR,1,1,0,13479,13479,0
Pharmaceuticals,35500000.0,USA,2,1,290,11992,12282,0
Data Center Infrastructure|Networking|Network Security|Software,21999992.0,USA,3,3,730,15349,16079,0
Biotechnology,75103391.0,USA,5,1,2015,14483,16498,1
Enterprise Software,43500000.0,USA,2,7,651,15215,15866,0
Startups,4500000.0,USA,2,3,1981,14095,16076,0
Photography|Software,4392386.0,CHN,1,1,0,14488,14488,0
Software,58295000.0,USA,3,9,286,16112,16398,0
Advertising|Mobile Advertising|Search Marketing|Social Media Advertising,49660149.0,ISR,7,12,2320,13848,16168,0
Health Care,2525000.0,USA,1,1,0,16160,16160,0
Enterprises|Gamification|SaaS|Software|Tutoring,50000.0,CAN,1,1,0,15553,15553,0
Biotechnology,3169200.0,USA,3,2,1382,14626,16008,0
Biotechnology,2988252.0,USA,1,2,0,15441,15441,0
Theatre,245000000.0,USA,2,2,273,11961,12234,0
Medical Devices,4000000.0,ISL,4,2,1508,14614,16122,0
Mobile,1010000.0,FRA,1,3,0,13986,13986,0
Healthcare Services|Medical|Therapeutics,31569703.9060323,GBR,2,1,420,16351,16771,0
Consumer Electronics|Design|Software,10000000.0,USA,1,1,0,16365,16365,0
Events|Mobile Advertising|News,40000.0,USA,1,1,0,16440,16440,0
Software,11051348.966548199,GBR,3,2,2289,14456,16745,0
Analytics|Enterprises|Enterprise Software|Services,24000000.0,USA,2,10,1291,12230,13521,1
Education,40000.0,FRA,1,1,0,15475,15475,0
Curated Web,850000.0,IND,2,8,604,16027,16631,0
Software,973622.0,KOR,4,3,549,15932,16481,0
Food Processing|Retail,6000000.0,USA,1,2,0,16260,16260,0
Biotechnology,32868505.0,USA,2,4,313,16107,16420,0
Games,19400000.0,FRA,3,5,1024,13239,14263,1
Social Media|Social Network Media,40000.0,CHL,1,1,0,15940,15940,0
Health and Wellness,640000.0,USA,2,1,500,14844,15344,0
Enterprises|Industrial|Knowledge Management|Mobility|Software|Speech Recognition,830000.0,USA,4,1,1305,14761,16066,0
Law Enforcement,1569095.0,GBR,1,1,0,16603,16603,0
Architecture|Market Research|Services,12500000.0,USA,1,6,0,12090,12090,0
Mobile|Mobile Coupons,1750000.0,USA,2,2,397,14610,15007,1
Travel,13637262.0,GBR,1,1,0,15922,15922,0
Advertising|Event Management|Marketing Automation|Media,30000000.0,USA,1,1,0,12090,12090,0
Web Tools,10800000.0,USA,1,2,0,16631,16631,0
Advertising,4760000.0,SWE,1,1,0,15117,15117,0
Fleet Management|Marketplaces|Software|Supply Chain Management|Technology|Tracking|Transportation,2520000.0,USA,1,11,0,15706,15706,0
Games,40000.0,CHL,1,1,0,15301,15301,0
Semiconductors,15000000.0,USA,1,3,0,12564,12564,0
Social Media,500000.0,CAN,1,1,0,14820,14820,0
Innovation Management|Robotics|Technology,25000.0,CHN,1,2,0,16384,16384,0
E-Commerce|Hardware + Software,15775000.0,USA,4,9,1227,15445,16672,0
Biotechnology,10869100.0,DEU,1,3,0,14341,14341,0
E-Commerce|Hotels|Internet|Privacy|Restaurants|Spas,1740000.0,GBR,1,2,0,14698,14698,1
Digital Media|iOS|iPhone|Software,12000000.0,USA,2,2,1526,13488,15014,0
Cloud Data Services|Cloud Management,1300000.0,USA,2,1,96,16239,16335,0
Technology,47000000.0,USA,4,11,1614,14730,16344,0
Health and Wellness,20000000.0,USA,1,1,0,15203,15203,0
Health and Wellness|Health Care|Medical|Medical Devices,14000000.0,ISR,1,2,0,16205,16205,0
Education,1097400.0,USA,4,1,948,15792,16740,0
Content,9100000.0,USA,1,5,0,16518,16518,0
Development Platforms|Life Sciences|Pharmaceuticals,23000000.0,USA,1,6,0,16602,16602,0
Consumer Goods|Fitness,3250000.0,MYS,2,7,75,16561,16636,0
Finance|FinTech|Hedge Funds,2000000.0,GBR,1,2,0,14610,14610,0
Health Care,23035500.0,USA,6,9,2082,13021,15103,0
Curated Web,44000000.0,USA,1,1,0,12585,12585,0
Software,786000.0,NZL,1,1,0,14018,14018,0
Product Design|SaaS|Services,4000000.0,USA,1,2,0,16538,16538,0
Music,120000.0,USA,2,3,376,14568,14944,1
Biotechnology,32999146.3112603,NLD,2,9,1974,13690,15664,0
Shipping|Shopping,59926327.286157705,BEL,3,2,2215,11603,13818,1
Software,2500000.0,CAN,1,1,0,13739,13739,0
E-Commerce|Finance|Social Media,1000000.0,USA,1,1,0,13879,13879,0
Entertainment|Services|Sports,840000.0,SGP,1,1,0,16540,16540,0
Marketplaces|Restaurants,8100000.0,USA,2,24,1165,15248,16413,0
Android|App Marketing|iPhone|Mobile|Mobile Advertising|Monetization,1600000.0,USA,3,2,214,15068,15282,0
Content|Media|Social Media|Social Network Media|Software|Video|Web Tools,39007789.0,USA,3,9,908,13300,14208,1
Game,120000.0,USA,1,5,0,16405,16405,0
Art|Content|Curated Web|Social Media,2200000.0,USA,2,3,365,13939,14304,0
Education,2100000.0,USA,2,3,972,14791,15763,0
Classifieds|Coupons|Marketplaces|Private Social Networking|Social Media|Social Network Media,150000.0,LTU,1,1,0,15704,15704,0
Analytics,20000000.0,USA,2,5,2718,11373,14091,0
Apps|Mobile|Online Dating,1600000.0,USA,1,1,0,16735,16735,0
Internet|Software,120000.0,USA,2,3,275,16130,16405,0
File Sharing|Photography|Real Time,2800000.0,USA,2,15,527,15281,15808,0
E-Commerce,1375748.0,GBR,1,1,0,15176,15176,0
Crowdfunding|Crowdsourcing|Design|Entrepreneur|Finance,10000000.0,USA,1,19,0,15051,15051,0
Games|Toys,40000.0,CHL,2,2,458,15672,16130,0
Education|Families|Marketplaces|Services,500000.0,USA,3,5,243,15949,16192,0
Games,297728.0,BGR,3,3,396,15826,16222,0
EdTech|Education,10100000.0,USA,2,19,592,15431,16023,0
Enterprise Software,14020000.0,USA,2,5,456,13038,13494,1
Education,170000.0,USA,1,1,0,15470,15470,0
Education|Private School|Publishing,300000.0,RUS,1,1,0,16225,16225,0
E-Commerce,665000.0,URY,3,2,414,15351,15765,0
Curated Web,40000.0,SGP,1,1,0,15940,15940,0
Photography,500000.0,JPN,1,1,0,16219,16219,0
Collaborative Consumption|Curated Web|Marketplaces|Mobile|Parenting|Peer-to-Peer,1550000.0,USA,6,6,1752,14926,16678,0
Curated Web,3225000.0,USA,3,2,846,14184,15030,0
Kids|Mobile|Software,4700000.0,ISR,2,5,786,15986,16772,0
Cloud Computing|Enterprise Software|PaaS|SaaS|Security|Software,5550000.0,USA,2,1,501,16044,16545,1
Publishing,20000.0,USA,1,1,0,16287,16287,0
Software,262729.0,KOR,1,1,0,15531,15531,0
Kids|Security,15000.0,USA,1,1,0,15901,15901,0
Apps|Cloud Data Services|Health Care|Parenting|Sales and Marketing|Social Media,1200000.0,USA,2,4,0,15706,15706,0
Apps,211612.0,GBR,1,1,0,16405,16405,0
Curated Web|Kids|Loyalty Programs|Parenting,4209381.0,GBR,1,1,0,13800,13800,0
Curated Web|Web Browsers,18400000.0,USA,6,14,1930,13392,15322,1
Consumer Electronics|Mobile|Social Network Media|Television,40000.0,USA,1,1,0,15518,15518,0
Artificial Intelligence|Big Data Analytics|Content Discovery|Knowledge Management|Technology,11200000.0,USA,2,4,504,15706,16210,0
Mobile|Soccer|Social Games|Sports,135905.0,DNK,1,1,0,16040,16040,0
SaaS|Software|Travel,1800000.0,USA,1,1,0,15796,15796,1
Android|Cloud Data Services|iPhone|Mobile|Natural Language Processing|Neuroscience|Software,20000000.0,USA,1,1,0,14910,14910,0
Messaging,200000.0,JPN,1,1,0,14822,14822,0
Android|Design|Games|iOS|iPad|iPhone|Mobile|Software,1500000.0,USA,1,2,0,15400,15400,0
Apps|Payments|Services,640113.0,BRA,1,1,0,16139,16139,0
E-Commerce|Gift Card,745000.0,CAN,4,5,568,15470,16038,0
Advertising|Games|Mobile,19009963.0,USA,7,26,1483,14910,16393,0
Adventure Travel|Entertainment|Local|Software|Travel,265000.0,USA,1,5,0,14610,14610,0
Messaging|Mobile|Social Media,120500000.0,CAN,5,17,2055,14610,16665,0
Clean Technology,3150000.0,USA,2,1,2,14827,14829,0
Semiconductors,42450000.0,USA,5,13,3334,12435,15769,0
Mobile,770000.0,USA,1,6,0,14822,14822,1
Nonprofits,4914999.0,USA,4,4,2303,13879,16182,0
Software,1800000.0,USA,1,1,0,16464,16464,0
Education,40000.0,CHL,1,1,0,15561,15561,0
Algorithms|Analytics|Big Data|Finance|Financial Exchanges|FinTech|Machine Learning|Trading,130420.0,USA,2,17,25,15918,15943,0
Chat|Enterprise Software|Messaging|Mobile Enterprise,630000.0,GBR,1,1,0,16344,16344,0
Information Services|Information Technology,3834862.0,CHE,1,2,0,12466,12466,0
Internet,27000000.0,USA,2,5,625,15706,16331,0
Software,1798750.0,ESP,2,2,1953,13579,15532,0
Software,5460000.0,AUT,1,4,0,13752,13752,0
Consulting|Hospitality|Mobile,500000.0,USA,1,18,0,15611,15611,0
Apps|Consumer Electronics|Health Care|Medical|Mobile,6925000.0,USA,6,15,1275,15391,16666,0
Application Platforms|Development Platforms|Internet,250000.0,USA,1,1,0,11722,11722,0
Apps|Comics|Education|Kids,85569.0,COL,2,2,41,16211,16252,0
Biotechnology,5500000.0,USA,1,3,0,16503,16503,0
Manufacturing|Publishing|Software,2300000.0,USA,1,2,0,15616,15616,0
Education|Toys,1351059.0,DEU,1,2,0,16102,16102,0
Hardware + Software,2600000.0,PRT,1,1,0,16000,16000,0
Health Care,35886875.0,USA,6,1,2912,13728,16640,0
Education|Games|Kinect,39260.0,BEL,2,1,11,15797,15808,0
Content Creators|Events|Software|Video,1357041.0,IRL,2,2,927,14669,15596,0
Manufacturing,27085039.0,USA,4,1,883,15244,16127,0
Biotechnology,11171910.0,USA,7,1,1832,14616,16448,0
Guides|Reviews and Recommendations|Social Network Media,19311.0,USA,1,1,0,14858,14858,0
Analytics|Social Media Marketing,49500000.0,USA,5,7,1389,15248,16637,0
Energy|Energy Efficiency|Service Providers,80000000.0,CAN,1,1,0,16658,16658,0
Mobile|Wireless,114449379.0,USA,12,30,3996,11458,15454,1
Android|Databases|Games|Mobile|Software,43000000.0,GBR,1,2,0,13027,13027,1
Enterprises|Enterprise Software,181850000.0,CHN,4,3,6226,10347,16573,1
Games,3365000.0,USA,4,1,1346,14761,16107,0
Software,500000.0,USA,1,2,0,15425,15425,1
Games,17000000.0,TWN,2,4,457,14549,15006,0
Finance,7719600.0,GBR,1,1,0,16085,16085,0
Software,1800000.0,CHN,1,2,0,10592,10592,0
Software,50000000.0,HKG,1,3,0,16034,16034,1
Software,18600000.0,CHN,1,2,0,15156,15156,0
Clean Technology,1180238.0,GBR,1,1,0,14237,14237,0
Travel,881000.0,DEU,1,1,0,13895,13895,0
iPhone|Messaging,310000.0,USA,1,2,0,15431,15431,0
Curated Web,995625.0,DEU,1,3,0,14364,14364,0
Advertising|B2B|Marketplaces|Procurement|Small and Medium Businesses,31500000.0,USA,4,21,1078,15645,16723,0
Health Care|Software|Web Tools,40000000.0,USA,1,1,0,15425,15425,0
Audiobooks|Digital Media|Language Learning,40000.0,CHL,1,1,0,15440,15440,0
Big Data|Health and Wellness|Mobile Health,12170000.0,USA,3,9,849,15566,16415,0
Health and Wellness|Kids|Parenting|Social Media,950000.0,USA,2,1,1127,15095,16222,0
Algorithms|Databases|Software,900000.0,RUS,1,1,0,15340,15340,0
Internet|Nonprofits|Software,4480000.0,USA,1,5,0,13494,13494,1
B2B|High Tech|Image Recognition|Machine Learning,60000.0,ARE,2,1,467,15949,16416,0
Enterprise Software|Finance,17818000.0,USA,4,9,1288,15048,16336,0
Hardware + Software,240000.0,USA,2,2,1342,11807,13149,0
Clean Technology|Oil,299320000.0,USA,5,6,2161,13838,15999,1
Advertising|Advertising Platforms|Internet|Internet Marketing|Sales and Marketing|Software,68185844.1231072,FIN,5,13,2161,14610,16771,0
Consulting,10000.0,USA,1,1,0,15492,15492,0
Android|Apps|iOS|Location Based Services|Mobile|Real Time|Software|Tracking,663600.0,GTM,3,3,306,15431,15737,0
Advertising|Audio|Content|Digital Media|Media|Monetization|Video,7300000.0,USA,3,2,947,13088,14035,1
Career Management|Curated Web|Education|Human Resources|Private School|Recruiting,3200000.0,CAN,2,5,532,15973,16505,0
Colleges|Games|Risk Management,225000.0,USA,2,2,283,13879,14162,0
Public Relations,26830000.0,USA,3,8,2277,13213,15490,0
Cloud Computing|Internet of Things|Mobile|Real Estate|SaaS|Smart Building,1500000.0,USA,1,4,0,16561,16561,0
Mobile|Social Media,770000.0,USA,2,1,94,15034,15128,0
Analytics|Business Analytics|Business Services|Internet Marketing|Sales and Marketing|Social Media Marketing|Software|Web Tools,10800000.0,USA,3,12,1892,14012,15904,0
Crowdfunding|Curated Web,994490.0,FRA,1,2,0,14398,14398,0
Online Dating|Social Media,881500.0,DEU,2,4,153,13757,13910,0
E-Commerce,200000.0,USA,1,1,0,15402,15402,0
Games,20000000.0,CZE,2,2,20,13987,14007,1
Curated Web,17000000.0,CAN,2,1,166,16022,16188,1
Enterprise Software|Health Care Information Technology,22470400.0,USA,3,16,833,15614,16447,0
Apps|Media|Mobile,1800000.0,DEU,1,3,0,16457,16457,0
Cooking|Recipes|Software|Specialty Foods,1400000.0,USA,3,8,120,16512,16632,0
Hospitality,19500000.0,USA,4,19,642,15518,16160,0
E-Commerce|Food Processing|Logistics|Restaurants,750000.0,USA,2,2,435,16232,16667,0
Curated Web,40000.0,CHL,1,1,0,15301,15301,0
Biotechnology,85250000.0,USA,4,3,1146,15042,16188,1
Android|Apps|iPhone|Mobile|Publishing,50000.0,USA,3,3,636,15819,16455,0
Analytics|Location Based Services,500000.0,HKG,1,4,0,15706,15706,0
E-Commerce|Mobile Payments,75000.0,USA,1,1,0,15917,15917,0
Analytics|Apps|Location Based Services|Media|Mobile|Software|Technology,750000.0,ISR,2,3,446,15826,16272,1
Fitness|Predictive Analytics|Productivity Software|Sports,4725966.0,IRL,3,3,648,15645,16293,0
E-Commerce,6459900.0,USA,4,3,894,15402,16296,0
Software,1000000.0,USA,1,1,0,16007,16007,0
Finance|Financial Services|Social Entrepreneurship,9000000.0,USA,3,1,1222,14833,16055,0
Hardware|Hardware + Software|Robotics|Shipping|Software,11600000.0,USA,2,2,1239,12053,13292,1
Collaboration|Document Management|Enterprises|Enterprise Software|SaaS,97000.0,USA,2,2,31,15826,15857,0
Apps|Social Network Media|Video,15000.0,USA,1,1,0,15584,15584,0
Productivity Software|Software|Task Management,1015912.0,CAN,1,1,0,14396,14396,0
Art|Creative|Creative Industries|E-Commerce|Kids|Subscription Businesses,7000000.0,USA,3,27,1147,15258,16405,0
Android|Entertainment|Games|Mobile,21000000.0,USA,2,7,373,15915,16288,0
Cloud Computing|Hardware|Home Automation|Internet of Things|SaaS|Security|Technology,4364112.0,DEU,2,4,522,15999,16521,0
Artificial Intelligence|Developer APIs|Internet of Things|Machine Learning|Sensors|Wearables,2545180.0,CAN,2,1,525,16161,16686,0
Photography,9000000.0,CHN,1,1,0,15887,15887,0
Credit|Enterprises|Finance,1500000.0,MEX,2,1,43,16144,16187,1
Mobile,1267155.0,KOR,1,1,0,14822,14822,0
Software|Software Compliance,50000.0,IND,1,1,0,16323,16323,0
Web Hosting,130000.0,FRA,1,1,0,15857,15857,0
Advertising,1000000.0,USA,2,7,177,16103,16280,1
Games,19000000.0,USA,2,4,988,14201,15189,0
Biotechnology,180000.0,USA,2,2,929,15483,16412,0
Web Hosting,10000000.0,USA,1,2,0,12996,12996,0
EdTech|Education,500000.0,USA,2,2,284,16030,16314,0
Cloud-Based Music|Music,104000000.0,TWN,1,4,0,16309,16309,0
Big Data|Developer APIs|Health and Wellness|Recipes|Semantic Web|Software,650000.0,GBR,1,3,0,16027,16027,0
Apps|Health Care|Health Care Information Technology|Mobile Health,2500000.0,USA,2,12,128,16338,16466,0
Design|Industrial|Manufacturing,3453579.0,NLD,1,1,0,16177,16177,0
Personal Health,2487070.0,GBR,3,8,136,16547,16683,0
Software,1500000.0,USA,1,3,0,16673,16673,0
Clean Technology,15718378.0,USA,8,1,1109,14403,15512,0
Travel,13330000.0,FRA,1,2,0,13066,13066,0
Hardware + Software,58000000.0,USA,2,7,84,13879,13963,1
Education|Marketplaces|Parenting|Service Providers,450000.0,IND,2,2,202,16563,16765,0
E-Commerce,80000.0,RUS,1,1,0,15826,15826,0
E-Commerce|Internet,344314.676068753,FIN,1,2,0,16161,16161,0
Finance|Payments,1830000.0,USA,4,1,852,15218,16070,0
Advertising|Internet|Investment Management|Mobile|Monetization|Publishing|Search|SEO|Social Media|Social + Mobile + Local,500000.0,USA,1,2,0,14975,14975,0
Internet|Mobile Commerce|Mobile Software Tools,2816143.0,ESP,2,2,156,16468,16624,0
Retail|Search,2051813.0,ITA,2,3,454,15909,16363,0
Cloud Computing|Health and Wellness|Health Care|Mobile,644000.0,SGP,3,3,636,15468,16104,0
Mobile,10000000.0,USA,2,2,59,15237,15296,0
E-Commerce,500000.0,USA,2,6,532,15954,16486,0
Analytics|Business Analytics|Business Intelligence|Software,7745454.0,CAN,2,11,374,16117,16491,0
Software,8700000.0,USA,1,2,0,12937,12937,0
Software,19100000.0,CAN,2,8,854,12062,12916,0
Entertainment|Games,750000.0,SGP,1,1,0,16102,16102,0
Sales and Marketing|Social Media|Technology,720000.0,GBR,1,2,0,15997,15997,0
Apps|Finance|FinTech|iOS|iPhone|Media|News|Pets,1496500.0,USA,5,5,870,15260,16130,0
Internet|Online Reservations|Online Travel|Tourism,6500000.0,HKG,2,6,136,16587,16723,0
Search,40000.0,CHL,1,1,0,15180,15180,0
Cloud Data Services|Developer APIs|Software,1300000.0,USA,2,10,433,15273,15706,0
Enterprise Software,2000000.0,USA,1,3,0,15508,15508,0
Analytics|Social Media,40000000.0,USA,10,53,1514,14426,15940,1
Collaboration|Crowdsourcing|Curated Web,1000000.0,USA,1,1,0,13879,13879,1
Mobile|Online Scheduling,2100000.0,USA,3,6,432,15710,16142,0
Delivery,11000000.0,USA,2,2,19,16723,16742,0
Enterprise Software|Social Media Management,10000000.0,CHN,1,3,0,16120,16120,0
Finance,29000000.0,SWE,2,5,152,16317,16469,0
Software,482000.0,CAN,2,2,393,14221,14614,1
Analytics|Business Intelligence|Enterprise Software|Marketing Automation|Predictive Analytics|SaaS|Software,2600000.0,USA,5,3,1480,14975,16455,0
Mobile,164744.0,CHN,1,1,0,16102,16102,0
Colleges|EdTech|Education|K-12 Education|Machine Learning|Personalization,147250017.0,USA,6,37,2718,14020,16738,0
Mobile,1100000.0,CAN,1,1,0,15748,15748,0
Search|Semantic Search,500000.0,USA,2,2,153,16169,16322,0
Android|Apps|Curated Web|Internet|iOS|iPad|iPhone|Search,537868.0,DEU,2,1,426,15949,16375,0
Clean Technology,12000000.0,USA,1,1,0,13908,13908,1
Security,6580000.0,USA,5,15,736,15799,16535,0
Messaging,500000.0,IND,1,1,0,15890,15890,0
Finance|FinTech|Insurance,15700000.0,CHE,3,8,598,16136,16734,0
Biotechnology|Clean Technology|Nutrition,1635523.0,USA,2,2,448,16007,16455,0
Software,94885095.0,USA,7,15,705,14365,15070,1
Software,14412889.0,USA,5,9,1107,15173,16280,0
Content|Games|Television|Video,4500000.0,ISR,2,6,110,13555,13665,0
Games,15000.0,USA,1,1,0,15340,15340,0
Education|Services,6200000.0,USA,1,1,0,16567,16567,0
Big Data|Big Data Analytics|Curated Web|Social Games|Social Media|Software|Sports,650000.0,USA,3,1,188,16030,16218,0
All Students|Education,270000.0,GBR,3,1,734,15431,16165,0
Curated Web|Families|Online Travel|Social Travel,970000.0,ESP,2,1,445,15340,15785,0
E-Commerce,1664696.0,GBR,1,1,0,16302,16302,0
Fitness|Health and Wellness|Healthcare Services,50000.0,RUS,1,1,0,15567,15567,0
E-Commerce|Fashion|Internet,3400000.0,USA,3,4,1039,15366,16405,0
Advertising|Analytics|Brand Marketing|Content|Digital Media,1500000.0,USA,2,6,116,16023,16139,0
App Marketing|Email Marketing|Internet Marketing|Software,500000.0,USA,1,1,0,13189,13189,1
Weddings,25000.0,USA,1,1,0,16191,16191,0
Enterprise Software,7710995.0,USA,3,5,2760,12002,14762,1
Cloud Computing|Emerging Markets|SaaS|Small and Medium Businesses|Software|Telephony,22500000.0,IND,3,5,1304,14975,16279,0
Games,31860000.0,USA,4,8,8410,7305,15715,0
EdTech|Education,18120360.0,USA,8,1,1492,15090,16582,0
Technology,18000.0,USA,1,1,0,16467,16467,0
Market Research,1200000.0,USA,1,2,0,16623,16623,0
Analytics|Archiving|Business Intelligence|Cloud Computing|Collaboration|Content|Document Management|Ediscovery|Email|Risk Management|Software,2391663.0,GBR,1,2,0,15400,15400,0
E-Commerce,2400000.0,USA,1,5,0,12251,12251,1
Content Delivery|CRM|Productivity Software|SaaS|Sales and Marketing|Software,7621051.0,USA,3,5,1725,14373,16098,0
Internet Marketing|Software,11196032.0,USA,6,7,1512,14770,16282,0
Software,3600000.0,USA,2,4,492,12784,13276,0
Artificial Intelligence|Collaboration|Enterprise Software|Unifed Communications,1200000.0,USA,2,5,386,16104,16490,0
Curated Web|Information Services,20000000.0,USA,2,8,1090,12363,13453,0
EdTech|Education,8600000.0,USA,3,6,965,15400,16365,0
Social Media,40000.0,CZE,1,1,0,15666,15666,0
Developer Tools|Email Marketing|SaaS|Sales and Marketing|Software,110000.0,USA,1,1,0,16709,16709,0
Software,500000.0,USA,1,5,0,16386,16386,0
B2B|Internet|Media,488605.0,ESP,2,2,640,15796,16436,0
Enterprise Software|Finance|Mobile|Mobile Payments,1605000.0,USA,3,4,507,15796,16303,0
Analytics|Mobile|Networking|Psychology|Social Media|Social Search,2250000.0,USA,1,5,0,16010,16010,0
Fashion|Software|Technology,6346881.0,GBR,2,5,260,16344,16604,0
Photography|Photo Sharing,8400000.0,USA,2,11,132,15786,15918,0
Messaging|Mobile,20000.0,USA,1,1,0,15826,15826,0
E-Commerce,3165969.0,CHE,3,2,475,14822,15297,0
Mobile Advertising|Mobile Analytics|Mobile Commerce|Personalization,91061.0,POL,1,1,0,16486,16486,0
Crowdfunding|Services|Social Fundraising,187524.0,BEL,1,1,0,16392,16392,0
Analytics|Consumers,9803.0,CAN,1,1,0,15340,15340,0
Engineering Firms|Enterprise Software|Optimization|Testing,1800000.0,USA,1,9,0,15981,15981,1
Medical|Medical Devices|Startups,68312.0,LVA,1,1,0,16251,16251,0
Digital Rights Management|Independent Music Labels|Music Services|Technology,116000000.0,USA,3,6,2582,13910,16492,0
E-Commerce|News|Textbooks,78812455.0,CAN,3,5,449,14593,15042,1
Facebook Applications|Game|Games|iPhone|Mobile|Social Media,14747010.0,FRA,2,6,1485,15090,16575,0
Communities,18000000.0,USA,2,4,683,11540,12223,0
Messaging|Mobile,15000000.0,USA,2,4,974,13057,14031,0
Cloud Computing|PaaS|Software|Web Development|Web Hosting,21500000.0,USA,4,13,1432,15218,16650,0
Hospitality,40000.0,CHL,1,1,0,15324,15324,0
Enterprise Software|SaaS|Search|Speech Recognition|Video,1335000.0,USA,2,4,365,15675,16040,0
Hardware + Software,21000.0,USA,2,1,385,15610,15995,0
Finance,1000000.0,CAN,1,5,0,16583,16583,0
Social Media,3000000.0,USA,1,22,0,15068,15068,0
Bitcoin,25000.0,NLD,1,1,0,16130,16130,0
Delivery|Logistics|Service Providers,177372.0,ESP,1,1,0,16445,16445,0
Hospitality,476883.0,GBR,2,2,2,16160,16162,0
Education,280000.0,FRA,1,6,0,16686,16686,0
Mobile|Services|Technology,262476.371394899,ITA,2,3,126,16258,16384,0
Biotechnology,146000000.0,USA,6,12,2057,14091,16148,0
Design|Electronics|Manufacturing|Technology,3500000.0,USA,1,3,0,15845,15845,0
Semiconductors,7000000.0,USA,1,1,0,13518,13518,0
Advertising|Analytics|Media,97000000.0,IND,5,18,2123,13879,16002,0
Apps|Education|Kids|Publishing,332399.0,GBR,1,1,0,16511,16511,0
Credit|Curated Web,4250000.0,AUT,4,11,639,15518,16157,0
Software,6000000.0,USA,1,1,0,16604,16604,0
Analytics|Business Intelligence|Market Research|SaaS,514668.489931579,ESP,2,4,450,16266,16716,0
Big Data|CRM|Enterprise Search|Enterprise Software|Search|Web Development,500000.0,USA,1,1,0,15020,15020,0
Health Care|Medical|Therapeutics,73657688.0,USA,7,10,1948,14732,16680,0
Clean Technology,106800000.0,USA,4,19,2078,12593,14671,0
Software,2000000.0,USA,1,3,0,13335,13335,1
News,4215900.0,FRA,1,1,0,14455,14455,0
Consumer Electronics,30000.0,CAN,1,1,0,16495,16495,0
Developer Tools|Internet of Things|Telecommunications,1300000.0,USA,1,7,0,16485,16485,0
E-Commerce|Internet|Shopping,78500000.0,NGA,4,7,1011,15340,16351,0
Games,19000000.0,USA,4,9,2315,13573,15888,1
Games|Telecommunications,6800000.0,CHN,1,1,0,14294,14294,1
Apps,155000.0,IND,2,3,114,16102,16216,0
Logistics|SaaS,1300000.0,GBR,1,3,0,16735,16735,0
Indoor Positioning|Internet of Things|Location Based Services|Mobile|Retail Technology|Sensors,2250000.0,POL,2,1,321,15958,16279,0
Advertising|Analytics|Big Data,36140000.0,USA,5,12,2581,13330,15911,1
Advertising|Apps|Brand Marketing|Facebook Applications|Marketing Automation|Mobile|SaaS|Sales and Marketing|Social CRM|Social Media|Social Media Advertising|Social Media Marketing|Social Media Platforms|Software,833549.0,FRA,1,2,0,16148,16148,0
Enterprise Software,36393131.0,USA,5,11,3538,11988,15526,0
Internet,5000000.0,USA,1,1,0,16567,16567,0
Manufacturing,48799840.0,USA,1,1,0,14454,14454,0
Engineering Firms|Hardware + Software|Mechanical Solutions|Sensors,2000000.0,DEU,1,2,0,16526,16526,0
Android|Application Platforms|App Marketing|Banking|Brand Marketing|CRM|Enterprise Application|Enterprise Software|Field Support Services|Finance|Financial Services|Health Care|Hospitality|iOS|Manufacturing|Media|Mobile|Mobile Commerce|Mobility|Retail|Sales and Marketing|Software|Travel,103400000.0,USA,6,10,1575,14992,16567,0
Education|Employment,7000000.0,USA,4,8,911,13970,14881,0
Games,1000000.0,CHN,1,1,0,14761,14761,0
Curated Web,52000000.0,CHN,4,14,919,13569,14488,0
Software,6500000.0,USA,1,3,0,13829,13829,0
Security,37669746.0,USA,9,15,4195,12053,16248,0
Mobile,2500000.0,USA,1,4,0,15686,15686,0
Enterprise Software|Financial Services|Information Technology|Mobile Payments|Payments|Social Entrepreneurship|Telecommunications,5859922.0,USA,5,4,1881,14841,16722,0
Bitcoin|Finance,3516136.0,KOR,3,16,389,15918,16307,0
Electronics,1500000.0,USA,1,2,0,16616,16616,0
Biotechnology,21055000.0,USA,3,2,3010,13692,16702,0
New Product Development|Product Design|Sales and Marketing,300000.0,IND,1,1,0,16700,16700,0
Curated Web,11217240.0,USA,3,1,761,14826,15587,0
Education,12570000.0,USA,2,12,413,16051,16464,0
Biotechnology,3000000.0,USA,1,1,0,13348,13348,1
Curated Web,55237600.0,USA,5,11,1438,13088,14526,1
Biotechnology,319000000.0,USA,1,5,0,14703,14703,0
Energy,300000000.0,USA,1,2,0,12460,12460,1
Clean Technology,8000000.0,IND,1,2,0,14193,14193,0
Clean Technology,38690547.0,CHN,4,11,1954,12599,14553,1
Search,5000000.0,CHN,1,1,0,13422,13422,0
E-Commerce,368000000.0,CHN,5,10,1756,14610,16366,0
Advertising|Coupons|Mobile|Mobile Coupons|Sales and Marketing,7250000.0,USA,3,7,600,15287,15887,0
Credit Cards|E-Commerce|Online Shopping|Payments,1600000.0,USA,1,2,0,15796,15796,0
Semiconductors,76500100.0,USA,6,36,2610,13097,15707,1
Angels|Pre Seed|Startups|Venture Capital,336269.0,BGR,6,3,1245,15231,16476,0
Collaborative Consumption|Hospitality|Local Based Services|Online Travel|Travel|Vacation Rentals,500000.0,KOR,1,1,0,15796,15796,0
Bio-Pharm|Pharmaceuticals|Services,27000.0,USA,2,1,36,16538,16574,0
Audio|Video Streaming,2.0,USA,1,1,0,16701,16701,0
Clean Technology,40000.0,DEU,1,1,0,15205,15205,0
Apps|Hardware + Software|Media|Social Media|Subscription Businesses,70000.0,USA,2,3,188,16129,16317,0
Cloud Computing|Government Innovation|Governments|SaaS|Services,192151.572088518,BGR,3,3,365,16191,16556,0
Biotechnology|Health Diagnostics,5700000.0,NLD,2,4,74,14566,14640,1
Analytics|Banking|Big Data|Finance|FinTech|SaaS,355000000.0,DEU,9,29,1303,15403,16706,0
Finance|FinTech,4500000.0,USA,1,1,0,15048,15048,0
Entertainment,50000.0,TUR,1,1,0,15783,15783,0
Android|EdTech|Education|iOS|Kids|Mobile|Toys,78461.0,CAN,2,1,300,15922,16222,0
Hardware + Software,789000.0,DEU,1,1,0,13579,13579,0
Apps|Art|Entertainment|Games|Mobile,15000.0,USA,1,1,0,15038,15038,0
Curated Web,9650000.0,USA,2,2,1492,13313,14805,1
Biotechnology,30000000.0,IND,1,1,0,14736,14736,0
Curated Web,1000000.0,USA,1,1,0,13493,13493,0
Finance,15000000.0,USA,2,5,1100,14822,15922,0
Consumer Electronics|Hardware + Software,2627940.0,ESP,2,2,2155,13886,16041,0
Analytics|Mobile Games|Software|Sports,29159330.0,USA,7,7,2087,14549,16636,0
Communities|Crowdsourcing|Delivery,25000.0,USA,1,2,0,15273,15273,0
Search,6100000.0,USA,1,4,0,13299,13299,1
Sports,6500000.0,USA,2,1,381,14964,15345,0
Ad Targeting|Advertising Platforms|Analytics|Big Data|Big Data Analytics|Brand Marketing|Digital Media|Internet Marketing,50000000.0,USA,3,8,1502,14730,16232,0
Software,22470000.0,USA,3,6,2650,12293,14943,0
Optical Communications|Services|Systems,23000000.0,USA,2,6,1123,11661,12784,0
Manufacturing,3000000.0,USA,1,1,0,14867,14867,0
Clean Technology,97430000.0,IND,1,3,0,14046,14046,0
Design|Interface Design|Web Design,10000.0,JPN,1,1,0,16020,16020,0
Computers|Security,100000.0,USA,1,1,0,14903,14903,0
Enterprise Software|Risk Management,34965544.0,USA,4,5,2349,13535,15884,1
Manufacturing,67496338.0,CHN,2,1,183,14396,14579,0
Games,2460000.0,FRA,1,1,0,14748,14748,0
Education|Mobile|Professional Services,30000.0,CAN,1,1,0,16495,16495,0
Photography|Video Streaming,40000000.0,CHN,3,7,1828,12219,14047,1
Public Transportation|Transportation,950000000.0,CHN,3,6,471,15979,16450,1
EdTech|Education,5000000.0,CHN,1,2,0,16169,16169,0
Software,1000000.0,CHN,1,1,0,16040,16040,0
Mobile|Mobile Payments,16700000.0,USA,6,6,1156,15034,16190,0
Android|Games|iPad|Kids|Mobile,50000.0,TUR,1,1,0,15431,15431,0
Software,8000000.0,USA,1,3,0,12424,12424,0
Finance|Startups,1340300.0,GBR,2,10,490,13879,14369,0
Finance|Finance Technology|FinTech|Personal Finance,4088161.07228916,MEX,7,11,837,15522,16359,0
Advertising|Apps|Augmented Reality|Mobile,240629.0,GBR,1,1,0,15065,15065,0
Marketplaces|Mobile|Pets|Veterinary,1500000.0,USA,1,1,0,16718,16718,0
Education|Mobile,290000.0,USA,2,4,220,15746,15966,0
Apps,1354937.0,FRA,1,1,0,16694,16694,0
Credit|Finance|Financial Services,1300000.0,MEX,1,6,0,16321,16321,0
Music,15881418.0,CHN,2,2,214,15400,15614,0
Career Planning|Startups|Travel,400000.0,GBR,1,3,0,14730,14730,1
Health and Wellness|Mobile,266627.0,ESP,1,1,0,15869,15869,0
Curated Web,25000.0,USA,1,1,0,14754,14754,1
Analytics|Big Data|Business Services|SaaS,2000000.0,USA,2,1,881,15737,16618,0
Health Care|Nutrition|Startups,350000.0,USA,1,4,0,16248,16248,0
Internet Marketing,1000000.0,IND,1,2,0,16717,16717,0
Advertising|Blogging Platforms|Coupons|Discounts|E-Commerce|Social Media,873720.0,USA,3,2,801,15201,16002,0
Mobile,20425630.0,USA,2,4,402,15607,16009,0
Consumer Goods|Consumers|Pets,264713.0,KOR,1,1,0,15576,15576,0
E-Commerce|Education|High Schools,168242.0,ITA,2,2,440,15706,16146,0
E-Commerce,89615.0,PER,2,3,304,15645,15949,0
Games,7606490.0,CHN,1,3,0,15034,15034,0
Travel,40000.0,CHL,1,1,0,15440,15440,0
E-Commerce|Fashion|Flash Sales|Online Shopping|Shopping,119600000.0,RUS,5,18,2489,13149,15638,0
Coupons|Curated Web|Discounts,867000.0,RUS,6,5,1063,14883,15946,0
Nonprofits,5100000.0,USA,1,1,0,15974,15974,0
Health and Wellness,1500000.0,USA,1,1,0,16471,16471,0
Bio-Pharm|Health and Wellness|Medical|Pharmaceuticals,60000000.0,USA,1,4,0,16506,16506,0
iPhone|Mobile|Software|Technology,275000.0,USA,1,2,0,14938,14938,0
Blogging Platforms|Curated Web|Publishing|Sales and Marketing|SEO,342000.0,USA,5,1,106,15604,15710,0
Health and Wellness,5800000.0,USA,2,10,305,15975,16280,0
Internet|Leisure|Services,4700000.0,USA,1,2,0,16587,16587,0
Biotechnology,30105774.8181149,CHE,4,17,3966,12784,16750,0
Finance Technology|Software,26550000.0,USA,6,6,2909,13149,16058,0
Business Services|Productivity Software|Software,145000.0,USA,2,1,13,16283,16296,0
Music,5500000.0,CHN,2,2,547,13453,14000,0
Image Recognition|Search|Visual Search,1955000.0,USA,5,10,427,15187,15614,0
Manufacturing,160000.0,USA,1,1,0,15576,15576,0
Contact Management|Messaging|Startups,3344760.0,FRA,3,7,2198,14335,16533,0
E-Commerce|Marketplaces|Product Design|Retail,650000.0,USA,1,1,0,16602,16602,0
Mobile|Mobility|Software,139000.0,ARG,3,1,761,15400,16161,0
Finance|Shipping|Small and Medium Businesses|Software|Trading,1233133.0,GBR,2,7,280,16034,16314,0
Advertising|Consumer Electronics|Entertainment|Gamification|Mobile|Television,5000000.0,USA,2,3,472,15247,15719,0
Analytics|Real Estate|Rental Housing,60000.0,USA,2,3,215,15225,15440,0
Curated Web|Gamification|Media,57000.0,CHN,1,8,0,15154,15154,0
Mobile|Mobile Software Tools|Software|Television,8143000.0,USA,3,3,428,15579,16007,0
Mobile,25000.0,USA,1,1,0,15400,15400,0
Content|Mobile|Search|SMS,2000000.0,USA,2,2,369,13589,13958,0
Analytics|Data Mining|Software,8000000.0,USA,2,6,2080,12696,14776,1
Crowdfunding|FinTech|Venture Capital,150000.0,USA,2,8,114,16435,16549,0
Software,11750000.0,USA,1,3,0,12446,12446,0
Game|Games,66225.0,NOR,2,2,426,15431,15857,0
Software,4000000.0,CAN,1,3,0,11611,11611,0
B2B|Consumer Internet|Soccer|Social Commerce|Sports,2012948.0,USA,4,1,735,15258,15993,0
Games|Mobile|Monetization,50000.0,USA,4,2,280,16002,16282,0
Financial Services,15931.0,GBR,1,1,0,16536,16536,0
Biotechnology,2057896.0,USA,2,3,250,14307,14557,0
Health Care|Health Care Information Technology,10000000.0,ISR,1,1,0,15985,15985,1
Semiconductors|Web Design,3200000.0,USA,1,1,0,15999,15999,0
Biotechnology,120400000.0,GBR,3,5,1759,14802,16561,0
Aerospace|Communications Hardware|Hardware + Software|Mobile,82000000.0,USA,3,10,846,15573,16419,0
Artificial Intelligence|Machine Learning|Productivity Software,1099474.0,USA,2,2,303,16327,16630,0
Advertising|Apps|Customer Service|E-Commerce|Software|User Experience Design|Web Development,2281250.0,USA,2,1,65,14481,14546,0
Software,3000000.0,FRA,1,2,0,13151,13151,0
Manufacturing,20000.0,USA,1,1,0,16287,16287,0
Biotechnology,7154375.0,USA,6,7,1394,15358,16752,0
Enterprise Software|Finance|Payments|Risk Management|SaaS,71200000.0,USA,6,14,5086,11446,16532,0
SaaS,4000000.0,JPN,2,12,696,15439,16135,0
Analytics|Big Data|Health Care,3000000.0,USA,1,1,0,16002,16002,0
Analytics|Health Care|Physicians,58250000.0,USA,5,17,1570,15126,16696,0
Games|iPhone|Media|Mobile|Video,23350000.0,USA,5,18,1752,13648,15400,1
Biotechnology|Health Care,98400000.0,USA,4,21,2194,13042,15236,1
Communications Infrastructure|Internet Radio Market|Wireless,2674988.0,FIN,1,2,0,16297,16297,0
Collaboration|Software|Video,1536742.0,USA,2,1,628,14560,15188,0
Consumer Electronics|Cooking,12955.0,EST,1,1,0,16328,16328,0
Messaging,170000000.0,USA,1,1,0,14844,14844,0
Design,430110.0,ITA,1,1,0,14598,14598,0
Fashion|Financial Services|Internet Marketing|Lifestyle|Travel,16500000.0,USA,1,1,0,16141,16141,0
Analytics,4005616.0,USA,3,3,1690,13793,15483,0
Social Media,2270000.0,CHN,2,3,699,14610,15309,0
Curated Web|Services,2200000.0,FRA,2,4,657,15706,16363,0
Enterprise Software,674000.0,FRA,1,1,0,14879,14879,0
Advertising|Information Services|Internet|Portals,50038.0,VEN,1,1,0,15522,15522,0
Beauty|Cosmetics|Cosmetic Surgery|Health Care|Product Development Services,20000000.0,USA,1,2,0,16385,16385,0
Design|Engineering Firms|Technology,482786.0,SGP,1,1,0,15706,15706,0
E-Commerce|Manufacturing,10000000.0,CHN,2,1,305,15095,15400,0
Collaborative Consumption|E-Commerce|Fashion|Marketplaces,1045995.0,ESP,7,8,977,15603,16580,0
Delivery|Hospitality,14284977.0,ESP,4,3,798,15455,16253,1
Pharmaceuticals,16000000.0,IND,1,1,0,16598,16598,0
Consumers,13061910.0,FRA,4,8,1658,14944,16602,0
Health Care,345000.0,USA,2,1,73,16574,16647,0
EdTech|Education|Internet|Mobile|Mobile Devices|Tablets,40000.0,USA,3,2,645,15911,16556,0
Biotechnology,22496000.0,USA,3,9,1274,15286,16560,0
Mobile|Mobile Health,220000.0,USA,2,6,791,15614,16405,0
Apps,100000.0,IND,1,3,0,16610,16610,0
Curated Web|Life Sciences,500000.0,USA,1,2,0,14000,14000,0
Hardware|Life Sciences|Robotics|Software,6200000.0,USA,3,2,1657,14813,16470,0
Biotechnology,35388350.0,USA,4,4,2050,12690,14740,0
Biotechnology,6903050.0,BRA,1,1,0,15505,15505,0
Health Care,4603550.0,FRA,1,3,0,15442,15442,0
Biotechnology,29000000.0,USA,3,3,847,13892,14739,0
Curated Web|Web Tools,1000000.0,ISR,1,8,0,14031,14031,1
Internet,150000.0,IND,1,1,0,16695,16695,0
E-Commerce|Real Estate,155277.0,ESP,1,2,0,15341,15341,0
Software,8000000.0,USA,1,4,0,15993,15993,1
Hardware + Software|Internet of Things,28000.0,USA,1,1,0,16120,16120,0
E-Commerce,40000000.0,CHN,3,2,2132,13970,16102,0
Augmented Reality|Biometrics|Fashion|Hardware + Software,1624998.0,USA,2,1,264,16388,16652,0
Hospitality,14820030.0,FRA,2,4,482,14980,15462,1
Artificial Intelligence|Big Data|Data Mining|E-Commerce,40000.0,BRA,1,1,0,15749,15749,0
3D|Enterprise Software|Games,8341441.0,CAN,3,10,307,15798,16105,1
Apps,20000.0,USA,1,1,0,16269,16269,0
E-Commerce|EdTech|Education|Online Travel|Staffing Firms,25000000.0,CHN,1,2,0,16302,16302,0
Consumer Goods|Creative Industries|Social Innovation,30000000.0,CHN,2,4,140,16161,16301,0
Travel,1000000.0,CHN,1,1,0,16115,16115,0
Career Management|Curated Web|Education|Employment|Events|Guides,400000.0,ARE,1,1,0,15553,15553,0
E-Commerce,2000000.0,CHN,2,1,456,14975,15431,0
Apps,4000000.0,CHN,1,3,0,16707,16707,0
Finance,25000000.0,CHN,3,4,2011,13573,15584,0
Biotechnology,5500000.0,USA,1,1,0,16239,16239,0
Games,1000000.0,HKG,1,1,0,14914,14914,0
Music,44150000.0,USA,4,9,1095,12784,13879,1
Enterprise Software,1238066.0,USA,3,2,763,14400,15163,0
E-Commerce|Parenting,130000000.0,CHN,3,9,582,15918,16500,0
E-Commerce|E-Commerce Platforms|Mobile Commerce,14600000.0,CHN,1,2,0,16297,16297,0
Web Hosting,16000000.0,USA,2,5,532,12521,13053,0
Financial Services|Insurance|Risk Management,5757955.0,GBR,1,1,0,15884,15884,0
Biotechnology,5301059.0,GBR,1,4,0,15712,15712,0
E-Commerce|Fashion,210866000.0,RUS,4,6,514,15584,16098,0
Analytics|Big Data Analytics|Social Media|Social Media Monitoring,1500000.0,HKG,1,1,0,16680,16680,0
Android|Events|iPhone|Location Based Services|Mobile|Mobile Commerce|Social Media|Web Development,11308.0,GBR,1,1,0,15645,15645,0
Apps|Digital Media|Kids|Software,500000.0,SAU,1,1,0,16010,16010,0
Commercial Real Estate|Internet|Marketplaces|Real Estate|Technology,25000000.0,DEU,2,3,315,16161,16476,0
Crowdsourcing|Curated Web,11350000.0,JPN,2,8,560,15846,16406,0
Security,24600000.0,USA,4,13,1689,11787,13476,1
Technology,546402.0,GBR,1,6,0,16650,16650,0
Crowdfunding|Finance|Finance Technology|FinTech|Peer-to-Peer|Real Estate,3152596.0,GBR,7,10,468,16087,16555,0
Advertising|Lead Generation|Web Design,260000.0,POL,2,2,150,15737,15887,0
Real Estate|SaaS|Software,750000.0,USA,1,1,0,16520,16520,0
Consulting|Environmental Innovation|Geospatial|Project Management,17000000.0,USA,1,1,0,16062,16062,0
Mobile|Mobile Devices|Mobile Software Tools,1850000.0,USA,1,2,0,16262,16262,0
Information Technology|Productivity Software|Services,12000000.0,USA,2,12,321,11346,11667,1
Business Productivity|CRM|Logistics|Transportation,7217716.0,USA,2,2,469,16087,16556,0
Software,3999396.0,CHN,3,3,2646,11354,14000,0
Consumer Goods|Cooking|Internet,110000.0,IND,2,1,111,15951,16062,0
Messaging|Mobile Software Tools|Public Relations|Startups,22000000.0,USA,1,3,0,13555,13555,0
Advertising,10000000.0,CHN,1,1,0,14944,14944,0
Curated Web|Language Learning|Lifestyle,10000.0,CZE,1,1,0,15461,15461,0
Enterprise Software,1600000.0,JPN,1,5,0,15765,15765,0
EdTech|Education|Language Learning,40000.0,CHN,1,1,0,14942,14942,0
Software,4000000.0,USA,1,3,0,12698,12698,1
Fitness|Health and Wellness,1200000.0,USA,1,2,0,16344,16344,0
Alternative Medicine|Clinical Trials|Therapeutics,1030000.0,USA,2,2,182,16310,16492,0
CRM|Productivity Software|Small and Medium Businesses|Software,250000.0,USA,2,1,203,15993,16196,0
Biotechnology,11121112.0,NLD,2,2,539,15672,16211,1
Hardware + Software,16340966.0,USA,6,3,1845,14868,16713,0
Biotechnology,16556606.0,USA,4,1,1389,14449,15838,1
Business Intelligence|Event Management|Hospitality|Hotels|Meeting Software|Procurement|Software,10000000.0,USA,1,1,0,14581,14581,0
Curated Web,1400000.0,GBR,1,9,0,15223,15223,1
Internet|PaaS|Services|Software,156850.0,VEN,2,2,273,15706,15979,0
Clean Technology,186300000.0,USA,4,12,2784,13628,16412,0
Sports,500000.0,USA,2,1,455,16008,16463,0
Manufacturing,4400000.0,USA,1,1,0,15533,15533,0
Hardware + Software,1000000.0,ISR,1,2,0,16022,16022,0
Computers|Services|Software,81462.0,BRA,1,1,0,16344,16344,0
Clean Technology|Design|Innovation Management,40000000.0,USA,1,9,0,11253,11253,0
Artists Globally|Music|Social Network Media,780000.0,ARG,1,1,0,14857,14857,0
Biotechnology,1500000.0,ISR,1,1,0,16162,16162,0
Communities|Shared Services|Social Network Media,40000.0,CHN,1,1,0,15562,15562,0
Energy|Gas|Oil,130000000.0,USA,1,2,0,16219,16219,0
News,21000000.0,CHN,2,3,1522,13757,15279,0
E-Commerce,75000.0,USA,1,1,0,14290,14290,0
Clean Technology,15000000.0,CAN,1,2,0,16153,16153,0
Hardware + Software|Health and Wellness,4100000.0,USA,5,9,1227,15118,16345,0
Financial Services|Location Based Services|Loyalty Programs|Mobile,2410000.0,USA,2,5,552,15675,16227,0
Email|Internet Marketing|Networking|Reviews and Recommendations|Sales and Marketing|Software,219165.0,GBR,1,5,0,14245,14245,0
Software,3000000.0,ISR,1,1,0,13913,13913,0
E-Commerce|Fashion|Marketplaces,98104.0,PER,2,2,669,15645,16314,0
Design,700000.0,USA,2,5,231,14944,15175,1
Manufacturing,26615501.0,USA,8,5,1616,14579,16195,0
Manufacturing,416694.0,GBR,1,2,0,16103,16103,0
Telecommunications,21000000.0,USA,1,7,0,11733,11733,0
Biotechnology|Health Diagnostics,5000000.0,USA,1,2,0,15216,15216,0
E-Commerce,165000000.0,CHN,3,11,334,14700,15034,0
Social Media|Startups,75000.0,USA,1,2,0,15492,15492,0
Photography|Private Social Networking,1250000.0,USA,1,4,0,15584,15584,1
Apps|Crowdsourcing|Gps|Wireless,750120.0,USA,1,2,0,16437,16437,0
Music|Social Media,5000000.0,GBR,1,1,0,13269,13269,1
Social Media,2100000.0,USA,1,16,0,16170,16170,0
Internet|Services|Telecommunications,28000000.0,USA,1,1,0,12558,12558,0
Advertising,1900000.0,USA,2,6,5,16436,16441,0
Travel & Tourism,3380000.0,USA,1,1,0,12374,12374,0
News,617646.0,GBR,1,1,0,15347,15347,1
IT and Cybersecurity|Network Security|Security,23700000.0,USA,5,8,497,15806,16303,0
B2B|Business Travelers|Enterprise Software,475000.0,MEX,3,2,461,15579,16040,0
Android|Apps|Internet|Messaging|Mobile|Social Media|Unifed Communications|User Experience Design,49890000.0,USA,10,15,3648,11645,15293,1
Advertising|Advertising Networks|Geospatial|Internet|Maps,3800000.0,CAN,2,3,624,13818,14442,0
Enterprises|Enterprise Software|News|Video,2550000.0,USA,2,1,98,15638,15736,0
Angels|Startups|Venture Capital,40000.0,CHL,1,1,0,15659,15659,0
Education,1100000.0,USA,1,2,0,15313,15313,1
Content Discovery|Machine Learning,415485.0,DEU,2,1,216,16191,16407,0
Business Productivity|Enterprise Application|Mobile|Search|Software|Web Browsers,1117000.0,USA,3,1,574,15899,16473,0
Clean Technology,3894250.0,DEU,1,1,0,13951,13951,0
Education,1250000.0,USA,1,1,0,14700,14700,0
Social Media,40000.0,USA,1,1,0,15608,15608,0
Bitcoin,25000.0,ARG,1,1,0,15949,15949,0
Comics,40000.0,CHL,1,1,0,16222,16222,0
Software,40000.0,ARG,1,1,0,15408,15408,0
Analytics|Content|Service Providers,10000.0,USA,1,1,0,16116,16116,0
Construction|iPad|Software,1500000.0,USA,3,6,1644,14337,15981,1
Software,2000000.0,SGP,1,2,0,16465,16465,0
Analytics|B2B|CRM|Predictive Analytics,64700000.0,USA,4,9,2570,14026,16596,0
Web Hosting,2572600.0,USA,3,1,1141,15027,16168,0
Semiconductors,195500000.0,CHN,5,11,3013,13239,16252,0
Software,295000.0,GBR,1,1,0,13675,13675,0
Computers|Enterprise Software|Mobile|Personalization|Tablets|Television|Video|Video on Demand|Video Streaming,15000000.0,ISR,2,5,911,15006,15917,0
Crowdfunding|Finance|Venture Capital,500000.0,USA,1,1,0,16467,16467,0
Advertising|Email Marketing|Startups,960000.0,USA,2,11,447,15111,15558,1
Developer Tools|Optimization|SaaS|Software|Testing,2600000.0,USA,1,1,0,16590,16590,0
News,70000.0,USA,2,2,252,15362,15614,1
Cyber Security|Information Security|Internet of Things|Mobile Security|Security,4000000.0,USA,3,12,717,15681,16398,0
Apps|App Stores|Education|Games|iPad,1117000.0,USA,4,2,237,15069,15306,1
Enterprise Software,26000000.0,USA,2,1,1303,15363,16666,0
Enterprise Software,800000.0,USA,1,8,0,15286,15286,1
Consulting,25000.0,USA,1,1,0,15283,15283,0
Finance,25000.0,USA,1,1,0,15175,15175,0
Analytics|E-Commerce|Payments|SaaS|Software,1142500.0,USA,3,6,688,15595,16283,0
Consumers,5943536.0,GBR,2,3,333,16191,16524,0
Consumer Electronics|Hardware|Hardware + Software,212550.0,ITA,1,1,0,15188,15188,0
Biotechnology,7094556.0,FIN,1,2,0,15587,15587,0
Biotechnology,20000000.0,USA,1,1,0,14889,14889,0
3D Printing|E-Commerce|Fashion,20000.0,GBR,1,1,0,16161,16161,0
Data Security|Infrastructure|Service Providers,80000000.0,USA,2,5,956,11351,12307,0
Design|Marketplaces,25500000.0,USA,3,12,378,16302,16680,0
Clean Technology,9000000.0,USA,1,1,0,13999,13999,0
Pharmaceuticals,90000000.0,IND,1,1,0,16373,16373,0
Enterprise Software|Finance|SaaS|Supply Chain Management,8500000.0,USA,2,3,1873,14428,16301,0
Big Data Analytics|Business Intelligence|Business Services|Enterprise Software,10000000.0,USA,1,1,0,10893,10893,1
Finance,428000.0,DEU,1,1,0,13807,13807,0
Employment|Finance|Identity|Internet|Legal|Licensing|Startups|Taxis|Technology|Venture Capital,1600000.0,USA,2,14,351,14958,15309,1
Consulting,287048.0,GBR,1,1,0,16128,16128,0
Law Enforcement|Lead Generation|Legal|Marketplaces|Video Chat,790000.0,USA,2,8,361,15647,16008,0
B2B|Internet|Law Enforcement|Legal|Marketplaces|Peer-to-Peer|Services|Startups|Technology,200000.0,USA,3,2,375,15614,15989,0
Service Industries|Services,1900000.0,USA,1,20,0,16386,16386,0
Bridging Online and Offline|Collaborative Consumption|Local Based Services|Marketplaces,7225500.0,USA,4,7,455,16133,16588,0
Legal|Project Management|SaaS,1350000.0,USA,2,5,309,15763,16072,0
Cloud Computing|E-Commerce|Legal|SaaS,2100000.0,AUS,3,3,997,15737,16734,0
Security,11400000.0,USA,3,1,211,16049,16260,0
Browser Extensions|Mobile,17074000.0,NLD,2,3,278,14655,14933,1
Infrastructure|Messaging,22000000.0,USA,3,23,236,15961,16197,0
Cloud Security|Enterprise Software,19900000.0,USA,2,4,830,13447,14277,1
News,72000000.0,USA,2,4,448,16142,16590,0
Cloud Computing|Networking|Software|Virtualization|Web Hosting,200000.0,CAN,1,2,0,14556,14556,1
Web Hosting,51829000.0,USA,3,2,2164,13949,16113,1
Apps|Design|Publishing,905693.0,NLD,3,4,1302,14722,16024,0
Curated Web|Design|Enterprise Software|Software,535000.0,USA,1,3,0,15569,15569,0
E-Commerce,710367240.0,MYS,6,16,748,15655,16403,0
E-Commerce,40000000.0,IDN,1,2,0,15655,15655,0
E-Commerce|Mobile|Shopping|Tablets,100000000.0,VNM,1,3,0,15876,15876,0
Biotechnology,100000.0,USA,1,1,0,14823,14823,0
Apps|Local Based Services|Local Businesses,500000.0,IND,1,4,0,16647,16647,0
Security,10000000.0,CHN,1,1,0,16040,16040,0
Mobile,3120000.0,FRA,1,4,0,14048,14048,0
Health and Wellness|Health Care,34722866.0,USA,2,4,1699,13769,15468,1
Babies|Communities|Kids|Mobile|Service Providers,286241.0,ITA,3,3,480,15806,16286,0
Clean Technology,15530000.0,FRA,1,3,0,14006,14006,0
E-Commerce|Fashion,27500000.0,USA,3,33,812,15946,16758,0
Biotechnology,20000000.0,USA,2,3,576,13822,14398,0
Automotive|CRM|Enterprise Software|Mobile|Telecommunications|VoIP,6203334.0,FIN,1,2,0,16493,16493,0
Networking|Web Hosting,2796478.0,CHN,1,1,0,15187,15187,0
Big Data|Lead Generation|Recruiting|Sales and Marketing,550000.0,USA,2,2,321,16378,16699,0
Enterprise Software,9700000.0,USA,3,5,646,15544,16190,0
Employment|Human Resources|Recruiting,1950000.0,JPN,2,4,766,15706,16472,0
Software,38000000.0,USA,3,5,629,15974,16603,0
Advertising,12500000.0,USA,4,7,795,13202,13997,0
B2B|Internet|Mobile|Real Estate|Video Streaming,125000.0,USA,1,1,0,16405,16405,0
Enterprise Software|Social Media Marketing,1487485.0,CAN,3,10,942,15660,16602,0
Enterprise Software|Lead Generation|Predictive Analytics,35000000.0,USA,4,8,2747,13892,16639,0
Email|Email Marketing|Messaging|Personal Health,250000.0,USA,1,3,0,15187,15187,0
Analytics|Apps|Curated Web|E-Commerce|Finance|FinTech|Offline Businesses|Point of Sale|Restaurants|Retail|Reviews and Recommendations|Social Media,26000000.0,USA,2,1,638,15340,15978,0
Finance,125000000.0,USA,2,2,0,15301,15301,0
Cloud Computing|E-Commerce|Media|Mobile|Music|Social Media,20385.0,GBR,1,1,0,16040,16040,0
Energy|GreenTech|Solar,75000000.0,USA,1,1,0,16477,16477,0
Design,40000.0,PRT,1,1,0,15138,15138,0
Consumers|Health and Wellness|Health Care|Software,4000000.0,CAN,1,3,0,16386,16386,0
Enterprise Software|Entrepreneur|Health and Wellness|Startups,200000.0,USA,1,1,0,15614,15614,0
Education,40000.0,CHL,1,1,0,15637,15637,0
Software,5100000.0,USA,1,4,0,16148,16148,0
Collaboration|Enterprise Software|IT Management|SaaS,2459722.05140819,DEU,1,2,0,16498,16498,0
Collaboration|Enterprise Software|Health and Wellness|Project Management|SaaS|Software|Startups,24600000.0,USA,3,2,702,15929,16631,0
Business Development|CRM|Enterprises|Health and Wellness|Mobile|SaaS,482431.0,CAN,1,1,0,16484,16484,0
Analytics|Apps|Marketing Automation|Mobile|Mobile Commerce|Optimization,17225000.0,USA,3,11,903,15749,16652,0
Hospitals,3000000.0,USA,1,1,0,16728,16728,0
Mobile|Photography|Social Games|Social Media,25000.0,USA,1,1,0,15217,15217,0
Internet|Marketplaces|Social Network Media|Sports,68497.0,BGR,2,2,151,16071,16222,0
Mobile|Transportation,100000.0,USA,1,5,0,15857,15857,0
Biotechnology,1010000.0,CAN,1,3,0,14693,14693,0
Augmented Reality|Embedded Hardware and Software|Hardware + Software,44050000.0,USA,5,10,1581,15135,16716,0
Browser Extensions|Mobile|Search|Software|Wireless,5390000.0,USA,6,6,937,15309,16246,0
Advertising|Business Intelligence,30000000.0,USA,1,1,0,14139,14139,0
Crowdfunding|Financial Services|Startups,286700.0,NLD,3,1,540,15953,16493,0
Apps|Mobile|Security|Wireless,50000.0,AUS,2,1,383,15550,15933,0
EdTech|Education,2000000.0,USA,1,1,0,13151,13151,1
Apps|EdTech|Education|iPad|Kids|Mobile,3440000.0,USA,1,9,0,16029,16029,0
Education,2875000.0,USA,2,10,289,14816,15105,0
Computer Vision|EdTech|Education|Tutoring,2525000.0,USA,3,1,413,15201,15614,0
Education,610547.0,CAN,3,2,610,14761,15371,1
Education|Tutoring|VoIP,41347.0,USA,1,1,0,16071,16071,0
All Students|E-Books|Education,300000.0,USA,2,3,304,16220,16524,0
EdTech|Education,400000.0,IND,1,2,0,15854,15854,0
EdTech|Education,16000.0,USA,1,1,0,15737,15737,0
Software,6000000.0,USA,1,1,0,15050,15050,0
EdTech|Education|Finance|Incubators|Startups,1135000.0,USA,1,1,0,16449,16449,0
Analytics|Big Data|Education,150000.0,USA,2,4,343,15749,16092,0
Analytics|Big Data|EdTech|Education|Predictive Analytics,4700000.0,USA,2,10,385,15818,16203,0
Education,1000000.0,USA,1,1,0,15652,15652,0
E-Books|EdTech|Education,820000.0,USA,2,7,371,16275,16646,0
Curated Web|Recruiting|Training,9900000.0,USA,2,7,1126,15568,16694,0
EdTech|Education|Software|Systems,707630.0,IRL,2,2,716,15371,16087,0
Finance|Financial Services,72130000.0,USA,5,24,1688,14487,16175,1
EdTech|Education|Technology,22400000.0,USA,3,13,1266,15428,16694,0
Real Estate,525000.0,USA,2,2,80,16273,16353,0
Software,25000000.0,USA,2,2,453,16191,16644,0
E-Books|Social Network Media,40000.0,CHL,1,1,0,16222,16222,0
Colleges|EdTech|Education|Technology,1000000.0,USA,1,2,0,14975,14975,0
Education,4062948.0,DEU,4,9,2268,14197,16465,0
Biotechnology,20288126.0,GBR,2,5,569,13192,13761,0
Application Platforms|Chemicals|Technology,67935.0,LVA,1,1,0,16087,16087,0
Electronics|Lighting|Technology,1948937.0,GBR,1,1,0,16343,16343,0
Manufacturing,13500000.0,CAN,2,3,992,15147,16139,0
Mens Specific|Retail|Shopping,4500000.0,USA,2,1,112,16287,16399,0
Hardware + Software,16000000.0,CAN,3,8,1747,14645,16392,0
Semiconductors|Technology,11000000.0,USA,1,2,0,13789,13789,0
Bitcoin|Information Security,1482968.0,FRA,1,6,0,16485,16485,0
Bitcoin|Finance Technology|FinTech|Virtual Currency,1500000.0,USA,2,8,139,16113,16252,0
Internet,1475482.0,SWE,1,2,0,11990,11990,0
Startups,37000000.0,USA,1,7,0,16331,16331,0
Design|E-Commerce,9000000.0,USA,1,1,0,16618,16618,0
Curated Web|Entertainment|Gift Card|Private Social Networking|Social Commerce|Social Network Media,7850000.0,FRA,3,11,759,14641,15400,1
Innovation Management,1102363.0,KOR,1,3,0,15750,15750,0
Brand Marketing|Cause Marketing|Contests|Internet Marketing|Photography|Social Activists|Social Media|Social Media Marketing,363925.0,ITA,3,2,325,15949,16274,0
Software,63500000.0,USA,4,31,1534,11498,13032,1
Android|Games|iPhone|Mobile|Mobile Games,25000.0,USA,1,1,0,14248,14248,0
Analytics|Business Analytics|Business Intelligence,500000.0,USA,2,4,47,14883,14930,1
Analytics|Legal|Services,369794.0,IRL,3,3,393,16102,16495,0
Apps|Education|Law Enforcement|Legal|Services|Software,20000.0,USA,2,1,73,15531,15604,0
Legal,40000.0,ARG,1,1,0,15639,15639,0
Legal,900000.0,USA,1,2,0,15064,15064,0
Legal,25000.0,USA,1,1,0,15765,15765,0
Legal,660000.0,NLD,1,1,0,16681,16681,0
Business Intelligence|Legal,20275.0,ITA,1,1,0,15979,15979,0
Legal,900000.0,USA,1,2,0,15922,15922,0
Legal,266000000.0,USA,3,4,2484,13593,16077,0
Entertainment,1000000.0,USA,1,1,0,12382,12382,0
Investment Management,11000000.0,CHN,1,1,0,16689,16689,0
Semiconductors,46370000.0,USA,5,9,3087,11584,14671,0
Advertising,47801705.0,USA,6,6,1810,14505,16315,0
Entertainment|Film Production|Games,1008000000.0,USA,4,6,1276,15070,16346,0
Messaging,4000000.0,USA,2,4,1020,13573,14593,0
Finance,25000.0,USA,1,1,0,16185,16185,0
Advertising,6550000.0,USA,4,4,1220,14579,15799,1
Wireless,14000000.0,USA,2,5,412,11975,12387,1
Analytics|Sports,60000.0,USA,2,1,453,16146,16599,0
Advanced Materials|Clean Technology|Specialty Chemicals,88000000.0,USA,6,13,2773,13543,16316,0
E-Commerce,50000000.0,CHN,1,2,0,15279,15279,0
Consumer Electronics,25000000.0,USA,1,1,0,16126,16126,0
Hardware + Software,375000.0,USA,1,1,0,15176,15176,0
Pets,68.0,DEU,2,4,289,16161,16450,0
Real Estate,17100000.0,USA,2,6,1142,13781,14923,1
Maps|Navigation|Software|Travel,5900000.0,USA,3,1,0,13514,13514,0
iPad|News,12300000.0,FRA,3,2,682,14975,15657,0
E-Commerce,4000000.0,BRA,2,3,299,15694,15993,1
Mobile|Shopping,8000000.0,USA,1,5,0,15503,15503,1
Apps,5800000.0,USA,1,1,0,16651,16651,0
Entertainment|Games|Mobile|Portals,2550000.0,ESP,1,1,0,13416,13416,0
Curated Web|E-Commerce|SaaS|Software,15000.0,USA,1,1,0,15107,15107,0
Curated Web,893000.0,USA,3,4,583,14975,15558,0
P2P Money Transfer,3923692.0,GBR,1,4,0,16421,16421,0
Finance|Finance Technology|Financial Services|FinTech|SaaS,1000000.0,USA,2,1,441,15153,15594,0
Credit|Emerging Markets|Finance|FinTech,14000000.0,HKG,3,14,1247,15475,16722,0
Credit|Finance|Finance Technology|FinTech|Personal Finance,392230000.0,USA,13,29,2632,13634,16266,1
Finance|Financial Services|Peer-to-Peer,5303380.0,GBR,1,4,0,16071,16071,0
Real Estate,98000000.0,USA,2,7,208,16309,16517,0
Financial Services,10000000.0,IND,1,4,0,16624,16624,0
Cloud Computing|Finance|Personal Finance,3000000.0,USA,2,2,270,16185,16455,0
Finance,400000.0,UKR,2,1,304,16071,16375,0
Commercial Real Estate|Crowdfunding|Finance|Finance Technology|FinTech|Peer-to-Peer|Real Estate|Real Estate Investors,47142568.0,GBR,2,1,563,16038,16601,0
Finance,33000000.0,USA,4,14,1496,15022,16518,0
Financial Services|Peer-to-Peer,1400000.0,KOR,1,1,0,16542,16542,0
Consumer Lending|Finance|FinTech,31727288.0,USA,7,12,2796,13787,16583,0
Education,288453.0,GBR,1,1,0,16283,16283,0
Collaborative Consumption|Crowdfunding|Finance|Social Fundraising,100000.0,USA,1,1,0,16283,16283,0
Apps|Finance|Mobile|Mobile Payments,2435738.21686922,DEU,4,3,567,15931,16498,0
Finance|FinTech,64000000.0,USA,4,20,738,15450,16188,0
Advertising|E-Commerce|Internet Marketing|Marketplaces|SaaS|Tracking,13259614.0,FRA,3,5,1989,14690,16679,0
Real Estate,30000000.0,USA,1,1,0,16072,16072,1
Health Care,169521818.0,USA,11,6,2021,14427,16448,1
Computer Vision|Hardware + Software,1000000.0,JAM,1,3,0,16525,16525,0
Health Care,4249995.0,USA,4,4,823,15584,16407,0
Consumer Goods|Eyewear|Online Shopping,35900000.0,IND,3,6,1189,15248,16437,0
Hardware + Software,35700000.0,USA,3,8,1366,14644,16010,0
Health Care,22360000.0,USA,1,3,0,14304,14304,1
Apps|Messaging,1500000.0,USA,1,12,0,15979,15979,1
Pharmaceuticals,20376244.0,DEU,1,5,0,16643,16643,0
Biotechnology,2500000.0,USA,2,1,545,14747,15292,0
Advertising,19570000.0,CAN,3,7,607,13577,14184,0
Event Management|Marketplaces|Music|PaaS,938838.0,DEU,2,1,1331,14620,15951,0
Manufacturing,28680536.0,FRA,2,4,2567,13623,16190,0
Software,5000000.0,USA,2,2,567,14004,14571,0
Design|Lifestyle|Manufacturing,1000000.0,USA,1,1,0,16040,16040,0
Bio-Pharm|Medical Devices|Therapeutics,20000000.0,USA,1,4,0,13741,13741,0
Consumer Electronics|EdTech|Education|Hardware + Software|High Schools,1243897.0,DEU,5,3,506,15803,16309,0
Advertising|Loyalty Programs|Service Providers|Services,27400000.0,USA,2,1,1763,13847,15610,0
Corporate Training|Enterprise Software,1100000.0,USA,1,1,0,16407,16407,0
Education,50000.0,USA,1,1,0,15431,15431,0
Mobile|Social Network Media,610000.0,USA,2,2,588,15769,16357,0
Semiconductors|Software,7180000.0,FRA,1,2,0,13188,13188,1
Recycling|Services|Waste Management,2000000.0,IND,1,1,0,16556,16556,0
E-Commerce,84472800.0,CHN,6,13,1340,14000,15340,0
Mobile Commerce,100000000.0,USA,1,1,0,16681,16681,0
Games,100000.0,GHA,1,1,0,14362,14362,0
Digital Media|Mobile|Social Media,165473.0,JPN,2,1,250,16428,16678,0
Parking|Storage,126553.0,ESP,1,2,0,16367,16367,0
Information Technology,3000000.0,SGP,1,1,0,16514,16514,0
E-Commerce|Group Buying,250000.0,USA,2,2,699,15196,15895,0
Advertising,40000.0,CHL,1,1,0,15754,15754,0
Real Estate,196832.0,GBR,1,1,0,16071,16071,0
Mobile,40000.0,CHL,1,1,0,15777,15777,0
Consumer Electronics|E-Commerce,6000000.0,IND,1,3,0,14992,14992,1
Curated Web|Education|Tutoring,655000.0,USA,2,3,749,13514,14263,0
E-Commerce|Interior Design|Online Shopping,52110.0,ESP,1,1,0,15887,15887,0
Hospitality|Promotional|Restaurants|Sales and Marketing,140000.0,CAN,1,1,0,14488,14488,0
Collaborative Consumption|Peer-to-Peer,20000.0,USA,1,1,0,16314,16314,0
Transportation,1300000.0,IND,1,4,0,16651,16651,0
Internet,650000.0,SGP,2,14,524,16203,16727,0
Mobile|Social Media|Social Network Media,1760000.0,USA,4,1,2272,14092,16364,0
Curated Web|Sales and Marketing,3100000.0,USA,2,16,289,15629,15918,1
Entertainment|Photography,105400000.0,CHN,3,5,2243,14092,16335,1
Biotechnology,41000000.0,USA,2,6,381,13444,13825,1
Software,8000000.0,USA,1,3,0,13779,13779,0
Financial Services|Service Providers,1601493.0,USA,1,1,0,16640,16640,0
Internet|Sports|Trading,89063.0,GBR,1,1,0,16202,16202,0
Software,5000000.0,USA,1,4,0,15988,15988,1
Art|E-Commerce|Marketplaces,120000.0,USA,1,1,0,16436,16436,0
Semiconductors,30000000.0,USA,1,4,0,12954,12954,1
Internet|Services|Training,40000.0,CHL,1,1,0,16222,16222,0
Software,4580000.0,GBR,2,3,567,12978,13545,1
CRM|Enterprise Software|Gamification|Sales Automation,9500000.0,USA,5,19,1020,15643,16663,0
Digital Media|Software|Video,8999992.0,USA,3,2,888,15722,16610,0
Enterprise Software|Human Resources|Recruiting|SaaS|Software,12800000.0,USA,3,16,1005,15340,16345,0
Enterprise Software|Networking,6000000.0,USA,1,2,0,12917,12917,1
Finance Technology|FinTech,12500000.0,ISR,1,1,0,15156,15156,0
Biotechnology,19913173.0,GBR,2,4,1,16350,16351,0
Medical Devices,1500000.0,ISR,1,1,0,16538,16538,0
Game Mechanics|Sales and Marketing|Social Games|Social Media|Software,25000.0,USA,1,1,0,14761,14761,0
Mobile,13954716.0,CHN,4,3,1299,15065,16364,0
Biotechnology,475000.0,USA,2,1,335,15664,15999,0
Legal,10023448.0,USA,4,12,819,15007,15826,1
Hardware + Software,60000000.0,USA,1,2,0,12871,12871,1
Software,1090000.0,GBR,1,2,0,14257,14257,0
Content|Internet Marketing|Legal,765527.0,ESP,2,6,37,16078,16115,0
EdTech|Education,2000000.0,USA,1,2,0,12551,12551,1
Biotechnology,244702780.0,USA,4,1,1733,14683,16416,1
Startups,41347.0,GBR,1,1,0,16071,16071,0
Education|Software,120000.0,AUS,2,3,188,15233,15421,0
Enterprise Software,5700000.0,USA,2,8,548,14488,15036,1
Legal,1697976.0,GBR,2,5,290,16451,16741,0
Algorithms|Legal|Search,41004.0,GBR,1,1,0,14672,14672,0
Legal,40000.0,USA,1,1,0,15562,15562,0
Automotive|Legal|Professional Services|Software|Technology,800000.0,USA,1,7,0,16155,16155,0
Audio|Games|Mobile|Music,1708000.0,USA,2,1,289,14313,14602,0
Manufacturing,34500000.0,USA,3,11,2035,13693,15728,0
Mobile,1892250.0,FRA,1,2,0,14306,14306,0
Content|Entertainment,4800000.0,KOR,1,1,0,16177,16177,0
Public Relations,32300000.0,USA,2,15,1422,11607,13029,1
Advertising|App Marketing|Digital Media|Internet Marketing|Search Marketing|Semantic Search|SEO|Social Media|Social Media Marketing,75000.0,COL,1,2,0,14123,14123,0
Enterprise Software|Mobile|Sales Automation,600000.0,USA,1,2,0,15770,15770,0
Cloud Data Services|Data Integration|Data Security|Mobile Devices|SaaS|Security|Software,45727627.0,USA,4,2,1067,15440,16507,0
Social Media,162364.0,CHN,1,1,0,16040,16040,0
Real Estate,5000000.0,IND,1,1,0,16623,16623,0
Employer Benefits Programs|Enterprise Software|Health and Insurance|Insurance,30800000.0,USA,2,7,385,15069,15454,0
Recruiting,2882561.0,JPN,2,2,378,16268,16646,0
Curated Web|Finance|Publishing|Writers,1678978.0,USA,4,12,1113,15314,16427,0
Consulting,31700308.0,GBR,1,1,0,14988,14988,0
E-Commerce|Online Reservations|Online Scheduling,2243200.0,NLD,3,6,882,13149,14031,0
Health and Wellness|Healthcare Services|Medical,339959044.0,USA,2,1,72,14719,14791,1
Clean Technology,500000.0,USA,1,1,0,14903,14903,0
Financial Services,400000.0,USA,1,1,0,16442,16442,0
Curated Web|File Sharing|Media|Peer-to-Peer|Photo Sharing|Synchronization|Video,2000000.0,ISR,2,4,649,13992,14641,0
Bitcoin|Finance Technology|FinTech|SaaS|Software|Virtual Currency,500000.0,USA,1,4,0,16353,16353,0
Cloud Computing|SaaS|Software,15050000.0,USA,3,5,2257,13654,15911,1
Digital Media|Hardware + Software|Technology,31100000.0,USA,4,8,1820,13185,15005,1
Customer Service|Logistics|Transportation,37422037.0,BRA,1,1,0,15202,15202,0
Enterprise Software,8592884.0,CAN,1,1,0,14153,14153,0
Clean Technology|Recycling|Sustainability,50000.0,USA,1,1,0,15223,15223,0
Education,34700.0,USA,2,1,5,15835,15840,0
Software|Web Development,1264400.0,GBR,1,2,0,14302,14302,0
Enterprise Software|Licensing,15968956.0,USA,5,10,2399,13559,15958,0
E-Commerce|Postal and Courier Services|Shipping,1500000.0,USA,2,2,901,12947,13848,0
Art|Design|E-Commerce|Fashion|Jewelry|Travel,525000.0,FRA,1,1,0,15887,15887,0
E-Commerce|Fashion|Jewelry|Shopping,10000000.0,TUR,3,5,641,15309,15950,0
Design,5000000.0,CHN,1,2,0,15340,15340,0
Recruiting|Social Media,70000000.0,CHN,1,2,0,16175,16175,0
High Schools|Information Technology|Technology,3200000.0,JPN,1,4,0,16286,16286,0
Android|Apps|Gps|iPhone|Mobile|Mobile Emergency&Health|Security|Tracking,76100000.0,USA,9,37,2267,14126,16393,0
Big Data|Brokers|Consulting|Finance|Health and Insurance|Monetization|Productivity Software|Software,6547468.0,USA,4,2,1826,14853,16679,0
Biotechnology|Fitness|Health Care,2700000.0,ISR,1,1,0,15873,15873,0
Photo Sharing|Social Media,1000000.0,IND,1,1,0,14105,14105,1
Biotechnology,55000000.0,ISR,3,11,2254,14398,16652,0
Curated Web,2547983.0,GBR,1,1,0,15589,15589,0
Advertising,6500000.0,USA,1,1,0,15100,15100,0
Diagnostics|Investment Management|Services,11317842.0,AUT,1,1,0,16575,16575,0
Curated Web,1400000.0,GBR,2,7,483,15546,16029,1
Curated Web|Loyalty Programs|Productivity Software,65000000.0,USA,1,2,0,11120,11120,0
Biotechnology,20500000.0,USA,1,4,0,16485,16485,0
Social Media,5000000.0,USA,2,5,7,15449,15456,0
Health and Wellness,925000.0,USA,2,1,410,16107,16517,0
Health and Wellness,8831000.0,USA,3,7,2369,14304,16673,0
Health and Wellness|Services|Wearables,2500000.0,USA,2,13,370,16217,16587,0
Games|Gamification|Health Care|Mobile,312500.0,USA,3,2,579,15796,16375,0
Health Care|Information Technology|Mobile|Mobile Health,2650000.0,USA,2,3,699,15857,16556,0
Software,7800000.0,USA,2,4,30,12102,12132,0
Health Care,62669579.0,USA,10,16,2303,14399,16702,0
Curated Web,500000.0,USA,1,5,0,14120,14120,0
Security|Technology,177850000.0,USA,5,13,1946,13467,15413,1
Biotechnology|Diabetes,200000.0,IND,1,1,0,15912,15912,0
Big Data|Health and Wellness|Health Care,5000000.0,USA,1,1,0,16198,16198,0
Health Care|Healthcare Services|Hospitals,15000000.0,USA,1,3,0,13949,13949,1
Hardware + Software,25126750.0,USA,9,3,1559,14714,16273,0
Mobile|Payments|Point of Sale,2600000.0,RUS,1,1,0,15584,15584,0
Biotechnology,625000.0,USA,2,1,472,15755,16227,0
Software,42500000.0,USA,2,11,273,13136,13409,1
Consumer Electronics|Internet of Things|Services,9400000.0,CHN,1,2,0,16701,16701,0
Curated Web|Networking|Photography|Social Network Media|Software,31000.0,USA,1,2,0,14884,14884,0
Consumers|Services|Storage,120000000.0,USA,1,1,0,16351,16351,0
Information Technology|Services,2000000.0,USA,1,1,0,16174,16174,0
Advertising,66000000.0,USA,1,1,0,15463,15463,0
E-Commerce|Fashion|Mass Customization|Personalization,838350.3946953659,JPN,2,1,135,16435,16570,0
Fitness|Health and Wellness|Services,8000000.0,USA,1,3,0,12635,12635,0
Android|Fitness|Health and Wellness|Internet|iPhone|Personal Health|Social Media,6700000.0,SWE,1,2,0,16174,16174,0
Business Analytics|Business Intelligence|Consulting|CRM|Information Services|Project Management|SaaS|SEO,427329.0,FIN,3,1,1462,15156,16618,0
Health and Wellness,200000.0,USA,1,2,0,16566,16566,0
Fitness,1000000.0,CAN,1,1,0,16457,16457,0
Blogging Platforms|Consumer Electronics|Design|Public Relations,2500000.0,USA,1,4,0,15671,15671,0
Curated Web|Health and Wellness|Productivity Software|Quantified Self|Software,3600000.0,USA,3,5,1213,15208,16421,0
Analytics|Big Data|Business Intelligence|Design|E-Commerce|Fashion,560000.0,SGP,1,3,0,15949,15949,0
Advertising,1000000.0,USA,2,6,10,15006,15016,1
Analytics|Social Media|Social Media Marketing,750000.0,USA,1,4,0,16220,16220,0
Big Data|Machine Learning|Mobile|Mobile Advertising,5000000.0,USA,1,6,0,16469,16469,0
Cloud Computing|E-Commerce|SaaS|Sports|Travel|Twin-Tip Skis,7300000.0,USA,4,24,2036,13939,15975,0
Clean Technology|Internet of Things|Lighting,13320000.0,USA,3,4,660,15584,16244,0
Photography,34700000.0,USA,2,10,415,16231,16646,0
Manufacturing,17000000.0,CAN,3,5,549,14687,15236,0
Automotive|Consumer Electronics|Hardware + Software|Lasers,58500000.0,GBR,5,19,1533,13360,14893,0
3D|3D Technology|Business Intelligence,20000000.0,CHN,1,4,0,16241,16241,0
Security,16000000.0,ISR,3,4,1274,15316,16590,0
Biotechnology|Health and Wellness|Health Care,179961674.0,USA,8,17,2995,13067,16062,0
Design|Designers|Sales and Marketing,118000.0,USA,1,1,0,16643,16643,0
Android|Mobile|Networking|Photo Sharing,1200000.0,GBR,1,11,0,15006,15006,1
Angels|Finance|FinTech|SaaS|Software|Venture Capital,115000000.0,USA,3,5,2005,14761,16766,0
Health and Wellness,3100000.0,USA,1,1,0,14568,14568,0
Internet|Services|Wireless,5000000.0,USA,1,2,0,12531,12531,0
Consulting|Law Enforcement|Legal,30000000.0,USA,1,1,0,16478,16478,0
Startups,50000.0,USA,1,1,0,16652,16652,0
Clean Technology,4999929.0,USA,1,1,0,14578,14578,0
Clean Technology,311641726.0,USA,8,8,1969,14734,16703,1
Consumers|E-Commerce,35000000.0,CHN,2,1,1453,13483,14936,1
Games,4000000.0,USA,1,1,0,14035,14035,0
Curated Web,5000000.0,USA,2,5,1590,11017,12607,1
Health Care,8719016.92197002,GBR,5,6,890,15881,16771,0
Manufacturing|Point of Sale|Telecommunications,33000000.0,USA,1,5,0,11519,11519,0
Software|Technology,10000000.0,ISR,1,1,0,16659,16659,0
EdTech|Education,12192266.0,USA,2,3,188,16373,16561,0
Clean Technology,42800000.0,USA,2,7,106,15649,15755,0
Web Hosting,14000000.0,USA,2,10,707,12270,12977,0
Games,2744997.0,USA,4,2,544,15085,15629,0
3D Technology,172314.0,LVA,1,1,0,16156,16156,0
Education|K-12 Education|Online Education,100000000.0,USA,1,2,0,11367,11367,0
Music,1250000.0,USA,1,1,0,13269,13269,0
Customer Support Tools|Finance|FinTech|Retail|Software|Trading,750000.0,USA,2,1,1532,14903,16435,0
Mobile Analytics|Mobile Payments|Point of Sale|Restaurants|Retail|Retail Technology|Software,126000000.0,CAN,3,8,1191,15503,16694,0
Design|Semiconductors|Technology,57500000.0,USA,2,8,517,11124,11641,0
Mobile,265000000.0,USA,1,2,0,15160,15160,0
Semiconductors,5206950.0,IRL,1,4,0,13191,13191,0
Advertising,1250000.0,USA,1,1,0,15309,15309,0
Hardware + Software,26590000.0,USA,6,1,2177,14425,16602,1
Finance|FinTech,13000000.0,USA,1,1,0,14225,14225,0
Enterprise Software,18000000.0,USA,1,3,0,15065,15065,1
Biotechnology,43562640.0,USA,4,4,1049,14470,15519,1
Biotechnology,1500000.0,USA,2,1,188,14379,14567,0
Content|E-Commerce|Education|Social Media,70052.0,USA,1,1,0,15340,15340,0
Advertising,28300000.0,USA,6,14,1570,13514,15084,1
Photography|Search,47300000.0,USA,3,14,1158,12934,14092,1
Online Reservations|Social Media|Travel,118584.0,EST,2,1,638,15492,16130,0
Local Advertising|SaaS|Software,2620000.0,USA,4,1,665,15958,16623,0
Advertising|Lead Generation|Mobile|Television,1250000.0,IRL,1,2,0,15979,15979,0
E-Commerce|Kids|Shopping,25000.0,ARG,1,1,0,15765,15765,0
Analytics|Content|Curated Web|News|Personalization|Social Media,295208.0,USA,3,3,109,15584,15693,0
Distribution|E-Commerce|Hospitality|Reviews and Recommendations|Supply Chain Management|Wine And Spirits,450000.0,USA,1,2,0,15483,15483,0
Advertising Networks|Coupons|Curated Web|Local|Local Coupons|Local Search|Private Social Networking|Reviews and Recommendations|Search,5000000.0,USA,1,1,0,14593,14593,0
Advertising|Analytics|Big Data|Communities|Sales and Marketing|Social Media,1600000.0,GBR,1,2,0,15668,15668,0
Collaboration|Consumer Internet|Corporate Wellness|Health and Wellness|Social Media,850000.0,USA,1,6,0,16435,16435,0
Big Data|Consumers|Guides|In-Flight Entertainment|Local|Online Travel|Personalization|Travel,140893.0,IRL,3,3,315,15765,16080,0
Identity Management|Open Source|Security|Software,10000000.0,USA,1,3,0,14364,14364,1
Beauty|Cosmetics|Curated Web|E-Commerce,250000.0,TUR,2,3,937,14980,15917,0
Retail,100000000.0,CHN,1,1,0,16533,16533,0
Search|Travel,3900000.0,FRA,1,2,0,14208,14208,1
3D|Mobile|Web Development,20000.0,USA,1,1,0,16357,16357,0
Energy|Hardware + Software|Mobile,103350000.0,USA,6,18,1737,13860,15597,0
Fashion|Flash Sales|Kids|Social Commerce,1200000.0,USA,1,1,0,14853,14853,0
Software,650000.0,USA,1,1,0,16573,16573,0
Consumer Electronics|Drones|Robotics,1000000.0,USA,1,8,0,16161,16161,0
Games|Mobile,27100000.0,USA,4,11,1127,13118,14245,0
Semiconductors,4336290.0,GBR,2,5,1881,13392,15273,0
Curated Web|E-Commerce|Events|Leisure|Lifestyle|Mobile,3057318.0,IRL,4,7,1169,15006,16175,0
Big Data|Cloud Computing|Media|SaaS|Software|Video Editing,621246.0,BEL,1,2,0,15700,15700,0
Advertising,30000000.0,CHN,2,3,275,15156,15431,0
Big Data|Energy Efficiency|Energy Management,1586357.0,GBR,1,3,0,16693,16693,0
Advertising|Mobile|Mobile Advertising|News,20900000.0,USA,5,9,1570,12996,14566,1
Health and Insurance|Health Care|Insurance|SaaS,3000000.0,USA,2,4,277,16359,16636,0
Biotechnology,42119415.0,USA,5,6,1328,14041,15369,0
E-Commerce|Social Media,50000000.0,IND,3,9,888,15636,16524,0
E-Commerce|Machine Learning|Personalization,825000.0,USA,5,2,666,15918,16584,0
Electronics|Health Care|Hospitals,20000.0,USA,1,1,0,16471,16471,0
Babies|Kids|Parenting|Photography|Video,40968.0,PRT,1,1,0,16045,16045,0
Advertising|Content|Distribution|Startups,333000.0,USA,2,5,817,15371,16188,0
Online Rental|Services|Taxis,1000000.0,KOR,1,1,0,16274,16274,0
E-Commerce|Mobile|Mobile Payments|Payments,11522960.0,FRA,3,3,2102,13879,15981,0
Automotive|Concerts|Events|Limousines|Online Travel|Weddings,15000000.0,USA,2,2,878,14184,15062,0
Cloud Computing|SaaS|Telecommunications|Unifed Communications,650000.0,POL,2,2,369,16010,16379,0
Auctions|E-Commerce,1109160.0,SRB,1,5,0,14396,14396,0
Software,2180000.0,FRA,1,2,0,13164,13164,0
Biotechnology,40000.0,CHL,1,1,0,15574,15574,0
Advertising|Automotive|CRM|Email Marketing|Internet Marketing|Lead Generation,10000.0,USA,1,1,0,15887,15887,0
Manufacturing,35000000.0,USA,1,1,0,13021,13021,0
Clean Technology,55000000.0,USA,2,2,112,14979,15091,0
Education|Health and Wellness|Health Care|Medical|Software,12500000.0,IRL,2,2,280,15775,16055,0
Health Care,1600332.8692368,BEL,1,1,0,16773,16773,0
Marketplaces|Social Media|Social Media Marketing,50511.0,PER,1,1,0,15349,15349,0
E-Commerce|Food Processing|Restaurants,30000000.0,CHN,3,5,920,15522,16442,0
Photography,4000000.0,USA,1,1,0,15856,15856,0
Consumer Electronics,4000000.0,USA,1,3,0,16471,16471,0
Biotechnology,60964064.0,USA,7,29,2217,14244,16461,0
Games,115000000.0,CHN,3,5,2456,13634,16090,1
Industrial|Industrial Automation|Industrial Energy Efficiency|Manufacturing|Product Development Services,400000.0,AUT,1,1,0,16040,16040,0
Software,6352877.0,USA,3,7,708,14902,15610,0
Automotive|Clean Technology|Energy Efficiency|Semiconductors|Software,2500000.0,USA,3,4,2649,14031,16680,0
Corporate Training|Enterprise Software|Language Learning|Software,4000000.0,USA,1,5,0,16376,16376,0
Crowdsourcing|Language Learning|SaaS|Software|Translation,180000.0,AUT,2,2,52,15522,15574,0
Communities|Social Network Media|Technology,475210.0,GBR,4,3,577,15979,16556,0
Messaging|Translation,131341.0,DEU,3,4,1096,14610,15706,0
Education|Tutoring,40000.0,USA,2,2,572,16076,16648,0
Collaboration|Crowdsourcing|Enterprise Software|Local|Translation,8044807.0,USA,6,11,2163,13208,15371,0
Apps|Mobile|Translation,390077.0,SVK,2,2,253,16183,16436,0
EdTech|Education|Language Learning,1500000.0,ISR,2,4,515,15989,16504,0
Biotechnology|Medical|Pharmaceuticals,2000000.0,USA,1,1,0,12415,12415,0
Curated Web|Education|Language Learning|Online Education,3000000.0,RUS,3,4,1667,14936,16603,0
Enterprise Software,4670000.0,USA,3,1,854,14979,15833,1
Big Data|Education|Language Learning|Online Education,9369630.0,EST,4,10,1059,15690,16749,0
E-Commerce,175500000.0,MEX,4,10,512,15747,16259,0
Semiconductors|Web Hosting,69218498.0,USA,4,15,1441,13978,15419,1
Internet of Things,5700000.0,USA,2,3,312,16358,16670,0
Advertising|Loyalty Programs,40429937.0,USA,8,9,1595,14901,16496,0
Biotechnology|Health Diagnostics,12643228.0,USA,7,10,2031,13802,15833,0
Advertising|Social Bookmarking|Social Media|Visualization,133150.0,DEU,1,1,0,14730,14730,0
Advertising|Internet Marketing|Networking|Public Relations|Search|SEO|Social Media,9309959.0,GBR,5,7,1882,14519,16401,0
Banking|Finance|Financial Services|Small and Medium Businesses,2841845.0,IRL,1,1,0,16489,16489,0
Networking|Social Media|Social Recruiting|Software,103200000.0,USA,5,13,1817,12357,14174,1
Marketing Automation|Music|Tracking,2716888.0,DNK,2,2,533,16161,16694,0
Analytics|Brand Marketing|Reputation|Social CRM|Social Media|Social Media Management|Social Media Monitoring,11200000.0,FRA,3,6,1168,14968,16136,0
Consumer Electronics|Educational Games|Toys|Wearables,118138.0,CAN,2,3,9,16265,16274,0
Software,2600000.0,USA,1,4,0,16084,16084,0
Cloud Data Services|Curated Web|Facebook Applications|Mobile|Video Streaming,1500000.0,FIN,1,2,0,14655,14655,0
Web Hosting,789717.0,ESP,5,4,761,14761,15522,0
Crowdsourcing|E-Commerce|Fashion|Mobile Commerce|Retail,500000.0,USA,1,2,0,16344,16344,0
Curated Web,500000.0,USA,1,1,0,14483,14483,0
Advertising|Internet Marketing|Publishing,9700000.0,USA,3,6,1274,14554,15828,1
Advertising,8500000.0,USA,3,5,820,13787,14607,0
Finance|Social Media|Software,100000.0,USA,1,1,0,15553,15553,0
Health and Wellness,19300000.0,USA,2,3,390,15345,15735,0
Cloud Data Services|Internet|Small and Medium Businesses,140000.0,RUS,1,1,0,15390,15390,0
Advertising|Content Creators|Content Delivery|Performance Marketing,3400000.0,USA,1,2,0,15596,15596,0
Software,87000000.0,USA,3,8,675,12727,13402,1
Game,5484092.0,KOR,2,6,570,15832,16402,0
Lead Management|Mobile|Software,51133.0,CZE,1,1,0,15887,15887,0
Health Care,2000000.0,CAN,1,1,0,16140,16140,0
Direct Marketing|Presentations|Productivity Software|Sales and Marketing|Software|Speech Recognition|Startups|Technology,517208.0,USA,3,6,244,15796,16040,0
Games,1600000.0,USA,1,3,0,14932,14932,1
Biotechnology,611424.0,USA,3,2,1515,13487,15002,0
Biotechnology,8010000.0,DNK,1,3,0,12843,12843,0
Biotechnology|Health Diagnostics,15000000.0,USA,1,6,0,12271,12271,1
Biotechnology,37935003.0,USA,3,7,639,11971,12610,1
Information Technology|Services,5700000.0,USA,1,4,0,16575,16575,0
Hardware + Software,32408800.0,NLD,3,9,1224,13488,14712,1
Mobile Analytics|Personalization|Software,1000000.0,PRT,1,2,0,16190,16190,0
Software,1150000.0,GBR,1,1,0,14670,14670,0
Mobile,12400000.0,DEU,2,3,657,12784,13441,1
Public Relations,43956298.0,CAN,4,11,1640,12912,14552,0
Software,14700000.0,USA,2,10,939,12459,13398,1
Clean Technology,51600000.0,USA,2,2,1733,14519,16252,0
Chemicals,23500000.0,USA,2,10,1003,15321,16324,0
Advertising,8700000.0,USA,2,4,291,15988,16279,0
Enterprise Software,17500000.0,USA,2,9,504,13409,13913,1
Accounting|Billing|FinTech|Payments|SaaS,595504.0,DEU,4,1,598,16102,16700,0
Clean Technology,81575000.0,USA,6,4,2999,12784,15783,0
Apps|Enterprises|Mobile|Publishing|Software|Tablets|Technology,803852.0,AUS,2,2,344,15586,15930,0
Semiconductors,1400000.0,USA,2,2,8,15889,15897,0
Advertising|PaaS|Social Media,4817324.0,USA,2,1,910,15217,16127,0
Consulting,93000000.0,USA,4,5,2397,13757,16154,0
Nanotechnology,73799994.0,USA,7,19,2210,13313,15523,0
Material Science|Nanotechnology|Water|Water Purification,11634052.0,USA,3,4,1364,15267,16631,0
Intellectual Asset Management|Investment Management|Marketplaces|Trading,250000000.0,USA,1,2,0,12832,12832,0
Clean Technology,21250000.0,USA,5,5,2191,13717,15908,0
Career Planning|Enterprise Software|Online Scheduling|Project Management|SaaS|Task Management,11600000.0,USA,4,6,2319,13879,16198,0
Collaborative Consumption|Curated Web|Marketplaces|Peer-to-Peer|Real Estate|Real Time,26200000.0,USA,6,19,1409,14964,16373,0
Enterprise Software,2430000.0,USA,1,1,0,13577,13577,1
Software,2776316.0,USA,2,1,1921,14351,16272,0
Innovation Engineering|Social Innovation|Utilities,7100000.0,USA,2,3,867,15636,16503,0
Financial Services|Investment Management|Marketplaces|Peer-to-Peer,245703.0,GBR,2,1,375,15897,16272,0
Software,641650.0,DEU,1,1,0,14287,14287,0
Curated Web|Digital Media|Media,3100000.0,USA,1,1,0,15903,15903,0
E-Commerce,390408.0,AUS,1,1,0,16495,16495,0
Education,3000000.0,IND,1,1,0,15553,15553,0
Audio|Entertainment|Mobile|Technology,14650000.0,USA,4,9,859,15883,16742,0
Education,950000.0,USA,1,1,0,16475,16475,0
Education,18000.0,USA,1,1,0,15857,15857,0
Distribution|EdTech|Education|Mobile|Publishing,25000.0,USA,1,1,0,15196,15196,0
Auctions|Curated Web|E-Commerce,11165000.0,USA,4,13,1584,14396,15980,0
Curated Web|Social Media,700000.0,NOR,3,3,516,15567,16083,0
Software,620000.0,USA,2,1,33,16267,16300,0
Clean Technology|Electric Vehicles|Sensors|Transportation,2200000.0,USA,2,6,428,15706,16134,0
Embedded Hardware and Software|Home Automation|Internet of Things,25000.0,USA,1,1,0,16071,16071,0
Software,26500000.0,USA,3,12,923,12808,13731,0
Biotechnology,35300000.0,USA,3,11,420,15693,16113,0
Social CRM|Software,151650012.0,USA,13,23,2331,13620,15951,0
Design|Email Marketing|Software|Testing|Web Design,49000000.0,USA,1,1,0,16735,16735,0
Art|Fashion|Publishing,100000.0,USA,1,3,0,16071,16071,0
Curated Web,5000000.0,RUS,1,2,0,15988,15988,0
Local Businesses,50000000.0,IND,1,3,0,16645,16645,0
Social Media,3367787.0,USA,6,9,1308,15279,16587,0
E-Commerce,10750000.0,USA,2,6,196,15372,15568,0
E-Commerce,2580850.0,USA,3,9,497,16128,16625,0
Brewing,176875.0,GBR,1,1,0,16010,16010,0
Hospitality,4000000.0,USA,1,1,0,16044,16044,0
Farming,17000.0,USA,1,1,0,16314,16314,0
Messaging|Mobile|Mobile Games|Wearables,3000000.0,USA,2,7,187,16387,16574,0
Education,5926121.0,USA,5,3,1953,14207,16160,0
Consumer Goods|Manufacturing|Specialty Foods,50000.0,USA,2,2,92,16252,16344,0
Hardware|Internet of Things,341965.120416601,GBR,3,1,1166,15583,16749,0
Beauty|Health Care|Medical,36800000.0,USA,1,1,0,16539,16539,0
Advertising|Video Streaming|Virtual Worlds,750000.0,USA,1,4,0,16587,16587,0
Education|Electronics|Hardware + Software|Open Source|Rapidly Expanding,62344476.0,USA,5,33,1426,15218,16644,0
Health and Wellness,745000.0,USA,3,26,125,16218,16343,0
Sporting Goods,13000000.0,CHN,1,1,0,16646,16646,0
Art|Auctions|Collectibles|E-Commerce|Jewelry,47600000.0,USA,1,1,0,16393,16393,0
Enterprise Software,670020.0,IRL,2,1,165,14975,15140,0
Curated Web|Restaurants,60000.0,USA,1,1,0,14393,14393,1
Cloud Infrastructure|PaaS|SaaS,110000.0,USA,2,1,252,16457,16709,0
Analytics|Big Data Analytics|Information Technology|Networking|Real Time|Software,5850000.0,USA,2,4,460,15857,16317,0
Finance|Financial Services|Professional Services,40000.0,USA,1,1,0,16594,16594,0
Advertising|Restaurants,69604550.0,GBR,5,9,1531,13943,15474,1
Finance|Services|Small and Medium Businesses,7400000.0,USA,1,7,0,12128,12128,0
Software,6855000.0,USA,5,5,846,15202,16048,0
Apps|Entertainment|Mobile|Video Streaming,200000.0,ESP,1,1,0,15675,15675,0
Curated Web,4900000.0,USA,1,2,0,13082,13082,1
Fitness|Health and Wellness|Social Media,100000.0,USA,1,1,0,15614,15614,0
Brand Marketing|Content|Enterprise Software|Real Time,67300000.0,USA,8,35,1689,14796,16485,0
Broadcasting,1650000.0,TWN,2,3,40,16407,16447,0
Advertising|Email|Publishing|Real Time,65100000.0,USA,4,17,1994,14609,16603,0
Consumer Electronics|Employment|Gamification|Human Resources|Incentives|Predictive Analytics|Real Time|Restaurants|SaaS|Software,1878595.0,CAN,2,2,762,15340,16102,0
Software,100000.0,USA,1,1,0,16265,16265,0
Application Platforms|Broadcasting|Entertainment|Software|Technology,800000.0,USA,1,2,0,16698,16698,0
Mobile|Music,2775000.0,USA,4,5,250,15932,16182,0
Hardware + Software|Internet of Things|Mobile Emergency&Health|Mobile Health|Senior Citizens,7300000.0,USA,2,3,626,15340,15966,1
Apps|Blogging Platforms|Chat|Collaboration|Messaging|Mobile|Social Media|Software,50000.0,USA,1,1,0,15614,15614,0
Hardware + Software,1280000.0,RUS,7,2,1335,15095,16430,0
Curated Web|Document Management|Real Time,3154164.0,USA,2,5,237,15909,16146,1
Education|Internet|Language Learning,19389998.0,USA,5,3,1882,13879,15761,1
E-Commerce|Education|Messaging|Social Media|Social Network Media|Video Chat,1000000.0,USA,3,6,755,15681,16436,0
Collaboration|Digital Signage|Real Time,605000.0,USA,1,1,0,16719,16719,0
Internet,750000.0,USA,1,1,0,16573,16573,0
Cloud Computing|Crowdsourcing|Enterprise Software,81000000.0,USA,4,10,4774,11323,16097,1
Messaging|Mobile|Social Media,2200000.0,USA,1,2,0,15132,15132,0
Advertising|Enterprises|Entertainment|Internet Marketing|Video,12000000.0,USA,4,3,1762,14104,15866,1
Advertising|Brand Marketing|Data Integration,16000000.0,USA,4,9,2131,13665,15796,1
Social Media,10998000.0,USA,4,5,913,15859,16772,0
Apps|Education,2395319.0,USA,3,4,1144,15095,16239,0
Content Syndication|Hardware + Software,68000000.0,USA,2,7,1847,13804,15651,1
Business Productivity|Collaboration|Enterprise Software|Events|Meeting Software|Productivity Software|SaaS,835000.0,USA,2,2,547,16009,16556,0
Analytics|Big Data|Collaboration|Data Mining|Data Visualization|Government Innovation|Governments,2110000.0,USA,2,3,158,16388,16546,0
Software|Video|Video Streaming,14699973.0,USA,4,1,1653,13634,15287,0
Education,110000.0,ESP,1,1,0,16097,16097,0
Broadcasting|News|Video Streaming,50000000.0,ISR,4,11,2142,13514,15656,0
Computers|Services|Software,35000000.0,USA,3,14,1000,11128,12128,1
Web Hosting,12100000.0,USA,2,5,223,13683,13906,0
Concerts|Music|Video|Video Streaming,402450.0,GBR,3,2,532,16024,16556,0
Market Research|Semantic Search|Video,2001339.0,GBR,3,1,529,16129,16658,0
Biotechnology,53000000.0,USA,3,3,1641,14116,15757,0
Consumers,2013684.33364246,GBR,3,6,587,16071,16658,0
Advertising|Digital Media|Entertainment|Fashion|Media,15700000.0,USA,2,8,1735,13726,15461,0
E-Commerce|Group Buying|Networking|Social Commerce,934725004.0,USA,10,31,1675,14081,15756,0
Apps|Electronics|Hardware + Software|Music,5796518.0,USA,4,1,1127,14777,15904,1
Fitness|Health and Wellness|Health Care|Health Care Information Technology,30000000.0,USA,2,5,209,16323,16532,0
Mobile|Payments,1600000.0,IND,2,2,711,15922,16633,0
Curated Web,1000000.0,ARG,1,1,0,11078,11078,0
Consumer Electronics|Gift Card|Software|Tablets,1410816.0,USA,2,1,111,15636,15747,0
Interior Design,12600000.0,IND,2,6,237,16421,16658,0
Beauty|Marketplaces,500000.0,VNM,1,5,0,16570,16570,0
Software,3230250.0,AUT,1,1,0,13542,13542,0
Music,30000000.0,CHN,3,6,1851,14610,16461,0
Android|Audio|Cloud-Based Music|Computers|Digital Entertainment|Digital Media|iPad|iPhone|Mac|Mobile|Music|Music Services|Software|Technology|Video Streaming,460000.0,USA,2,1,73,15887,15960,0
Software|Supply Chain Management,56100000.0,USA,2,3,1064,15643,16707,0
Hardware + Software,494561.0,GBR,1,2,0,14182,14182,0
Mobile|Social Media,21000000.0,CHN,2,8,340,15918,16258,0
Design|Manufacturing|Service Providers,4950000.0,USA,1,1,0,12439,12439,0
Nanotechnology|Technology,7100000.0,USA,1,3,0,12062,12062,0
Finance|Project Management,320125.0,ESP,1,1,0,15793,15793,0
Software,19250000.0,USA,2,5,603,15608,16211,0
Games,1058197.0,KOR,2,3,515,15684,16199,0
Manufacturing,8000000.0,USA,2,6,383,13154,13537,0
Bitcoin|FinTech,313000.0,USA,2,3,229,16367,16596,0
Finance|Financial Services|FinTech,2377667.31041814,ESP,3,1,901,15827,16728,0
Finance,18867.0,AUS,1,1,0,16010,16010,0
Financial Services,22100000.0,USA,3,1,323,16272,16595,0
Finance|FinTech,12436303.0,USA,2,1,933,15111,16044,0
Developer APIs|Developer Tools|Internet|Printing,9400000.0,USA,3,20,556,15765,16321,0
Content Syndication,234377.0,GBR,2,2,349,16118,16467,0
Enterprise Software|Location Based Services|Mobile|Wireless,39734188.0,USA,7,9,3185,13103,16288,1
Software,4555940.0,KOR,3,4,1005,14975,15980,0
Apps|Mobile|Pets|SaaS,525000.0,USA,3,2,1186,15044,16230,0
Advertising,36500000.0,USA,5,3,2261,13545,15806,0
Advertising,9568056.0,USA,2,1,707,15806,16513,1
Software,40000.0,USA,1,1,0,15652,15652,0
News,4570000.0,USA,2,1,559,15454,16013,0
Crowdfunding|Finance|Mobile,160000.0,USA,2,3,64,16203,16267,0
Advertising|Local|Local Search,4818112.0,USA,4,4,1098,15342,16440,0
Advertising,4699999.0,USA,2,2,589,13501,14090,0
Local Search|Real Estate|Social Search,35000000.0,USA,2,2,154,12934,13088,0
Curated Web|Transportation,6000000.0,USA,2,10,300,15645,15945,1
3D Printing|Crowdfunding|Crowdsourcing|Education|Hardware + Software|Internet of Things|Local|Manufacturing|New Product Development|Open Source,250000.0,USA,2,3,755,15497,16252,0
Big Data|CRM|Enterprise Software|Local|Local Advertising|Restaurants|Retail|Retail Technology|Software|Task Management,1900000.0,USA,1,7,0,16596,16596,0
News,3000000.0,USA,1,1,0,15916,15916,0
Advertising|Digital Media|Local|Mobile,2288352.0,USA,2,1,831,15036,15867,0
Curated Web,5000000.0,IND,1,1,0,16079,16079,0
Consumers|Curated Web|Incentives|Loyalty Programs|Small and Medium Businesses,1025000.0,USA,3,3,427,15348,15775,0
Guides|Hospitality|Local|Restaurants|Reviews and Recommendations|Travel,5000000.0,USA,1,1,0,13879,13879,0
Content|Curated Web|Local|Mobile|Reviews and Recommendations|Travel,1200000.0,USA,1,1,0,16462,16462,0
Local|Travel|Travel & Tourism,25000.0,USA,1,1,0,16273,16273,0
Web Hosting,40000.0,DEU,1,1,0,15407,15407,0
Search,40000.0,USA,1,1,0,15448,15448,0
Big Data|Offline Businesses|Search,6725000.0,USA,5,16,899,15131,16030,0
B2B|SaaS|Software,1100000.0,USA,1,8,0,16736,16736,0
Software,708000.0,SWE,2,2,430,14635,15065,0
Bridging Online and Offline|E-Commerce|Mobile Commerce|Small and Medium Businesses,25200.0,USA,2,4,258,15972,16230,0
Advertising|E-Commerce|Internet Marketing|Real Estate|Realtors,1290000.0,USA,2,2,147,16010,16157,0
Software,560000.0,USA,1,2,0,15553,15553,0
Curated Web|Facebook Applications|Local Based Services|Location Based Services|Real Time,650206.0,USA,2,9,184,14984,15168,0
Curated Web,172500.0,USA,3,1,644,14365,15009,1
E-Commerce,175000.0,USA,3,1,924,14841,15765,0
Curated Web,5000000.0,IND,1,2,0,16539,16539,0
Ad Targeting|Advertising|Big Data|Brand Marketing|Digital Media|Internet Marketing|Mobile|Online Video Advertising|Social Media,8850000.0,USA,7,27,1948,14181,16129,0
Advertising|Location Based Services|Mobile,532219.0,NLD,3,3,581,15434,16015,0
Hotels|Networking|Search|Travel,50000.0,ZAF,2,2,92,15248,15340,0
E-Commerce|Employment|Marketplaces|Restaurants|Temporary Staffing|Wine And Spirits,12500.0,USA,1,1,0,16506,16506,0
Local|Local Advertising|Local Coupons|Mobile|News|Social Media,10255000.0,USA,5,3,1374,14754,16128,1
App Marketing|Mobile Analytics,59750000.0,USA,6,20,2021,14497,16518,0
Advertising|Digital Signage|Internet Marketing|Location Based Services|News|Social Media,8650000.0,USA,3,4,1284,13774,15058,1
Advertising|Local|Sales and Marketing|Social Network Media,216977.0,GBR,2,6,395,15949,16344,0
Public Relations,50000.0,SGP,1,1,0,13514,13514,0
Automotive|Gps|Location Based Services,22500000.0,AUS,2,2,1337,12849,14186,0
Software,1171464.0,USA,2,1,712,14027,14739,0
Enterprise Software|Location Based Services,11735000.0,USA,5,1,787,14390,15177,0
Location Based Services|Mobile|Security,25800000.0,USA,3,11,1327,11730,13057,1
Analytics|Crowdsourcing|Location Based Services,2500000.0,CAN,1,4,0,15183,15183,1
Android|Apps|iPhone|Location Based Services|Mobile|Wireless,250000.0,AUS,1,2,0,12357,12357,0
Advertising|Curated Web|Internet|Local|Local Businesses|Local Commerce|Retail,5041000.0,USA,2,7,458,15034,15492,0
Software,630000.0,USA,1,2,0,16597,16597,0
Automotive|Clean Energy|Clean Technology,915000.0,USA,2,5,363,16142,16505,0
Location Based Services|Marketplaces|Mobile|Reviews and Recommendations|Travel,898130.0,USA,2,5,382,15767,16149,0
Curated Web,2500000.0,AUS,1,1,0,15937,15937,0
Security,23280000.0,USA,3,7,991,12839,13830,1
Social Media,18093000.0,USA,6,18,1167,15240,16407,0
Android|Mobile,3200000.0,USA,1,4,0,16476,16476,1
Hardware + Software,2200000.0,USA,3,2,1156,14458,15614,0
Software,2100000.0,JPN,1,8,0,14071,14071,1
Governance|Information Security|Risk Management,8000000.0,USA,3,8,837,14700,15537,0
Sports|Teachers,250000.0,USA,1,2,0,16058,16058,0
Digital Rights Management|Security,15000000.0,USA,1,3,0,10957,10957,1
Ad Targeting|Analytics|Big Data|Location Based Services,400344.0,GBR,3,2,624,15706,16330,0
Mobile,9000000.0,USA,2,13,579,15461,16040,0
Games,4565002.0,USA,2,11,525,15965,16490,0
E-Commerce,10800000.0,JPN,2,2,480,15869,16349,0
Curated Web|Databases|File Sharing|Photography,2559510.0,DEU,2,1,507,13505,14012,0
Advertising|Content|Curated Web|Databases|Developer APIs|Local|Local Search|Personalization|Restaurants|Reviews and Recommendations|Social Media|Trusted Networks,4600000.0,USA,2,19,229,15224,15453,1
Biotechnology,56883875.0,USA,3,4,1333,13465,14798,0
Travel & Tourism,3272251.0,GBR,1,1,0,16338,16338,0
SaaS|Software|Vacation Rentals,682683.0,ESP,2,6,463,16111,16574,0
Software,17132114.0,USA,7,2,1983,14746,16729,0
Fashion,35000000.0,USA,1,1,0,14599,14599,1
Art|Auctions|Marketplaces,2250000.0,USA,4,8,453,15979,16432,0
Games|Travel,600000.0,ITA,2,1,38,13634,13672,1
Advertising,25000.0,ARG,1,1,0,15553,15553,0
Application Performance Monitoring|Big Data Analytics|Business Analytics|Software,11100000.0,USA,3,8,1337,14641,15978,1
Software,8250000.0,USA,1,2,0,16239,16239,0
Career Management|Employment|News|Professional Services|Social Media|Social Network Media,2000.0,UGA,1,2,0,15864,15864,0
Enterprise Software,33400000.0,USA,4,14,1698,14659,16357,0
Analytics|Big Data|Business Intelligence|Software|Web Development,47999999.0,USA,5,6,2136,13857,15993,0
Mobile,2500000.0,ISR,1,1,0,13867,13867,0
Hardware + Software,1480000.0,FRA,1,1,0,14771,14771,0
Software,14000000.0,USA,1,2,0,13067,13067,0
EdTech|Education,5000000.0,USA,1,1,0,15838,15838,0
Biotechnology,79437580.0,USA,3,8,1079,13677,14756,0
Customer Service|Customer Support Tools|Internet|SaaS|Software|Ticketing,546467.0,GBR,1,2,0,12957,12957,0
Curated Web,1600000.0,USA,1,1,0,15924,15924,0
Software,15604.0,GBR,1,1,0,14822,14822,0
Customer Support Tools|Field Support Services|Health Care Information Technology|Health Diagnostics|Industrial Automation|SaaS|Software|Tech Field Support,3000000.0,USA,1,1,0,16307,16307,0
Software,18000.0,NZL,1,1,0,15765,15765,0
Digital Media|Internet|Internet Marketing,500000.0,IND,1,2,0,16602,16602,0
Public Transportation,7038704.0,USA,3,2,1687,13292,14979,0
Cloud Computing|Cloud Management|Health and Insurance|Infrastructure|Web Hosting,7600000.0,USA,1,1,0,15069,15069,0
Software,1020560.0,FRA,1,2,0,14184,14184,0
Software,4000000.0,USA,1,3,0,16518,16518,0
Mobile,400264.0,GBR,1,1,0,16489,16489,0
Analytics|Big Data Analytics|Data Visualization|Logistics,10600000.0,IND,2,1,168,16532,16700,0
Facebook Applications|Identity|Internet Marketing|Online Identity|Software,1300000.0,CAN,1,6,0,16113,16113,0
Governments|Healthcare Services|Local Businesses,72500000.0,USA,1,1,0,12395,12395,0
Security,29300000.0,USA,4,12,1911,12479,14390,1
Advertising,1200000.0,JPN,1,3,0,16089,16089,0
Enterprise Software,1000000.0,FRA,1,1,0,16574,16574,0
Chat|Customer Support Tools|Software,30000000.0,USA,3,8,1150,12723,13873,1
Software,26927374.0,TUR,1,1,0,15810,15810,0
Brand Marketing|Software,4800000.0,USA,4,6,1001,15309,16310,0
Design,148775.0,ITA,1,1,0,14669,14669,1
Carbon|Energy|Fuel Cells,400000.0,USA,1,1,0,13747,13747,0
Design|Graphics|Web Design,9300000.0,USA,1,2,0,12954,12954,0
Education,120000.0,USA,1,1,0,15734,15734,1
Enterprise Software,76250948.0,USA,6,16,2438,13835,16273,0
Brand Marketing|Crowdsourcing|Entrepreneur|Games|Graphics|Media|Sales and Marketing|Startups,50190.0,BRA,1,1,0,15400,15400,0
Analytics|Big Data Analytics|Enterprises,9200000.0,ISR,2,3,230,16483,16713,0
E-Commerce,114553.0,CHL,3,3,297,15675,15972,0
Software,1262354.0,JPN,3,2,1314,13604,14918,0
Advertising|Colleges|Content|Events|Reviews and Recommendations|Sales and Marketing|Search|Social Media,400000.0,USA,2,2,152,14937,15089,0
Advertising,4000000.0,RUS,2,4,499,15553,16052,0
Games|Location Based Services|Mobile Games,670000.0,USA,1,1,0,15197,15197,1
Security,787126.0,GBR,1,1,0,15742,15742,0
Curated Web|Ediscovery|Local|Location Based Services|Mobile,2100000.0,USA,2,11,745,14839,15584,0
Consumer Goods,1200000.0,USA,1,7,0,16624,16624,0
Content|Facebook Applications|Games|Social Games|Social Media|Virtual Goods,4000000.0,USA,1,3,0,14127,14127,1
E-Commerce,22952986.0,USA,2,6,546,15323,15869,0
Crowdfunding|Marketplaces|Nonprofits|Social Fundraising,40000.0,CHL,1,1,0,16222,16222,0
Advertising,30000000.0,JPN,1,4,0,16371,16371,0
Business Development|Software,20950000.0,USA,2,6,1542,12094,13636,1
Biotechnology,47118258.0,USA,5,1,1870,14447,16317,0
Messaging|Mobile|SMS|Wireless,20000.0,MYS,1,1,0,13149,13149,0
Curated Web,637956.0,GRC,3,2,531,15909,16440,0
Software,24000000.0,USA,1,6,0,11408,11408,0
Biotechnology,520000.0,USA,2,1,380,15076,15456,0
News,20000000.0,CHN,1,1,0,13818,13818,0
Apps|Cloud Computing|PaaS|Software,1500000.0,USA,1,1,0,14975,14975,1
Curated Web|Guides|Travel,65000.0,CHL,2,2,76,15324,15400,0
Education,40000.0,USA,1,1,0,15379,15379,0
E-Commerce,20000.0,USA,1,1,0,15826,15826,0
Mobile|SaaS|Usability|User Experience Design,2200000.0,USA,1,3,0,16156,16156,0
Beauty|Online Scheduling|Service Providers|Startups,375000.0,USA,1,1,0,16161,16161,0
Curated Web|Design|Fashion|Home & Garden|Jewelry,500000.0,USA,1,1,0,15673,15673,0
Analytics|Business Intelligence|Data Visualization,48000000.0,USA,3,9,735,15770,16505,0
Advertising,3150000.0,USA,2,23,210,13916,14126,1
iOS|Social Media|Technology,34078.0,ITA,1,1,0,16222,16222,0
Security,32652679.0,USA,4,5,1329,15189,16518,0
Hotels|Leisure|Video,25000.0,RUS,1,1,0,15765,15765,0
Fashion,1500000.0,SWE,1,1,0,15065,15065,0
Consumers,2229331.0,NLD,1,2,0,16685,16685,0
Fashion|Mobile Social,160000.0,POL,1,1,0,15156,15156,0
Marketplaces,1000000.0,USA,1,6,0,15857,15857,0
Cyber Security|Mobile|Security,282000000.0,USA,8,36,2153,14314,16467,0
E-Commerce|Fashion|Marketplaces|Shoes,500000.0,USA,1,1,0,15645,15645,0
E-Commerce,500000.0,USA,1,1,0,14357,14357,0
Chat,5882000.0,IND,3,8,282,16440,16722,0
Internet|Mobile|Public Relations,76000.0,UKR,1,1,0,15862,15862,0
Cloud Computing|Flash Storage|Mobile|Photography|Storage|Synchronization|Video|Web Hosting,1400000.0,USA,1,7,0,15982,15982,1
Curated Web|Ediscovery|Reviews and Recommendations,7500000.0,USA,3,10,1582,12935,14517,0
E-Commerce,29200000.0,USA,3,41,901,15652,16553,0
E-Commerce|SaaS|Search,600000.0,SWE,1,1,0,16588,16588,0
Advertising|Advertising Platforms|Brand Marketing|Social Media,739000.0,USA,3,3,1055,15428,16483,0
Big Data Analytics|CRM|Hardware + Software|SaaS,3500000.0,USA,3,8,291,16317,16608,0
Advertising,1400000.0,USA,1,1,0,14287,14287,1
Advertising Networks|Advertising Platforms|Artificial Intelligence|Big Data|Machine Learning|Mobile|Mobile Advertising|Mobile Games|Mobile Video,3500000.0,GBR,2,7,433,15721,16154,0
Commercial Real Estate|Internet|Online Shopping|Real Estate,50000000.0,USA,1,3,0,14335,14335,1
Textiles,17000.0,USA,1,1,0,16314,16314,0
Mobile|Mobile Payments,13000000.0,USA,3,2,263,16012,16275,1
Location Based Services|Mobile|Networking,39105997.0,USA,5,5,1797,12935,14732,1
Curated Web,9030000.0,USA,2,7,886,14610,15496,0
Advertising|Incentives|Sales and Marketing,4750000.0,USA,3,4,545,15918,16463,0
Enterprise Software,97500.0,USA,1,1,0,14534,14534,0
Biotechnology|Health Diagnostics,7331039.0,DEU,4,8,2044,14154,16198,0
Pharmaceuticals,43859905.0,GBR,1,6,0,13075,13075,0
Education|Finance|Social Network Media,12123837.0,USA,4,17,340,15095,15435,1
E-Commerce,1500000.0,USA,1,1,0,15706,15706,0
Delivery|Marketplaces,224229.0,ITA,1,2,0,16419,16419,0
Internet Marketing,25000.0,USA,1,1,0,15908,15908,0
Kids|Publishing,9837165.0,GBR,2,7,386,16225,16611,0
Hospitality,44500000.0,USA,5,8,672,14610,15282,0
Ad Targeting|Advertising|Content|Interest Graph|Monetization|Optimization|Publishing|Sales and Marketing|Social Media|Weddings,61689765.0,USA,6,14,2580,13923,16503,0
Android|E-Commerce|iOS|Licensing|Mobile|Tablets|Web Development,9500000.0,CHE,1,3,0,15187,15187,0
Advertising|Automotive|Consumer Internet|Retail|Search|SEO,6000000.0,USA,3,2,1342,15095,16437,0
Babies|E-Commerce|Fashion|Kids|Marketplaces|Online Shopping|Peer-to-Peer|Recycling,535000.0,USA,3,1,715,15918,16633,0
Public Relations,1270189.0,USA,3,1,1115,15107,16222,0
Internet|Services|Transportation,10099999.0,CHN,2,3,92,16601,16693,0
Biotechnology,26000000.0,USA,1,1,0,15155,15155,0
Computers,10000000.0,USA,2,4,474,16205,16679,0
Incubators|Mobile Commerce|Social Games|Video Games,3000000.0,PHL,1,1,0,16426,16426,0
Curated Web|Semantic Web,3529175.0,USA,2,2,206,14400,14606,0
Curated Web|Finance|FinTech|Internet Radio Market|Music|Video Streaming,53000.0,USA,2,2,212,14457,14669,0
Software,1000000.0,USA,1,2,0,16402,16402,0
Android|iOS|Startups|Travel,4000000.0,USA,3,11,434,16056,16490,0
Mobile|Transportation|Travel,1500000.0,USA,2,2,184,16222,16406,0
Energy|Gas|Price Comparison|Utilities,6946213.0,GBR,1,1,0,16692,16692,0
Leisure|Online Reservations|Online Travel,3337468.0,GBR,1,1,0,15095,15095,0
Curated Web|Vacation Rentals,4136359.0,GBR,3,3,608,15370,15978,0
3D Printing|Design|Personalization|Technology,376605.28000602603,IRL,1,2,0,16375,16375,0
Enterprise Software|FinTech|Payments,875000.0,USA,1,7,0,16495,16495,0
E-Commerce|Marketplaces|Organic Food|Specialty Foods|Ventures for Good,2095000.0,USA,3,14,983,15248,16231,0
Mobile,240000.0,SGP,1,3,0,15650,15650,0
E-Commerce,27500000.0,GBR,2,5,262,16493,16755,0
Curated Web,6000000.0,USA,1,2,0,15498,15498,0
Software,781000.0,USA,1,1,0,16336,16336,0
News,2700000.0,GBR,1,1,0,15974,15974,0
Education|Life Sciences|Online Dating|Psychology|Self Development,100000.0,USA,1,1,0,15890,15890,0
Real Estate,4500000.0,USA,4,13,1467,14721,16188,1
E-Commerce,40000.0,CHL,1,1,0,15754,15754,0
Gift Card,2741200.0,USA,3,2,404,16358,16762,0
Advertising|E-Commerce|Search|Weddings,9970000.0,USA,6,18,1352,15160,16512,0
Consumers,5369505.6318624,GBR,2,2,40,16212,16252,0
E-Commerce|Fashion,200000.0,USA,1,1,0,16010,16010,0
E-Commerce|Online Shopping|Retail|Startups,1050000.0,USA,3,1,578,15344,15922,0
E-Commerce|Fashion,215116.0,GBR,2,2,325,15805,16130,0
Design|E-Commerce|Flash Sales,5788830.0,ITA,3,3,956,15584,16540,0
Customer Service|Non Profit,50000.0,USA,1,1,0,15636,15636,0
Design|E-Commerce|Flash Sales,717888.0,ITA,1,1,0,16182,16182,0
Technology,54090.0,USA,1,1,0,16525,16525,0
Mobile,601824.0,GBR,3,3,234,16080,16314,0
E-Commerce,86928000.0,FRA,1,2,0,15157,15157,0
Biotechnology,57000000.0,USA,2,5,215,15981,16196,1
Information Technology,3500000.0,SWE,1,2,0,16339,16339,0
Finance|FinTech,50723650.0,USA,3,3,443,15826,16269,0
Mobile,18878570.0,USA,3,5,598,15340,15938,0
Enterprise Software|Loyalty Programs|SaaS,1053441.0,GBR,2,7,534,16129,16663,0
Software,11000000.0,USA,3,5,1864,12864,14728,1
Analytics|E-Commerce|Loyalty Programs,388852.0,GBR,2,6,597,15586,16183,0
Local Businesses,734871.0,GBR,2,1,383,16191,16574,0
Advertising,4400000.0,IND,1,1,0,15250,15250,0
Clean Energy|Clean Technology,34400000.0,USA,3,8,1863,14060,15923,0
Biotechnology,10000000.0,USA,1,3,0,16323,16323,0
Financial Services,30000000.0,USA,1,1,0,16757,16757,0
Information Services,30000000.0,USA,2,3,2335,10962,13297,0
Biotechnology,75000000.0,USA,4,14,1390,13573,14963,1
Internet Marketing|Search|Search Marketing|SEO,150000.0,USA,2,1,157,16338,16495,0
Mobile,6000000.0,USA,2,1,482,15814,16296,0
Finance|Security,140000000.0,USA,2,2,82,16540,16622,0
Hardware + Software,100000.0,USA,1,1,0,13786,13786,0
EdTech|Education,3000000.0,USA,2,8,963,15340,16303,0
Business Productivity|Collaboration|Enterprises|Enterprise Software|Messaging|Mobile|Unifed Communications,10000000.0,USA,4,32,818,15400,16218,0
Biotechnology|Clean Energy|Renewable Energies,98900000.0,USA,3,7,823,13413,14236,0
Clean Technology|Lighting|Security|Semiconductors,33378639.0,HKG,5,6,560,15498,16058,1
Hardware + Software|Photography|Video|Wearables,100000.0,USA,2,1,242,16495,16737,0
Finance|Market Research|News|Publishing,28000000.0,IND,2,2,7,16316,16323,0
Advertising|Advertising Platforms|Media,17400000.0,USA,4,9,1141,14043,15184,1
Energy Efficiency|Energy Management|Software,17328859.0,USA,3,6,1805,14460,16265,0
Clean Technology,1500000.0,USA,1,3,0,15688,15688,0
Clean Technology|Energy|Environmental Innovation|Innovation Engineering|Oil & Gas|Service Providers,275000000.0,USA,2,3,755,15378,16133,0
Collaboration|Enterprises|Enterprise Software|Internet,6000000.0,USA,2,9,1038,15181,16219,0
Business Intelligence|Software,15600000.0,USA,1,3,0,13726,13726,0
Hardware + Software|Innovation Engineering|Internet of Things|Service Providers|Social Media|Social Network Media,55000.0,UKR,3,3,335,16374,16709,0
Consulting,2250000.0,USA,1,1,0,14552,14552,0
Energy Efficiency|Lighting,34213869.0,USA,4,2,996,15340,16336,0
Software,40000000.0,ISR,4,9,1901,12784,14685,0
Advertising|Sales and Marketing,18734312.0,USA,3,5,928,14217,15145,1
Semiconductors,6510027.0,USA,3,2,1575,13452,15027,0
Health Care,250000.0,USA,1,1,0,15551,15551,0
Analytics|Cloud Computing|Enterprise Search|Open Source|Search,52999999.0,USA,6,15,2486,14271,16757,0
Software,2106600.0,ESP,1,2,0,15225,15225,1
E-Commerce|Internet|Promotional,1819746.0,FRA,1,5,0,16469,16469,0
E-Commerce,40000000.0,CHN,2,4,489,13421,13910,1
Analytics|Big Data|iPad|Real Time|Social Media|Visualization,500000.0,USA,1,5,0,15431,15431,1
Curated Web|Email|Events|Facebook Applications|Music|Search,350000.0,USA,1,1,0,14295,14295,0
Game,1600000.0,ISR,1,1,0,16209,16209,0
Games,3500000.0,USA,1,3,0,15475,15475,0
Apps|Concerts|iOS|Music|Social Media,20000.0,USA,1,1,0,16269,16269,0
Android|Apps|Games|iOS|Mobile|Web Development,1500000.0,USA,1,3,0,15882,15882,0
Biotechnology,3438286.0,SWE,1,3,0,13411,13411,0
Fitness|Health and Wellness|Hospitals,1050000.0,USA,3,2,250,16029,16279,0
Facebook Applications|Games,1500000.0,CAN,1,1,0,13618,13618,1
Games|Mobile Games|Video Games,434095.0,ESP,4,4,913,15431,16344,0
Green Consumer Goods|Hospitality|Organic Food|Specialty Foods|Ventures for Good,3809819.0,CAN,2,4,350,15901,16251,0
Financial Services|Internet,485000000.0,CHN,1,3,0,16541,16541,0
Technology,25000.0,USA,1,1,0,16205,16205,0
Collaborative Consumption|Peer-to-Peer,3800000.0,USA,1,5,0,16673,16673,0
Crowdfunding|Crowdsourcing|Social Commerce|Social Media|Social Network Media,300000.0,CHL,2,1,133,15359,15492,0
Kids,2100000.0,USA,1,1,0,16587,16587,0
Apps|Mobile,3500000.0,GBR,3,11,602,15286,15888,0
Fitness|Health and Wellness|Online Shopping,93000000.0,CAN,1,2,0,13131,13131,0
Consulting,40000.0,GBR,1,1,0,16041,16041,0
Software,3879600.0,BEL,1,1,0,14355,14355,0
Fashion|Wearables,70000.0,USA,1,2,0,16570,16570,0
Apps|Fitness|Mobile,104791.0,IRL,2,1,1369,14853,16222,0
Advertising|Android|Apps|Games|iOS|Mobile|Mobile Advertising|Technology,900000.0,USA,4,3,548,15461,16009,0
Finance|Public Transportation,813000.0,USA,4,8,563,14822,15385,0
Software,888840.0,DEU,1,2,0,15099,15099,0
Biotechnology,21716216.2162162,CHE,2,5,293,14126,14419,0
Cloud Management|Information Services|Information Technology,400000.0,USA,1,1,0,16722,16722,0
Industrial|Industrial Automation|Technology,100000.0,USA,1,1,0,16077,16077,0
Hardware + Software,3484698.0,GBR,3,5,1183,14729,15912,0
Education,2500000.0,USA,1,7,0,16526,16526,0
Biotechnology,70550150.0,USA,3,9,656,15484,16140,1
Clean Technology,27901875.0,USA,4,4,1489,13923,15412,1
Biotechnology|Health Care|Medical,120000000.0,ISR,1,2,0,13392,13392,1
Biotechnology,3650000.0,USA,2,3,548,15475,16023,0
Software,5000000.0,USA,2,5,79,12732,12811,0
Brokers|Design|Social Media,1135462.0,USA,2,1,402,15790,16192,0
Lighting|Semiconductors,8000000.0,USA,2,2,519,13969,14488,0
Nanotechnology,24000000.0,USA,1,1,0,11408,11408,1
Analytics,8481871.0,USA,4,3,835,15392,16227,0
Software,21901051.0,USA,5,1,5329,11408,16737,0
Clean Technology,4500000.0,USA,1,1,0,14092,14092,0
Hardware + Software,1340000.0,USA,1,2,0,13122,13122,0
In-Flight Entertainment,15000000.0,USA,2,5,1190,13388,14578,0
Design|DIY|Fashion|Image Recognition|Photography|Printing|Technology,388000.0,USA,2,1,855,15550,16405,0
3D Printing,64219.0,ITA,1,2,0,16336,16336,0
Mobile,4160000.0,GBR,2,2,41,15267,15308,0
Analytics|CRM|E-Commerce|Internet Marketing|Retail Technology|SaaS,600000.0,USA,2,2,297,16102,16399,0
Analytics|Big Data Analytics|Medical,10000000.0,USA,2,3,246,16078,16324,0
Clean Technology,3301826.0,GBR,1,2,0,15209,15209,0
Health Care,17199997.0,USA,3,17,1663,13059,14722,1
Software,350000.0,USA,1,8,0,15034,15034,0
Computer Vision|Consumer Internet|Image Recognition|Machine Learning|Photo Editing|Photography|Photo Sharing|Semantic Search,350000.0,USA,3,6,152,16100,16252,0
Software,23000000.0,USA,4,8,2484,12112,14596,0
Hardware + Software,500000.0,USA,2,2,513,15167,15680,0
Cloud Computing|Infrastructure|Security|Software,28799999.0,USA,4,6,704,15943,16647,0
Semiconductors,44000000.0,USA,3,4,933,12815,13748,1
Document Management|Electronic Health Records|Health and Wellness,2300000.0,USA,1,1,0,16415,16415,0
Advertising|Content,28450000.0,USA,3,18,1066,14327,15393,1
Health and Wellness|Health Care|SaaS,1000000.0,USA,1,2,0,15986,15986,0
Semiconductors,9000000.0,USA,1,2,0,13677,13677,0
Health Care,11000000.0,USA,1,2,0,13091,13091,1
Advertising,7999997.0,USA,2,5,492,15761,16253,0
Consumer Electronics|Manufacturing|Water|Water Purification,16000000.0,IND,1,1,0,16423,16423,0
Manufacturing|Semiconductors|UV LEDs,135826373.0,USA,4,13,2496,13269,15765,1
Analytics|Health and Insurance|Information Technology,14000000.0,USA,1,3,0,16693,16693,0
Software,17100100.0,USA,4,11,1311,15431,16742,0
Hardware + Software,300000.0,USA,3,9,677,15765,16442,0
Biotechnology|Health Diagnostics,2446977.0,GBR,2,3,1596,13524,15120,0
Biotechnology|Health Care|Pharmaceuticals,19500000.0,USA,2,2,455,16105,16560,0
Curated Web|Games,67500000.0,USA,4,15,1899,13675,15574,0
Digital Signage|Manufacturing,400000.0,CAN,1,4,0,16295,16295,0
Augmented Reality|Consumer Electronics|Hardware + Software|Technology,6000000.0,ISR,2,3,2570,12807,15377,0
Biotechnology|Hardware + Software,13115002.0,USA,2,1,1554,14630,16184,1
Games,514640.0,NLD,1,1,0,15901,15901,0
Medical Devices,2093440.0,CHE,1,1,0,16554,16554,0
Online Reservations|Restaurants,828626.0,CHE,2,2,1310,15095,16405,0
Clean Technology|Green Building|Lighting|Semiconductors,26252441.0,USA,4,1,513,15311,15824,0
Health Care|Medical|Therapeutics,2568912.0,USA,3,3,821,15887,16708,0
Energy|Oil & Gas|Sustainability,1000000.0,BRA,1,1,0,8856,8856,0
Pharmaceuticals,15000000.0,CHN,1,1,0,16595,16595,0
Advertising,40000.0,CHL,1,1,0,15750,15750,0
Software,2548428.63890125,USA,1,1,0,13797,13797,0
Design|E-Commerce|Furniture,6130400.0,FRA,2,2,514,14730,15244,0
E-Commerce,11000000.0,USA,1,9,0,15841,15841,1
Clean Technology,5034690.0,GBR,1,3,0,15754,15754,0
Biotechnology,90200000.0,USA,6,4,995,14410,15405,0
E-Commerce,8600000.0,JPN,2,2,210,15785,15995,0
Software|Systems,112500.0,USA,2,2,109,15413,15522,0
Energy,500000000.0,USA,1,1,0,16559,16559,0
E-Commerce|Flash Sales|Lifestyle|Online Travel|Travel,699397.0,SGP,2,3,429,15504,15933,0
Mobile Devices|Parking|Services|Transportation,25500000.0,USA,2,37,125,16366,16491,0
Manufacturing|Startups,6835529.56366536,DEU,1,3,0,16722,16722,0
Semiconductors,4000000.0,USA,1,1,0,15537,15537,0
3D Printing,4378778.97748213,NLD,2,8,548,16084,16632,0
Hardware + Software,55230131.0,USA,3,3,3388,10953,14341,1
Fashion,2400000.0,DEU,1,6,0,16036,16036,0
Software|Technology,102400000.0,RUS,2,2,558,15494,16052,1
E-Commerce,15600000.0,SGP,5,8,1167,15492,16659,1
Curated Web|Entrepreneur|Startups,600000.0,USA,1,4,0,15727,15727,0
Hardware + Software|Semiconductors,1000000.0,USA,1,1,0,16180,16180,0
Semiconductors,91081806.0,USA,4,16,2928,13222,16150,0
Enterprise Software,3850000.0,USA,2,2,218,16034,16252,0
Mobile,600000.0,USA,1,1,0,13446,13446,0
Fashion,2026500.0,DEU,2,4,1205,15020,16225,0
Fashion,1500000.0,USA,1,6,0,16483,16483,0
Travel|Vacation Rentals,16000000.0,CAN,2,2,994,15600,16594,0
Hardware + Software,15000000.0,USA,1,3,0,13640,13640,0
Internet|Software,49300000.0,USA,3,13,868,11956,12824,1
Travel,163741652.0,CHN,5,8,2342,14245,16587,0
Marketplaces|Mechanical Solutions|Sensors,24180000.0,CAN,4,9,2153,12006,14159,0
Hotels|Local Search|Online Reservations|Reviews and Recommendations|Ticketing,200000000.0,CHN,1,1,0,16188,16188,0
Cloud Computing|Software,3320000.0,USA,2,1,9,15461,15470,0
Health and Wellness,11430040.0,IND,3,4,366,16323,16689,0
Biotechnology,74892748.0,USA,4,4,2239,14369,16608,0
Networking|Services|Technology,8000000.0,ISR,1,2,0,11828,11828,0
Automotive|Cars|Mobile,35000.0,USA,1,3,0,16436,16436,0
Apps|Collaborative Consumption|College Campuses|Peer-to-Peer|Software|Transportation,1012500000.0,USA,8,36,2174,14396,16570,0
Analytics|Opinions,3798067.0,CAN,5,3,418,14651,15069,0
Pharmaceuticals,357170.0,PRT,1,1,0,15856,15856,0
Bio-Pharm,5900000.0,CAN,1,2,0,12236,12236,1
EdTech|Education,289000000.0,USA,2,7,728,15721,16449,1
Finance,40000.0,CHL,1,1,0,15911,15911,0
Hardware + Software|Health Care|Medical,2900000.0,USA,3,3,714,15706,16420,1
Lifestyle Products|Sports|Women,50000.0,USA,1,1,0,15271,15271,0
Fitness|Health and Wellness|Wearables,105000.0,USA,4,4,491,15867,16358,0
Information Technology,38100000.0,USA,2,8,111,16612,16723,0
Marketplaces,3784218.0,CAN,1,4,0,12607,12607,1
Clean Technology,17780090.0,GBR,2,3,750,14515,15265,0
Biotechnology|Medical,22000000.0,FRA,1,1,0,16211,16211,0
Biotechnology,24800000.0,USA,2,13,267,16202,16469,0
E-Commerce|Fashion|Technology,60521346.0,GBR,4,16,1641,14914,16555,0
Enterprise Software,4110000.0,GBR,3,3,238,16344,16582,0
Analytics|Data Integration|Internet Marketing|Predictive Analytics|Software,9300000.0,USA,4,9,744,15621,16365,0
Employment|Human Resources|Software,7200000.0,USA,1,2,0,16708,16708,0
Hardware|Hardware + Software|Photography|Software,150750000.0,USA,5,19,2273,14114,16387,0
Hardware + Software,69000000.0,USA,5,13,2793,12956,15749,0
Biotechnology|Renewable Energies,18700000.0,USA,2,3,428,15886,16314,0
Software,1013190.0,SWE,1,1,0,13664,13664,0
Social Media,1500000.0,USA,1,1,0,13634,13634,0
Internet,20352.0,KEN,1,1,0,16272,16272,0
Finance,11700000.0,SGP,1,2,0,15999,15999,0
Apps|Mobile|Software,700000.0,USA,2,5,104,15527,15631,1
SaaS|Software,30150000.0,USA,3,7,847,13678,14525,1
Agriculture|Information Technology|Social Entrepreneurship|Software|Telecommunications,235000.0,KEN,1,1,0,15989,15989,0
Cloud Computing|Document Management|Enterprises|Enterprise Software|Knowledge Management|Software,7843200.0,FIN,1,2,0,15825,15825,0
E-Commerce|Fashion|Online Shopping|Retail,32000000.0,USA,2,7,225,16518,16743,0
Environmental Innovation|Mobile|Renewable Energies,51450000.0,TAN,3,4,664,16107,16771,0
Advertising|Analytics,1250000.0,USA,1,3,0,16022,16022,1
Demographies|Mobile|Test and Measurement,18000000.0,USA,2,3,654,12418,13072,1
Mobile,3650000.0,USA,1,8,0,16071,16071,0
Design|Innovation Engineering|Manufacturing|Semiconductors|Solar,540000000.0,JPN,1,1,0,14638,14638,0
Mobile,2490000.0,NOR,1,1,0,13444,13444,0
Search,3330000.0,GBR,2,6,110,13097,13207,0
Manufacturing,6257937.0,GBR,1,1,0,15461,15461,0
Technology,1500000.0,ISR,1,2,0,12116,12116,0
Finance|Mobile,50729469.0,USA,6,2,1478,14061,15539,0
Mobile,100000.0,CHN,1,1,0,15706,15706,0
Hardware + Software,22570114.0,GBR,1,1,0,13406,13406,0
Energy,8000000.0,USA,1,3,0,13833,13833,0
Hardware + Software,3000000.0,GBR,1,1,0,15847,15847,0
M2M|Software,2800000.0,FRA,1,1,0,14389,14389,0
Biotechnology,768000.0,DEU,3,3,2683,13333,16016,0
Hardware + Software,719550.0,BRA,1,1,0,15177,15177,0
Mobile,4000000.0,USA,1,2,0,13237,13237,0
Enterprise Software,6500000.0,USA,1,1,0,13798,13798,1
Games|Media|Music|Video,10500000.0,USA,1,1,0,14300,14300,0
File Sharing|Media|Mobile|Music|Social Media,500000.0,CAN,1,4,0,16014,16014,1
Contact Centers|Customer Service|Public Relations|VoIP,4125014.0,USA,2,1,1533,13392,14925,1
Mobile|SaaS|Services,3000000.0,USA,1,4,0,12438,12438,0
Mobile,6000000.0,USA,4,7,1640,14839,16479,0
E-Commerce,1490000.0,FRA,1,2,0,14535,14535,0
Analytics|Big Data|Big Data Analytics|Data Integration|Enterprise Search|Enterprise Software|Internet of Things|Search|Semantic Search,17395000.0,USA,3,11,830,15746,16576,0
Big Data|E-Commerce|Marketing Automation|Monetization|Retail|Software,1200000.0,ISR,1,1,0,16071,16071,0
Biotechnology,232239.0,GBR,1,1,0,15825,15825,0
Biotechnology,34151008.0,USA,6,3,2042,14489,16531,1
Analytics|Big Data|Information Technology,17136.0,DNK,1,1,0,16571,16571,0
Software,597666.872103547,LUX,5,8,1522,15034,16556,0
Automotive,20000.0,USA,1,1,0,15949,15949,0
Enterprise Software|Internet|Software,34394995.0,USA,5,9,1319,14721,16040,1
Design|Fashion|Technology|Wearables,133317.0,MEX,2,4,1247,15279,16526,0
Hardware + Software,100000.0,USA,1,3,0,14812,14812,0
Chat|FreetoPlay Gaming|Games|MMO Games|Mobile Games|Social Games|Translation,88300000.0,USA,4,5,2684,13879,16563,0
Finance Technology|Innovation Engineering|Internet of Things,300000.0,USA,1,6,0,16292,16292,0
Developer APIs|Enterprises|Internet|Internet of Things,3000000.0,USA,1,3,0,16149,16149,0
Games|Video|Video Games,91550000.0,USA,7,19,2296,14189,16485,0
Agriculture|B2B|Construction|E-Commerce,1040000.0,USA,2,6,336,15859,16195,0
Consumer Internet|E-Commerce|Fashion,5900000.0,USA,2,4,419,16071,16490,0
Biotechnology,13000000.0,ISR,2,3,409,15065,15474,1
Hardware|Internet of Things|Manufacturing|SaaS,2700000.0,USA,3,1,665,15979,16644,0
Biotechnology|Health Care,57016500.0,USA,2,11,1720,13285,15005,1
Pharmaceuticals,22000000.0,USA,1,4,0,16498,16498,0
Advertising Platforms|Analytics|Mobile Advertising|Social Media,40000.0,CAN,1,1,0,16594,16594,0
Software,44000000.0,USA,1,2,0,10928,10928,1
Design|SaaS|Web Development,1480960.0,AUS,2,5,942,15364,16306,0
Heavy Industry|Manufacturing|Smart Building,650000.0,USA,1,1,0,16233,16233,0
Health Care,15125297.0,USA,4,4,1173,15551,16724,0
Consumer Goods|Energy|Fitness,766000.0,USA,2,2,1392,13325,14717,0
Internet,1100000.0,AUS,1,4,0,16714,16714,0
Artificial Intelligence|Computer Vision|Software,1500000.0,USA,1,2,0,16465,16465,0
E-Commerce|Online Auctions,6161968.0,GBR,1,1,0,14813,14813,0
Design|E-Commerce|Furniture|Home & Garden,81057005.0,GBR,4,11,1946,14689,16635,0
B2B|Business Intelligence|Direct Marketing|Direct Sales|Events|Internet Marketing|Sales and Marketing,300000.0,SAU,2,1,598,16111,16709,0
Apps|Development Platforms|Productivity Software,400000.0,USA,1,3,0,16450,16450,0
Software,50000000.0,USA,1,1,0,13157,13157,1
Mobile,9918168.0,USA,3,12,713,15267,15980,0
E-Commerce,4586000.0,BRA,2,4,527,15485,16012,0
Services,4000000.0,USA,1,7,0,12024,12024,0
Advertising,8800000.0,CHN,5,15,2526,13180,15706,0
Beauty|Health and Wellness,32100000.0,USA,3,10,882,15824,16706,0
Biotechnology,8000000.0,USA,1,3,0,16083,16083,0
Curated Web|Finance|FinTech|Web Tools,315000.0,USA,2,9,61,13726,13787,1
Customer Service|Predictive Analytics|SaaS|Sales and Marketing|Sales Automation,1128000.0,USA,2,1,162,16600,16762,0
Digital Media|Internet|News|Printing|SaaS|Software,613000.0,FRA,3,4,1083,14654,15737,0
Advertising Platforms|Mobile Advertising,3000000.0,RUS,1,1,0,15796,15796,1
Games,2470295.0,IND,3,5,962,15684,16646,0
Ad Targeting|Advertising|Location Based Services|Mobile|Tablets|Television,2334100.0,NLD,3,3,2043,13239,15282,0
Curated Web|Design|Freelancers|Marketplaces|Web Design,67460.0,ESP,1,1,0,15309,15309,0
Advertising|Enterprise Software|Internet Marketing,12500000.0,USA,3,2,326,16222,16548,0
Apps|B2B|Cloud Computing|Enterprises|Enterprise Software|Marketplaces,2704436.22349417,AUS,4,4,698,15584,16282,0
Health Care,35036612.0,USA,1,2,0,16658,16658,0
Public Transportation|Transportation,35000000.0,CHN,4,6,1272,15248,16520,0
Games,6000000.0,SWE,1,1,0,16022,16022,0
Advertising|Internet|Market Research|Real Time,6697317.0,USA,1,4,0,16314,16314,0
Corporate Training|Digital Entertainment|EdTech|Events|Software|Technology,3477555.0,FRA,4,2,1470,15065,16535,0
Health Care|Medical|Medical Devices,4000000.0,ISR,1,1,0,15677,15677,0
Databases|E-Commerce|Open Source,22500000.0,USA,1,1,0,14683,14683,1
Nanotechnology,15000000.0,DEU,1,1,0,16290,16290,0
Apps|Delivery|Service Providers,120000.0,USA,1,1,0,16405,16405,0
Photo Sharing|Social Network Media|Video,357894.0,ESP,2,2,184,16252,16436,0
Augmented Reality|Hardware + Software|Technology|Video|Wearables,592000000.0,USA,2,6,258,16106,16364,0
Cyber Security|E-Commerce|Internet of Things|Mobile Commerce|Mobile Security,2200000.0,USA,1,4,0,16674,16674,0
Professional Services,3634238.0,FRA,3,3,640,16067,16707,0
Accounting|Analytics|Big Data|Cloud Computing|Finance|Finance Technology|FinTech|SaaS|Software,790000.0,DNK,3,1,588,15932,16520,0
Travel,1490000.0,IND,1,1,0,14797,14797,0
Android|Apps|iOS|Kids|Mobile|Video,1080000.0,USA,2,7,118,16388,16506,0
Enterprises|Software|Software Compliance,27000000.0,USA,2,8,769,15168,15937,1
Games|Television,58475686.072211,SWE,3,1,847,15889,16736,0
Games,37500000.0,ISR,2,6,627,12614,13241,0
Software,3107303.0,GBR,1,2,0,14963,14963,0
Android|Apps|Curated Web|iOS|iPhone|Video|Video Editing,25000000.0,USA,4,9,1392,14730,16122,0
Software,155000000.0,USA,1,1,0,13149,13149,0
Software,2000000.0,USA,1,3,0,16107,16107,0
Manufacturing,14032336.0,GBR,1,2,0,15714,15714,0
News|Publishing|Software,369311.0,DNK,2,1,268,14858,15126,1
App Marketing|B2B|Cloud Computing|Cloud Management|Mobile|Mobile Commerce|Sales and Marketing,59767166.0,USA,2,2,481,15091,15572,0
Ad Targeting|Advertising,40250000.0,USA,4,23,2257,14319,16576,0
Application Platforms|Cloud Infrastructure|E-Commerce|Internet|Mobile Software Tools|PaaS|Retail Technology|Testing,171961.0,NLD,3,1,471,15991,16462,0
Business Services|Finance Technology,234615.0,PRT,1,1,0,16450,16450,0
Curated Web|Video,4584180.0,USA,8,14,2332,13545,15877,0
Ad Targeting|Advertising|CRM|Lead Generation|Optimization|Personalization,2500000.0,USA,1,1,0,14103,14103,0
Finance|Payments,1500000.0,USA,1,1,0,16071,16071,0
Software,100000000.0,USA,1,1,0,16337,16337,0
Semiconductors,30353274.0,USA,4,11,2722,13172,15894,0
E-Commerce|Fashion|Flash Sales,105000.0,CHL,1,1,0,15765,15765,0
Hardware + Software,5505903.0,GBR,2,4,271,15666,15937,0
Medical Devices,300038.0,PRT,1,1,0,16216,16216,0
Semiconductors,70273798.0,USA,4,7,1863,13643,15506,0
Fashion|Lifestyle|Price Comparison|Social Commerce,50000.0,USA,1,1,0,16009,16009,0
Internet|SaaS|Services,1950000.0,DNK,2,2,244,16161,16405,0
Mobile|News,13000000.0,USA,2,3,679,15371,16050,0
Search,21000000.0,USA,2,9,365,13149,13514,0
Education|Infrastructure|Universities,21600000.0,IND,3,3,1196,15065,16261,0
Automotive,45000000.0,IND,3,6,992,13496,14488,0
E-Commerce|Social Games,100000.0,USA,2,1,174,14975,15149,0
Mobile,2440000.0,CHN,1,1,0,15970,15970,0
Advertising|Creative|Design|Facebook Applications|Graphics|Media|Photo Editing|Social Media|Software|Twitter Applications|Video Streaming|Web Design,400000.0,USA,1,1,0,15045,15045,0
Industrial|Manufacturing|Nanotechnology,30000.0,CAN,2,2,101,16636,16737,0
Curated Web|Email|Media,35000000.0,USA,1,3,0,14173,14173,0
Curated Web,165000000.0,RUS,1,1,0,13568,13568,0
Email|iPhone|Messaging|Productivity Software|Task Management,5000000.0,USA,1,5,0,15285,15285,1
Apps|Business Productivity|Cloud Computing|File Sharing|Mobile|Productivity Software|SaaS|Software|Storage,2800000.0,GBR,2,8,653,15706,16359,0
Messaging,11500000.0,USA,2,6,909,12283,13192,1
Email|Messaging|Services,1100000.0,USA,2,8,497,14610,15107,1
Software,585000.0,FRA,1,1,0,13622,13622,0
Messaging,1020000.0,FRA,1,1,0,14853,14853,0
B2B|Developer APIs|Enterprise Software,17456000.0,FRA,5,10,1809,14822,16631,0
Marketing Automation|Postal and Courier Services|SaaS|Software,290000.0,USA,4,11,383,15856,16239,0
Mobile Commerce|Photography|Printing|Social Commerce,1050000.0,USA,1,1,0,15729,15729,0
Email|Messaging,3091250.0,USA,4,10,604,15978,16582,0
Software,543773.0,ESP,1,3,0,16231,16231,0
Email|Kids,700000.0,BEL,1,3,0,16344,16344,0
Apps|Chat|Enterprises,20000000.0,CHN,1,2,0,16296,16296,0
Web Hosting,10000000.0,NGA,1,1,0,13018,13018,0
Big Data|Finance Technology|Small and Medium Businesses,2250000.0,USA,1,2,0,15940,15940,1
CRM|Email Marketing|Local Businesses|Marketing Automation|Reviews and Recommendations|Small and Medium Businesses,66000000.0,USA,6,13,1384,15248,16632,0
Automotive|Consulting|Incubators|Startups,1000.0,USA,1,1,0,14919,14919,0
Cloud Computing|Virtualization,12500000.0,USA,3,5,802,15807,16609,0
Health and Wellness|Medical|Medical Devices,35000000.0,IRL,2,1,1063,15608,16671,1
Clean Technology,40000000.0,USA,1,1,0,13984,13984,0
Clean Technology,158684000.0,IRL,2,2,1820,14102,15922,0
Aerospace|Software,1270000.0,FRA,1,1,0,14740,14740,0
Business Services|Data Visualization|SaaS|Sales Automation|Software,12000000.0,USA,1,1,0,16120,16120,1
Fleet Management|Industrial Automation|Predictive Analytics,237784.0,LVA,2,2,455,16017,16472,0
Telecommunications,15000000.0,KNA,1,3,0,12209,12209,0
Home Renovation|Infrastructure Builders|Opinions|Real Estate|Reviews and Recommendations,127393.0,BGR,3,3,852,15584,16436,0
Food Processing|Manufacturing|Specialty Foods,16600000.0,IND,1,1,0,16165,16165,0
E-Commerce,158814.0,CHN,1,1,0,15400,15400,0
Human Resources|Recruiting,1412665.79004266,USA,5,5,457,16130,16587,0
Software,7500000.0,SGP,1,2,0,14286,14286,0
Colleges|Education|ICT|Universities,4030.0,POL,2,2,0,15979,15979,0
Games,69000000.0,USA,6,1,2232,13180,15412,0
Software,3000000.0,USA,1,2,0,13640,13640,1
Clean Technology,5000000.0,USA,1,1,0,14114,14114,1
Computers|Hardware|Hardware + Software|Tech Field Support,1000000.0,USA,1,2,0,13102,13102,0
Concerts|Music|Photography|Subscription Businesses|Video|Video on Demand,466691.0,DEU,1,1,0,15925,15925,0
Consumers|Health and Wellness|Lifestyle|Nutrition,835000.0,ISR,3,2,1096,15006,16102,0
Innovation Engineering|Robotics|Universities,25000.0,CHN,3,3,587,15391,15978,0
Apps|E-Commerce|Incentives|Internet|Mobile,176455.0,USA,3,1,359,15893,16252,0
Information Technology,600000.0,JPN,2,5,22,16310,16332,0
Event Management|Events|Mobile,442063.212875096,USA,3,4,792,15522,16314,0
Advertising,4385100.0,FRA,1,3,0,15090,15090,1
Advertising|Design|Internet|Social Media,1000000.0,USA,1,3,0,16332,16332,0
Transportation|Travel,28000000.0,IND,2,7,298,13496,13794,1
Advertising,12223336.0,USA,4,3,1450,13818,15268,0
DIY|E-Commerce|Events|Media,10000000.0,USA,2,8,799,15796,16595,0
Games,66000000.0,USA,4,15,1016,14944,15960,1
Manufacturing|Marketplaces,78051.0,DEU,1,2,0,15857,15857,0
Apps|Design|Jewelry,25000.0,USA,1,1,0,15273,15273,0
Consumers|Design|Designers|Furniture,25000.0,USA,1,1,0,15495,15495,0
Manufacturing|Marketplaces|Software,1000000.0,USA,2,12,599,15905,16504,0
Digital Media|DIY|E-Commerce|Lifestyle|Retail|Wholesale,1500000.0,USA,1,5,0,16252,16252,0
Commercial Real Estate|E-Commerce|Storage|Subscription Businesses,10100000.0,USA,2,18,216,15974,16190,0
E-Commerce|Manufacturing|Marketplaces,3850000.0,USA,2,2,364,16252,16616,0
3D Printing|Consumer Goods|Mobile Games|Toys,3870000.0,GBR,4,7,1435,15187,16622,0
Biotechnology|Medical Devices,70100000.0,USA,3,8,633,13550,14183,1
3D|Audio|E-Commerce|Fashion|Jewelry|Printing,19975.0,ITA,1,1,0,15963,15963,0
Social Media,5250000.0,ARE,1,1,0,13149,13149,1
Lifestyle|Mobile|Mobile Games,2100000.0,KOR,2,2,390,15779,16169,0
Software,24054998.0,USA,5,2,1598,15033,16631,0
Advertising|Banking|Credit Cards|Discounts|Incentives|Shopping,38800000.0,USA,9,24,2404,12996,15400,0
Consumer Goods|E-Commerce|Kids|Online Shopping,1000000.0,RUS,2,3,324,15187,15511,0
Industrial,405000.0,USA,4,5,395,16222,16617,0
Health and Wellness,228445.0,USA,1,1,0,16111,16111,0
Advertising|E-Commerce|Fashion|Mobile|Sales and Marketing|Social Commerce,4963403.0,GBR,4,13,1206,15432,16638,0
Consulting,5710000.0,FRA,1,1,0,13699,13699,0
Mobile,2000000.0,CAN,1,1,0,15399,15399,0
Software,30000000.0,USA,1,1,0,16261,16261,0
E-Commerce,7712082.0,CHN,1,1,0,15126,15126,0
Apps|Families|Gps|iPhone|Location Based Services|Mobile|Mobile Emergency&Health|Parenting|Social Media|Tracking,2100000.0,USA,2,1,872,15394,16266,0
Food Processing,10000000.0,IND,1,2,0,16629,16629,0
Social Media,4600000.0,USA,1,2,0,13118,13118,1
E-Commerce|Social Media Advertising,20000.0,USA,1,1,0,16162,16162,0
Accounting|Banking|Cloud Computing|Internet|SaaS|Software|Technology,1878026.0,DEU,2,3,750,15000,15750,0
Collaboration|Curated Web|File Sharing|Internet|Messaging|Productivity Software,62000.0,USA,1,1,0,16455,16455,0
Analytics|Big Data|Business Intelligence|Cloud Computing|Databases|Enterprise Software|SaaS|Software,1800000.0,BGR,1,1,0,16574,16574,0
E-Commerce,3100000.0,USA,1,7,0,16497,16497,0
Curated Web,3444000.0,JPN,2,3,445,15838,16283,0
Ad Targeting|Advertising|Advertising Platforms|Internet Marketing|Market Research|Mobile|Mobile Advertising,162000.0,AZE,2,1,351,15779,16130,0
Bridging Online and Offline|Commercial Real Estate,17425000.0,USA,3,28,311,16293,16604,0
Software,14500000.0,USA,2,5,338,13409,13747,1
Consulting,3000000.0,USA,1,3,0,13649,13649,0
Analytics,7000000.0,USA,1,2,0,14726,14726,0
Enterprise Software|Mobile|SaaS|Software,6000000.0,USA,1,1,0,16643,16643,0
Software,19000000.0,USA,2,7,405,12159,12564,0
Health and Wellness|Health Care|Health Care Information Technology|mHealth|Mobile|Mobile Health,190000.0,CAN,3,1,1400,15126,16526,0
Software,1000000.0,AUS,1,2,0,16054,16054,0
Delivery|Location Based Services|Shipping,1725000.0,BRA,2,5,516,16134,16650,0
Security,70000000.0,USA,1,3,0,15177,15177,1
Design,180000.0,CHL,2,1,1198,15448,16646,0
Games|Mobile|Social Games|Social Media,1216719.9442521,ITA,2,1,1034,15703,16737,0
Mobile,1322411.0,USA,2,1,595,14313,14908,0
Credit Cards|Internet|Mobile|Payments|Software,150000.0,ARG,1,1,0,16023,16023,0
Hardware + Software,8000000.0,ISR,3,5,2147,11142,13289,0
Games|Health and Wellness|Mobile,8300000.0,USA,3,11,659,15552,16211,0
Hardware + Software,6000000.0,USA,1,2,0,13571,13571,0
SaaS|Software,20000.0,USA,1,1,0,14669,14669,0
Mobile,10000000.0,RUS,1,1,0,16112,16112,0
Reviews and Recommendations|Search,7000000.0,KOR,3,6,717,15899,16616,0
Web Hosting,33000000.0,USA,2,7,1212,12159,13371,0
Web Hosting,14199999.0,USA,2,1,804,15891,16695,0
Health and Wellness,3700000.0,USA,1,1,0,15727,15727,0
Entertainment|Games|Media|Video|Video Streaming,24100000.0,USA,4,10,1251,12692,13943,0
Consulting,5000000.0,USA,1,3,0,16174,16174,1
Mobile|Social Media,100000.0,USA,1,1,0,15354,15354,0
Consulting,15000000.0,USA,2,2,2073,14270,16343,0
Advertising|E-Commerce|Facebook Applications|Personalization|Product Search|Social Media,3000000.0,USA,4,7,1003,15279,16282,0
Enterprise Software,529000.0,AUS,1,1,0,14599,14599,0
Nonprofits,152763.0,USA,1,1,0,16111,16111,0
Manufacturing,5303380.0,GBR,1,1,0,16124,16124,0
E-Commerce|Retail|Subscription Businesses,500000.0,USA,1,13,0,15187,15187,0
Curated Web|Professional Networking|Software,91204041.0,USA,3,1,458,14978,15436,0
Business Intelligence,1000000.0,CZE,1,1,0,15706,15706,0
Software,57794854.0,USA,6,16,1754,13784,15538,1
Clean Technology,7494980.0,SWE,3,6,1436,14425,15861,0
Analytics|Business Services,60000000.0,IND,1,2,0,16470,16470,0
Analytics|Big Data Analytics|Business Intelligence|Market Research,56700000.0,IND,7,15,2941,13573,16514,0
Nanotechnology,4531914.0,GBR,1,1,0,14797,14797,0
3D|Software|Technology,22200000.0,ISR,2,6,350,16239,16589,0
E-Commerce,20000.0,MEX,1,1,0,16485,16485,0
Cloud Computing|Information Services|Information Technology|Mobile,1276115.0,USA,2,1,303,15949,16252,0
Advertising,45000000.0,CHN,3,3,293,14833,15126,1
Software,13200.0,USA,1,1,0,15926,15926,0
Biotechnology|Medical|Pharmaceuticals,50000000.0,USA,1,6,0,13600,13600,1
Collaboration|Information Technology|Services,2600000.0,USA,1,1,0,12552,12552,0
Android|Apps|Collaboration|iPhone|Mobile|Software,100000.0,USA,2,2,81,15684,15765,1
Enterprises|Enterprise Software,30000000.0,CHN,3,4,2191,13088,15279,0
Design|Enterprise Software|Geospatial|Maps|Open Source,63175000.0,USA,3,9,999,15604,16603,0
Big Data Analytics|Databases|Data Visualization,2000000.0,USA,1,3,0,16357,16357,0
Enterprise Software,5100000.0,IRL,3,3,2391,13573,15964,1
Pharmaceuticals,10000000.0,ISR,1,1,0,16582,16582,0
Logistics|Maps|Visualization,53491.0,SVK,1,1,0,16010,16010,0
Crowdsourcing|Maps|Mobile,1500000.0,SWE,1,4,0,16450,16450,0
Software,20000.0,USA,1,1,0,16468,16468,0
Big Data|Geospatial|Maps|Search,1720000.0,USA,3,9,592,16069,16661,0
Gps|iPhone|Location Based Services|Navigation,1568000.0,USA,2,3,211,16071,16282,0
Advertising|Email|Network Security|Search|Semantic Search|Social Media,500000.0,USA,1,1,0,15431,15431,0
Consulting,4000000.0,USA,1,1,0,13132,13132,0
Consumer Electronics|E-Commerce|Home Automation,8039920.0,GBR,1,2,0,16356,16356,1
Maps,1000000.0,ISR,1,7,0,16609,16609,0
Android|Fitness|Health and Wellness|iPhone|Sports,23650000.0,USA,6,7,2361,13514,15875,1
Health and Wellness|Health Diagnostics,1123603.0,IND,1,4,0,16500,16500,0
Analytics|Big Data|Enterprise Software|Indoor Positioning|Location Based Services|Navigation|Retail|SaaS,3395000.0,CAN,3,1,1003,15522,16525,0
Semiconductors,510000.0,NLD,1,2,0,13663,13663,0
Software,2230000.0,FRA,1,2,0,13843,13843,0
Analytics|Big Data|Big Data Analytics|Cloud Computing|Enterprises|Open Source|Software,173999994.0,USA,5,16,1804,14447,16251,0
Internet Marketing|Software,1700000.0,LUX,1,1,0,16183,16183,0
Geospatial|Graphics|Maps,2500000.0,USA,2,6,489,16093,16582,1
Software,621641.0,USA,3,6,420,16191,16611,0
Curated Web|Finance|FinTech|Maps|Photography|Travel,140000.0,USA,3,3,177,15376,15553,0
Chemicals|Clean Technology|Services|Water,500000.0,USA,3,3,1269,13706,14975,0
Networking,51000000.0,USA,2,6,783,11674,12457,1
Clean Technology,500000.0,USA,1,3,0,15675,15675,0
Intellectual Asset Management|Intellectual Property|Licensing,56500000.0,USA,2,1,269,16201,16470,1
Software,27819986.0,USA,3,6,2014,12447,14461,1
Security,43200001.0,USA,4,5,1583,13149,14732,0
Biotechnology,16000000.0,USA,2,5,440,13208,13648,1
E-Commerce,6190000.0,GBR,1,1,0,14816,14816,0
Apps|Education|Mobile,2000000.0,USA,4,2,823,15856,16679,0
Customer Service|E-Commerce|Emerging Markets|Internet Marketing|Logistics|Marketing Automation|Mobile Infrastructure|Optimization|Services,1432000.0,BRA,2,6,365,15706,16071,0
Media|Mobile|News|Publishing,5596496.0,ESP,3,9,1107,15614,16721,0
Health Care,452550.0,USA,1,1,0,15612,15612,0
Curated Web|Finance,1962000.0,USA,7,13,1899,14669,16568,0
Curated Web,13300.0,USA,2,2,243,13514,13757,0
Clean Technology,1250000.0,USA,3,8,297,13924,14221,0
Fashion,20000000.0,USA,1,1,0,16668,16668,0
Advertising|Search Marketing|Technology,100268406.0,USA,9,21,2343,13426,15769,1
Biotechnology,7100000.0,USA,2,1,534,16125,16659,1
Travel,546941.0,ITA,2,2,392,15887,16279,0
Clean Technology,5596159.0,GBR,1,1,0,14600,14600,0
Biotechnology,52435690.0,USA,3,8,1345,14367,15712,1
Hardware + Software,1000000.0,USA,1,2,0,15887,15887,0
Consumer Goods|Health and Wellness|Wearables,3000000.0,USA,2,5,292,16303,16595,0
Software,12825000.0,USA,3,17,824,15826,16650,0
E-Commerce,2000000.0,TUR,2,1,365,15706,16071,0
Design|E-Commerce|Fashion|Flash Sales|Lifestyle|Retail|Shopping,15000000.0,JOR,3,10,541,14914,15455,0
E-Commerce,40000.0,CHL,1,1,0,15187,15187,0
Advertising|Enterprise Software,800000.0,USA,2,4,532,15552,16084,0
Finance|FinTech|Software|Technology,3695012.0,USA,5,1,1937,14426,16363,0
Analytics|Consulting|Market Research,47000000.0,USA,2,10,1666,13578,15244,0
Apps|Facebook Applications|Software|Twitter Applications,2550000.0,USA,3,1,720,15239,15959,0
Market Research,153000000.0,USA,1,1,0,16003,16003,0
Analytics,5500000.0,USA,1,1,0,13305,13305,0
Software,4000000.0,USA,1,2,0,14035,14035,0
Content|Curated Web|Enterprise Software|News|Sales and Marketing|Software,3000000.0,GBR,1,1,0,13537,13537,0
Analytics|Content|CRM|Internet Marketing|Payments|SaaS|Software|Web Hosting,1473000.0,USA,6,13,1096,14610,15706,0
Advertising,7575000.0,USA,3,9,708,14425,15133,0
Content|Marketing Automation|Software,2000000.0,CAN,1,1,0,16743,16743,0
Finance|Finance Technology|FinTech|Peer-to-Peer,28084311.0,GBR,4,6,1812,14883,16695,0
E-Commerce,20000000.0,USA,1,5,0,14004,14004,1
Analytics|B2B|Brand Marketing|Lead Generation|Lead Management|Optimization|Software,108400000.0,USA,6,16,1872,13422,15294,1
Marketing Automation,4600000.0,USA,1,3,0,16154,16154,0
Finance,16250000.0,USA,2,2,2051,13563,15614,0
E-Commerce|Facebook Applications|Marketplaces|Monetization|Shopping,1000000.0,USA,1,1,0,15187,15187,0
E-Commerce,7375157.0,AUS,1,2,0,16636,16636,0
Finance|Personal Finance,200000.0,USA,1,2,0,13893,13893,0
Analytics|Sales and Marketing|Software|Technology,10250000.0,USA,1,7,0,12335,12335,1
Analytics|Big Data Analytics|Enterprise Software|Marketing Automation|Predictive Analytics|SaaS,96000000.0,USA,6,3,1481,15078,16559,1
B2B|Consulting|Marketplaces|Network Security|Small and Medium Businesses,1000000.0,USA,1,2,0,15091,15091,0
Advertising|Advertising Platforms|Automotive|Lead Generation|Mobile,2662400.0,FRA,1,1,0,15400,15400,0
Software,891772.0,USA,4,1,793,14138,14931,0
Software,83000000.0,USA,2,9,459,13514,13973,1
Commodities|Energy,8020000.0,USA,2,5,1221,11169,12390,0
Software,1400000.0,USA,1,2,0,16441,16441,0
Advertising,28150000.0,CAN,4,31,4687,7638,12325,0
Analytics|Big Data|E-Commerce|Price Comparison|Retail,1600000.0,ISR,1,2,0,15614,15614,0
Finance,250000000.0,GBR,1,1,0,14635,14635,1
E-Commerce|Enterprise Software|Technology,7410000.0,USA,3,9,395,15650,16045,0
Data Centers,240000000.0,USA,1,1,0,16548,16548,0
Content|Enterprise Search|Enterprise Software|Web Development,175563361.0,USA,7,17,4878,11688,16566,0
Enterprise Software,12000000.0,USA,1,4,0,13279,13279,1
Search|SEO,386881.0,AUT,4,4,654,14777,15431,0
Financial Services,75000000.0,USA,1,1,0,16637,16637,0
Consumer Goods|Cooking|Groceries,10500000.0,DEU,3,6,316,16231,16547,0
Apps|Games|Mobile|Software,2000000.0,GBR,1,1,0,16624,16624,0
Finance Technology|Payments|Transaction Processing,45517900.0,USA,5,11,1596,15139,16735,0
Content|Digital Media|Software,7500000.0,CAN,1,2,0,13189,13189,1
Clean Technology,1300000.0,USA,1,2,0,13903,13903,0
Biotechnology|Chemicals,99150000.0,USA,6,16,3033,13635,16668,1
Biotechnology,500000.0,NZL,1,1,0,16125,16125,0
Advertising|Content|Design|E-Commerce|SEO|Web Design,2000000.0,USA,1,1,0,10957,10957,0
Media|News|Search|Software,100000.0,AUT,1,1,0,14276,14276,0
Communities|Curated Web|Marketplaces|Peer-to-Peer,301104.0,GBR,2,1,759,13879,14638,0
Advertising|Brand Marketing|Consumer Behavior|Promotional,41290000.0,USA,5,13,1768,14176,15944,1
B2B|E-Commerce Platforms|Marketplaces,500000.0,RUS,1,2,0,15789,15789,0
E-Commerce|Mobile Commerce|Mobile Enterprise,251333.0,USA,3,1,151,16071,16222,1
Design,2917935.0,GBR,3,11,652,16013,16665,0
Augmented Reality|Loyalty Programs|Mobile|Retail|Software|Virtualization,2700000.0,USA,5,7,1052,15154,16206,0
Clean Technology,100000.0,USA,1,1,0,15706,15706,0
Mobile|Mobile Commerce|Public Transportation|Security,8800000.0,GBR,3,5,904,14880,15784,0
Curated Web,4500000.0,USA,1,1,0,13752,13752,0
Energy,25107.0,FIN,1,1,0,16375,16375,0
Clean Technology,175800000.0,USA,5,12,1741,13464,15205,0
E-Commerce,65000.0,ESP,2,2,273,15949,16222,0
Concerts|Events|Online Reservations,570000.0,USA,3,3,101,15823,15924,0
Public Relations,61000000.0,USA,2,5,740,12118,12858,1
Digital Media|News|Technology,31000000.0,USA,3,14,3679,12784,16463,0
Software,200000.0,USA,1,1,0,16061,16061,0
Cloud Computing|Cloud Data Services|Developer APIs|Enterprise Software,1601000.0,USA,2,17,501,14700,15201,0
Advertising|Hardware|Hardware + Software|iPhone,100000.0,USA,1,1,0,14784,14784,0
Curated Web|Internet,876693.0,GBR,1,3,0,14995,14995,0
Games,475000.0,USA,2,1,191,14276,14467,0
Analytics|Developer APIs|Enterprises|Enterprise Software|SaaS|Services,34700000.0,USA,6,30,2030,13514,15544,1
Artificial Intelligence|Computer Vision|Retail Technology,120000.0,USA,1,2,0,16405,16405,0
Chat|Photography|Presentations|Video,653600.0,ESP,1,4,0,15825,15825,0
Analytics|Social Media|Software,1500000.0,USA,1,4,0,16196,16196,0
Hardware + Software,10931341.0,USA,4,1,1019,14503,15522,0
News,1200000.0,USA,1,5,0,15826,15826,0
Communities|Online Identity,25000.0,USA,1,1,0,16191,16191,0
Content|Curated Web|Real Time|Social Media|Twitter Applications,5500000.0,USA,2,11,513,14963,15476,1
Clean Technology,300000.0,USA,1,3,0,15953,15953,0
Semiconductors|Services,16500000.0,USA,1,1,0,11250,11250,0
Biotechnology|Clean Technology|Entrepreneur|Green|High Tech|Life Sciences|Nonprofits|Startups|Venture Capital,1500000.0,USA,1,1,0,16506,16506,0
E-Commerce|Social Commerce,47850000.0,USA,3,12,711,15949,16660,0
Games|Location Based Services|Mobile|Social Media,432979.0,CAN,3,2,319,14928,15247,0
Diabetes|Health and Wellness|Interface Design,2250000.0,USA,1,7,0,15007,15007,1
Apps|Education|Social Network Media,700000.0,USA,1,2,0,16358,16358,0
Finance|Financial Services|Insurance,6000000.0,USA,1,1,0,16247,16247,0
E-Commerce Platforms|Education|Video,40791.0,GBR,1,1,0,16331,16331,0
Cannabis|Mobile|Services,2050000.0,USA,5,2,555,16056,16611,0
Brand Marketing,50000.0,MEX,2,2,46,16430,16476,0
Employment|Identity|Recruiting|Social Media|Software,470000.0,GBR,1,8,0,15117,15117,0
3D|Hardware + Software,15000000.0,USA,1,1,0,15055,15055,0
Manufacturing,2050000.0,USA,2,4,561,15930,16491,0
Education|High Schools|K-12 Education|Skill Assessment,29125000.0,USA,6,15,2182,14518,16700,0
Big Data Analytics|Open Source|Real Time,19567.0,GBR,1,1,0,15522,15522,0
Games,120000.0,USA,1,1,0,14989,14989,0
Finance|FinTech,25000000.0,USA,1,1,0,16163,16163,0
Enterprise Software|Marketplaces|Mobility|Ride Sharing|Shared Services,27968.0,DEU,1,1,0,16496,16496,0
Curated Web|Internet TV|Reviews and Recommendations|Social Television|Television,20000.0,USA,2,2,288,15210,15498,1
Hospitality|Mobile|Restaurants,250000.0,USA,1,2,0,15383,15383,0
Enterprise Software,2500000.0,USA,2,4,457,15327,15784,1
Fashion,51251176.0,GBR,2,2,54,15604,15658,0
Finance,40000.0,USA,1,1,0,15301,15301,0
Content|Digital Media|Information Services|Information Technology|Intellectual Property|Public Relations|Publishing|SaaS|Software,572977.0,NLD,2,3,151,16344,16495,0
Ad Targeting|Lead Generation|Messaging|Mobile Advertising|Performance Marketing|Real Time|SaaS|Sensors,328697.0,DEU,1,9,0,16587,16587,0
Media|News|Reviews and Recommendations,10000000.0,USA,1,3,0,13757,13757,0
Analytics|Film,500000.0,USA,1,1,0,15370,15370,0
Location Based Services|Sports|Vertical Search,35000.0,USA,1,1,0,16084,16084,0
Clean Technology|Commodities|Green|Industrial|Recycling|Software|Sustainability,140000.0,USA,3,4,535,15404,15939,0
Collaborative Consumption|E-Commerce|Fashion|Online Shopping|Recycling|Retail|Specialty Retail,780000.0,USA,2,2,751,15685,16436,0
Hardware + Software,6583047.0,BEL,1,1,0,15691,15691,1
Health Care,1025000.0,USA,2,3,1442,14944,16386,0
Automotive|Cars|Service Providers,2860000.0,SEN,1,1,0,13809,13809,0
Apps|EdTech|Online Education|Tutoring,3500000.0,USA,2,6,134,16567,16701,0
Consumer Goods|Groceries|Internet,25069809.0,SWE,2,1,177,16435,16612,0
Software,3000000.0,USA,1,1,0,12851,12851,1
Accounting|Human Resources|Risk Management,24900000.0,USA,2,2,636,11915,12551,0
Education|Kids|Startups|Teachers,15000.0,USA,1,1,0,14761,14761,0
Consumers|Energy Efficiency|Wine And Spirits,1100000.0,USA,1,1,0,16647,16647,0
Web Hosting,52500000.0,USA,2,8,419,13347,13766,0
Advertising|Digital Media|Mobile|Online Video Advertising|Search Marketing|Social Media Advertising|Virtual Currency,17000000.0,ISR,1,2,0,14791,14791,1
Biotechnology|Engineering Firms|Technology,16227.0,NLD,1,1,0,16525,16525,0
Logistics|Supply Chain Management|Technology,34500000.0,USA,2,3,928,11323,12251,1
Classifieds|Curated Web,20400000.0,IND,2,5,553,13362,13915,0
Internet,12000000.0,USA,1,2,0,11409,11409,0
Hardware + Software,50000.0,USA,1,1,0,14747,14747,0
3D|Manufacturing|Semiconductors,52000000.0,USA,1,7,0,12128,12128,1
Software,33600000.0,USA,5,6,1539,14679,16218,0
Software,4278125.0,GBR,1,1,0,15050,15050,0
3D|Games|Printing,2000000.0,CAN,1,2,0,16301,16301,0
3D Printing|E-Commerce|Jewelry|PaaS,2808785.0,USA,2,1,593,16094,16687,0
B2B|Hardware|Manufacturing,5750000.0,USA,2,8,240,16342,16582,0
Big Data|Enterprise Software|Venture Capital,9900000.0,USA,4,59,792,15628,16420,0
Drones|Logistics|Robotics,3500000.0,USA,2,8,547,15463,16010,0
Cloud Computing|Computer Vision|Digital Media|Hardware + Software,56000000.0,USA,5,30,1271,15340,16611,0
Nonprofits,173210.0,USA,1,1,0,16113,16113,0
Health Care|Medical Devices|Women,6000000.0,USA,1,2,0,15614,15614,0
Medical Devices,30000000.0,FRA,1,3,0,13901,13901,0
Browser Extensions|Coupons|E-Commerce|iPad|iPhone|Marketplaces|Monetization|Online Shopping|Optimization|Real Time|Social Commerce,2000000.0,USA,1,11,0,16161,16161,0
Biotechnology|Health Diagnostics,1960000.0,USA,1,1,0,14886,14886,0
Apps|Health and Wellness|Health Care,2200000.0,USA,2,7,98,16534,16632,0
Enterprise Software,3000000.0,USA,2,1,726,14796,15522,0
Big Data Analytics|Business Analytics|Software,2297795.0,HUN,2,2,466,16128,16594,0
Facebook Applications|Games|Social Media,736443.0,IRL,5,2,724,15396,16120,0
Communications Hardware|Enterprise Software|Mobile Video|Technology,105258362.0,USA,6,19,2570,13334,15904,1
Software,10000000.0,USA,1,1,0,13416,13416,1
Credit Cards|Gift Card|Payments,1500000.0,USA,1,2,0,14235,14235,1
Brand Marketing|Hospitality,150000.0,USA,1,1,0,13149,13149,0
Biotechnology,6000000.0,USA,1,3,0,16077,16077,0
Advertising|Cars|Software,6900000.0,USA,3,1,730,14610,15340,0
Agriculture|Analytics|Image Recognition|Maps,80000.0,USA,3,10,608,15675,16283,0
Startups,1500000.0,BRA,1,1,0,16666,16666,0
Information Technology,11075781.4194537,GBR,1,1,0,13768,13768,0
Biotechnology,385000.0,USA,3,3,1395,13514,14909,0
Education,2400000.0,USA,1,1,0,15895,15895,0
Software,254000.0,FIN,1,2,0,13403,13403,0
Hardware + Software,10800000.0,USA,2,7,1870,12009,13879,1
Biotechnology,13900000.0,USA,3,3,3919,12501,16420,0
Hardware + Software|Networking|Storage,7000000.0,CAN,1,3,0,11702,11702,1
Semiconductors,20000000.0,USA,1,4,0,13542,13542,1
Advertising|Brand Marketing|Service Providers,11000000.0,USA,2,3,168,14866,15034,1
Manufacturing,11000000.0,CHN,2,3,609,13422,14031,0
Software,35000000.0,USA,2,4,176,16021,16197,0
Aerospace|Drones|Mobile,2662571.0,USA,4,4,574,15673,16247,0
Auto|Automotive|Cars,1407360.0,USA,2,1,192,15675,15867,0
Analytics|B2B|E-Commerce|Sales and Marketing|Technology,66086.0,LVA,1,1,0,15949,15949,0
Security,5000000.0,NOR,1,2,0,13122,13122,0
Employer Benefits Programs|Health and Insurance|Health Care|Mobile|SaaS|Technology,34400000.0,USA,3,20,486,15922,16408,0
Automotive|Business Services|Technology,25000000.0,USA,1,1,0,16622,16622,1
Clean Technology,42500000.0,USA,2,1,967,14109,15076,0
Analytics|Enterprise Software|Internet Marketing|Optimization|Personalization|Sales and Marketing,14777360.0,USA,3,5,1597,14264,15861,1
Social Media|Social Network Media,1000000.0,USA,1,7,0,13448,13448,1
Games|Mobile,250000.0,GBR,1,2,0,13848,13848,0
Employment|Recruiting|Small and Medium Businesses,489000.0,CHN,1,1,0,16314,16314,0
Software,100000000.0,RUS,1,3,0,15944,15944,0
Biotechnology,18100000.0,USA,2,1,389,15967,16356,0
Health Care|Medical Devices|Music,552825.0,DNK,1,1,0,16055,16055,0
Manufacturing,18000000.0,IND,1,1,0,16148,16148,0
Beauty|E-Commerce|Mobile Commerce|Retail,16000000.0,USA,3,14,859,15819,16678,0
iPad|Mobile|Publishing,1000000.0,USA,3,7,260,15658,15918,0
Enterprise Software,480000.0,USA,1,3,0,15165,15165,0
Security,7000000.0,USA,1,5,0,13186,13186,1
Business Services|Consulting|Education|Freelancers|Marketplaces|Project Management|Recruiting,6157154.0,GBR,4,8,1810,14883,16693,0
Clean Technology,86200000.0,USA,5,15,1384,13644,15028,0
E-Commerce,62000000.0,CHN,3,6,275,14700,14975,0
Mobile,1500000.0,USA,1,3,0,13970,13970,0
Mobile|SMS|Wireless,121842730.0,USA,7,25,3650,12608,16258,0
Active Lifestyle|Lifestyle|Social Commerce,136843.0,DEU,1,1,0,16135,16135,0
Information Technology|Medical|Services,54782.9135744755,SRB,1,1,0,16587,16587,0
Health and Wellness|Wearables,61208131.0,USA,7,17,1280,14792,16072,0
Customer Service|Outsourcing|Services,2785109.61963999,GBR,2,1,179,16491,16670,0
Mobile,6625990.0,NOR,1,2,0,16121,16121,1
Clean Technology,14116150.0,FRA,1,1,0,14886,14886,0
Finance,2450000.0,NLD,1,1,0,13640,13640,0
Messaging,10883200.0,CHE,1,1,0,15015,15015,0
Consulting,22000000.0,GBR,1,1,0,14614,14614,0
Consumer Internet,9800000.0,USA,2,1,185,13754,13939,0
Insurance|Risk Management,107000000.0,USA,1,1,0,16232,16232,0
Software,285000.0,AUS,1,1,0,14047,14047,0
3D Printing|3D Technology|Manufacturing|Photography,31299000.0,IRL,2,1,158,16079,16237,0
Clean Technology,16889360.0,FRA,1,3,0,14791,14791,0
Consulting|Education|Training,2500000.0,TUR,1,1,0,14974,14974,0
Software,2560000.0,TUR,1,1,0,14291,14291,0
Semiconductors,37000000.0,USA,2,8,5,16246,16251,0
Big Data|Doctors|Enterprise Software|Health Care|Medical,12300000.0,USA,4,5,1183,15371,16554,0
Electronic Health Records|Software,11543305.0,USA,3,1,438,14256,14694,0
Biotechnology,12000000.0,USA,1,1,0,15112,15112,0
High School Students|Innovation Engineering|Teaching STEM Concepts,500000.0,USA,1,2,0,16384,16384,0
Finance|Wealth Management,2950000.0,CHE,3,2,701,15095,15796,0
Software,12500000.0,CHN,2,2,1034,12084,13118,0
Health and Wellness,4935249.0,USA,2,1,2736,12006,14742,0
Medical,7500000.0,USA,1,2,0,12461,12461,0
Advertising,8027970.0,CAN,2,2,1428,13817,15245,1
Telecommunications|Wireless,18000000.0,USA,1,3,0,11241,11241,0
Health Care,73600000.0,USA,2,5,518,16092,16610,0
Health and Wellness,3000000.0,USA,1,1,0,16771,16771,0
Curated Web|Health Care,21543780.0,USA,4,2,1077,15491,16568,0
Clean Technology|Fitness|Rehabilitation,708054.0,DNK,1,2,0,15468,15468,0
Health and Wellness|Mobile|Security|Travel,1685000.0,USA,2,2,599,14011,14610,0
Alternative Medicine|Cannabis|Content Delivery|Mobile,120000.0,USA,1,2,0,16405,16405,0
Delivery|Food Processing,7200000.0,TUR,5,5,692,15959,16651,0
Consumer Goods|Fitness|Groceries|Health and Wellness,30000.0,CAN,1,1,0,16495,16495,0
Business Intelligence|Finance|Mobile|Restaurants|SaaS|Software,3787576.0,USA,12,3,1444,15187,16631,0
Food Processing,100000.0,IND,1,2,0,16728,16728,0
Enterprise Software,25000.0,USA,1,1,0,15742,15742,0
Data Integration|SaaS|Sustainability,4300000.0,USA,2,2,131,16315,16446,0
E-Commerce|Furniture|Internet|Shopping|Utilities,4000000.0,RUS,1,1,0,15645,15645,0
Apps|Gift Registries|Personal Data|Social Commerce|Weddings,137892.0,BRA,2,1,24,16323,16347,0
Advertising|Creative|Marketing Automation|Sales and Marketing,20000.0,ARE,1,1,0,15737,15737,0
Semiconductors,3240000.0,AUT,1,2,0,14179,14179,0
Civil Engineers|Construction|Infrastructure Builders,27027027.0,BRA,1,1,0,15322,15322,0
Software,300000.0,DEU,1,1,0,16503,16503,0
Software,1150000.0,USA,1,1,0,16500,16500,0
Mobile,350000.0,USA,2,2,405,15335,15740,0
Big Data|Customer Service|Enterprise Software|Human Resources|Loyalty Programs|Software|Text Analytics,255000000.0,USA,4,3,1027,15610,16637,0
Analytics,4766772.0,USA,8,2,1365,14734,16099,0
Analytics|Web CMS,5300000.0,USA,2,1,796,15508,16304,0
EdTech|Education,10293718.0,GBR,4,6,1694,14607,16301,0
Software,6000000.0,USA,1,1,0,14322,14322,0
Biotechnology,1802640.0,USA,2,1,481,15828,16309,0
Health Care|Marketing Automation|Publishing,57285.0,GBR,2,1,106,16130,16236,0
Biotechnology,37082152.0,CAN,2,6,1372,14987,16359,0
Pharmaceuticals,22000039.0,USA,2,2,2582,14062,16644,0
Health Care,1000000.0,ISR,1,2,0,16345,16345,0
Hardware + Software,8425125.0,USA,4,8,1133,15492,16625,0
Biotechnology|Health Care|Life Sciences|Media|News,310000.0,USA,2,3,759,14214,14973,0
Health and Wellness,18900000.0,USA,5,6,2080,14550,16630,0
Health Care|Physicians|Technology,220773.0,CAN,2,1,1960,14592,16552,0
Delivery|Health Care|Hospitals,150000.0,IND,2,1,114,16617,16731,0
Biotechnology,10468800.0,FRA,1,1,0,15805,15805,0
Email|Health and Wellness|Medical|Search|Web Tools,750000.0,USA,1,7,0,15484,15484,0
Analytics,57000000.0,USA,2,2,1580,12509,14089,1
Life Sciences,165000.0,USA,1,1,0,13341,13341,0
Health and Wellness|Health Care|Software,40000.0,USA,1,2,0,15706,15706,0
Doctors|Health Care|Pharmaceuticals,500000.0,IND,3,6,598,15908,16506,0
Health Care,40000.0,CHL,1,1,0,15751,15751,0
Billing|Curated Web|Health and Wellness|Health Care|Medical|Portals|SaaS|Services|Software,3000000.0,USA,1,2,0,16675,16675,1
Biotechnology,45626066.0,ISR,7,3,5105,11495,16600,1
Health Care|Hospitals|Medical,24000000.0,IND,2,2,413,16225,16638,0
Software,77500000.0,USA,1,3,0,16078,16078,0
Advertising|Analytics|Displays|Mobile,1780000.0,USA,2,10,285,15095,15380,1
Curated Web,1050000.0,USA,2,2,406,14623,15029,0
Media,1500000.0,USA,1,1,0,16442,16442,0
Advertising,28587030.0,GBR,1,1,0,15075,15075,0
Advertising,250000.0,USA,1,1,0,13968,13968,0
Software,1300000.0,USA,1,3,0,12263,12263,0
Information Technology|Media|News|Social News,4475000.0,IND,2,4,108,16084,16192,0
Cloud Computing|Cloud Management|Web Hosting,16086016.0,USA,2,2,972,14720,15692,1
Software,1150000.0,FRA,1,1,0,13711,13711,0
Advertising,52000000.0,USA,4,12,2295,14000,16295,0
Advertising|Software,40500000.0,USA,3,3,365,13717,14082,1
Media|Semantic Search|Video,6333522.0,USA,2,2,1137,15431,16568,0
Advertising,6200000.0,ISR,2,2,316,13744,14060,0
Advertising|Apps|Brand Marketing|Games|Mobile|Mobile Advertising|Sales and Marketing|Social Media|Tablets,11500000.0,USA,4,4,880,15099,15979,0
Content|Curated Web|Education|Mobile|Video|Video Streaming|Web CMS,6500000.0,CAN,3,8,1293,15196,16489,1
Advertising|Digital Media,6650000.0,USA,2,1,297,15708,16005,0
Advertising Exchanges|Advertising Platforms,594224.0,GBR,3,1,227,16299,16526,0
Entertainment|Technology,5290000.0,USA,4,1,1176,15187,16363,0
Software,1320000.0,DEU,1,2,0,13502,13502,0
Online Video Advertising,22484005.0,DEU,1,3,0,16261,16261,0
Advertising|Media|Mobile,33400000.0,USA,5,8,1701,14376,16077,0
Advertising|Business Services|Consulting|Content|Entertainment|Investment Management|Sales and Marketing|Social Media|Technology,3350000.0,USA,1,1,0,9129,9129,0
Software,4200000.0,FRA,1,2,0,12871,12871,1
Curated Web,9400000.0,USA,1,1,0,13756,13756,0
Public Relations,11500000.0,USA,1,1,0,10988,10988,1
Advertising|Internet|Technology,207500000.0,USA,6,11,2281,13943,16224,0
Advertising,38000000.0,USA,2,4,1206,12387,13593,0
Advertising|Digital Media,38000000.0,USA,2,3,1186,12387,13573,1
Software,23000000.0,USA,4,4,1318,15006,16324,0
Pharmaceuticals,32383972.0,FRA,5,9,3317,12723,16040,0
Delivery|Hospitality,1000000.0,IND,1,1,0,16353,16353,0
Finance,10300000.0,USA,2,1,238,16077,16315,0
Biotechnology,528336.0,PRT,1,1,0,15896,15896,0
Advertising|Software,2250000.0,USA,2,3,62,15365,15427,0
Semiconductors,13000000.0,USA,2,3,682,13231,13913,0
Enterprise Software|Mobile Video|Software|Video Streaming,25750000.0,USA,5,9,3503,13149,16652,0
Education,5000000.0,USA,1,1,0,16546,16546,0
Mobile|Semiconductors|Wireless,38400000.0,USA,2,11,724,11173,11897,1
Entertainment|Media|Sports,4900000.0,MLT,1,4,0,16630,16630,0
Customer Service|Enterprise Software|Sales and Marketing|Social Media|Twitter Applications,500000.0,USA,1,2,0,15106,15106,0
Advertising,10000000.0,CHN,1,1,0,15156,15156,0
Software,2250000.0,USA,1,1,0,15728,15728,0
Advertising|Auctions|Mobile|Tablets,3485917.0,ESP,2,5,809,15887,16696,0
Software,35800000.0,USA,1,1,0,15910,15910,0
Advertising|Games|Mobile Games|Social Games,5200000.0,USA,3,17,794,15219,16013,0
Games,21500000.0,USA,3,2,4115,10957,15072,0
Video Streaming,1700000.0,CHL,1,1,0,16094,16094,0
Software,1460000.0,GBR,1,1,0,13927,13927,0
Advertising|App Marketing|Email Marketing|Internet Marketing|Lead Generation|Media|Performance Marketing|Search Marketing|Semantic Search|SEO|Social Media Advertising|Sports,21000000.0,USA,2,3,294,14735,15029,0
Advertising,15000000.0,CHN,2,2,268,14843,15111,0
Advertising|Broadcasting|Content,4715000000.0,USA,2,6,1052,12233,13285,1
Broadcasting|Delivery|Media,10000000.0,USA,1,2,0,13970,13970,1
Biotechnology,30958000.0,USA,4,2,968,15706,16674,0
Health and Wellness,40000.0,CHL,1,1,0,15751,15751,0
Biotechnology,10000000.0,CAN,1,1,0,14742,14742,0
Health Care,115000000.0,USA,1,1,0,15986,15986,0
Health Care,7000000.0,USA,3,2,1008,14553,15561,0
Health Care,40000.0,CHL,1,1,0,15379,15379,0
Health and Wellness,605352.0,PRT,1,1,0,16168,16168,0
Health Care,7500000.0,USA,1,3,0,15609,15609,0
Curated Web,32500000.0,USA,2,2,244,15517,15761,0
Enterprise Software,23660573.0,CAN,5,3,1685,14111,15796,0
Pets,24075206.0,GBR,2,3,587,14883,15470,0
Clinical Trials|Health Care|Health Care Information Technology,250000.0,RUS,1,1,0,15918,15918,0
Health and Wellness|Health Care|mHealth,1940000.0,USA,2,13,193,16017,16210,0
Biotechnology|Medical Devices,634306.0,DNK,2,2,1007,14939,15946,0
Biotechnology,9091508.0,GBR,1,1,0,16058,16058,0
Biotechnology,20000000.0,USA,1,1,0,15572,15572,1
Enterprise Software|mHealth|Mobile Health,40000.0,USA,1,1,0,15539,15539,0
Software,3271224.0,USA,3,1,621,13958,14579,1
Health and Wellness|Software,9650000.0,USA,2,1,368,15134,15502,0
Biotechnology,21000000.0,USA,2,2,1616,12810,14426,0
Health Care,2300000.0,USA,2,1,411,14797,15208,1
Health Care,40257500.0,USA,2,1,654,15713,16367,0
Health and Wellness|Health Care|Hospitals|Marketplaces,12222661.0,DEU,3,4,366,16040,16406,0
Medical,450326.03605009994,GBR,1,1,0,13021,13021,0
Health and Wellness,40000.0,CHL,1,1,0,15940,15940,0
Education|Medical|Publishing,6327003.0,GBR,2,3,292,16201,16493,0
Legal,1200000.0,USA,3,6,832,15540,16372,0
Health Care,100000.0,IND,1,1,0,16762,16762,0
Health and Wellness,301953.0,IND,1,6,0,16759,16759,0
Health Care,27000000.0,USA,1,2,0,13837,13837,1
Pharmaceuticals,13800000.0,USA,1,9,0,11694,11694,0
Analytics|Cloud Data Services|Games|Mobile|Retail Technology|Telecommunications,41000000.0,USA,2,4,397,13071,13468,1
Human Resources|Recruiting|Virtual Workforces,40000.0,CHL,1,1,0,16222,16222,0
Biotechnology,645000.0,USA,2,1,54,14561,14615,0
Biotechnology|Health Care|Therapeutics,43654112.0,USA,4,8,1594,13314,14908,0
Cloud Computing|Health Care Information Technology|Mobile|Software,7000000.0,USA,3,10,967,15475,16442,0
Software,1000000.0,FIN,1,4,0,14761,14761,0
Biotechnology,1500000.0,USA,1,5,0,12831,12831,0
Hospitality,6000000.0,IND,1,1,0,15953,15953,0
News,82000000.0,USA,2,22,608,16098,16706,0
Biotechnology,31070000.0,USA,2,4,699,13721,14420,1
Dental|Fitness|Health and Wellness|Medical|Medical Devices,870000.0,GBR,1,1,0,16282,16282,0
Big Data Analytics|Health Care,22745000.0,USA,3,7,669,15204,15873,0
Biotechnology|Hospitals|Medical,18000000.0,ISR,1,1,0,15879,15879,1
Health and Wellness|Health Care Information Technology|Transportation,1275388.0,USA,3,4,631,15340,15971,0
Health and Wellness,32999999.0,USA,4,3,593,14867,15460,0
Services,40000000.0,JPN,1,1,0,16686,16686,0
Hardware + Software|Health and Insurance|Health Care|Mobile Payments,250000.0,USA,1,2,0,15857,15857,0
Health Care,4722200.0,ESP,1,2,0,15309,15309,0
Health Care,24750000.0,USA,4,13,2221,11533,13754,1
Pharmaceuticals,28000000.0,USA,1,2,0,12538,12538,0
Software,4000000.0,USA,1,1,0,16265,16265,0
Analytics|Health Care,16000000.0,USA,3,2,827,14830,15657,0
Apps|Big Data|Electronic Health Records|Enterprise Software|Hospitals|Internet of Things|mHealth|Mobile,2800000.0,GBR,3,2,778,15364,16142,0
Medical Devices,5696202.0,DNK,1,1,0,14396,14396,0
Health Care,2100000.0,USA,1,2,0,13580,13580,1
Fitness|Healthcare Services|Medical,18947.0,COL,1,1,0,16211,16211,0
Finance Technology|Health Care|Medical|Personal Finance|SaaS,280000.0,USA,1,1,0,16630,16630,0
Health and Wellness,1796534.0,ESP,2,3,726,15870,16596,0
Health and Wellness|Software,2026196.0,USA,1,3,0,15278,15278,0
Biotechnology|Hardware,134300000.0,USA,7,1,1447,15299,16746,0
Software,250000.0,CAN,1,1,0,15364,15364,0
Health Care,8000000.0,USA,1,2,0,13999,13999,1
Health Care,36004847.0,USA,8,2,1795,14501,16296,0
Health Care,1699000.0,USA,7,10,980,15765,16745,0
Health Care,300000000.0,USA,1,1,0,14923,14923,0
Software,39252578.0,USA,6,8,3785,12810,16595,0
Automotive|Biotechnology|Crowdfunding|Finance|Health and Wellness|Incubators|Medical Devices|Venture Capital,50000.0,USA,1,2,0,15580,15580,0
Information Technology,1500000.0,USA,1,1,0,16359,16359,0
Consulting,114000000.0,USA,3,1,3263,12635,15898,1
Medical Devices,2002616.0,FRA,1,1,0,14722,14722,1
Medical|Medical Devices|Women,750000.0,CAN,1,1,0,15492,15492,0
Health and Wellness|Health Care|Health Care Information Technology,2210000.0,USA,3,5,1321,15309,16630,0
Health Care,100000.0,USA,1,1,0,15778,15778,0
Consulting|Health and Wellness|Health Care|Information Technology,863205.0,CHE,1,3,0,15309,15309,0
Biotechnology,4900000.0,CAN,9,15,4599,11284,15883,0
Software,28400000.0,USA,6,9,1837,13431,15268,0
Health Care|Healthcare Services,10000000.0,IND,1,2,0,16589,16589,0
Artificial Intelligence|Data Mining|Health and Wellness|Health Care|Medical|Search|Semantic Search,590000.0,USA,3,5,1416,15079,16495,0
Health and Wellness|Health Care|Medical,27000.0,IRL,1,1,0,15957,15957,0
Health Care,400000.0,IND,1,1,0,16078,16078,0
Navigation|Sensors|Tracking,2412571.0,CHE,1,5,0,16465,16465,0
Chat|Curated Web|Internet|Messaging|Social Network Media|Web Development,70000000.0,USA,5,15,1906,13057,14963,1
Doctors|Health Care|Video,5346153.0,FIN,2,1,251,16303,16554,0
Curated Web|Digital Media|E-Commerce|Publishing,2400000.0,USA,2,1,277,15562,15839,0
Email|Mobile|Mobile Enterprise|Online Scheduling|Productivity Software,870000.0,ISR,1,1,0,16380,16380,0
Business Analytics,3000000.0,USA,3,4,1347,15065,16412,0
Mobile|Mobile Video|Video Streaming,18200000.0,USA,4,32,815,15706,16521,0
Health and Wellness,50000000.0,CHN,3,4,449,15796,16245,0
Social Media,52500.0,CHL,2,2,759,15646,16405,0
Mobile|Software|Travel,1814010.0,USA,2,1,321,16280,16601,0
Auctions|Events|Meeting Software,16787.0,NLD,1,1,0,16495,16495,0
Entertainment|Match-Making|SexTech|Social Media,25000.0,USA,1,1,0,15431,15431,0
Curated Web|Video,1800000.0,USA,2,10,491,14674,15165,1
Business Travelers|Hospitality|Hotels|Online Travel|Travel,1271800.0,IRL,3,4,1113,15252,16365,0
Software,3000000.0,USA,1,1,0,13754,13754,0
Hardware|Hardware + Software,3729074.0,USA,2,1,329,15896,16225,0
Travel,13150000.0,USA,2,3,838,14090,14928,0
E-Commerce,500000.0,USA,1,2,0,15639,15639,1
Location Based Services|Mobile|Online Dating|Real Time|Social Media,5575000.0,USA,4,4,1157,13665,14822,0
Telecommunications,316209.0,GBR,1,1,0,16427,16427,0
Advertising,1300000.0,DEU,2,4,855,15553,16408,0
Analytics|Apps|Education|SaaS,950000.0,IND,1,1,0,16574,16574,0
Communities|Social Media,18300000.0,USA,5,12,4098,12022,16120,0
Games|Video,25000000.0,USA,4,14,942,12815,13757,1
Internet|Social Media,15000.0,USA,1,1,0,15095,15095,0
Cloud Computing|Computers|Finance|Human Resources|SaaS|Software,90000.0,DNK,1,1,0,15614,15614,0
3D|Entertainment|Games|Messaging,10200000.0,USA,3,5,973,12784,13757,0
Energy|Oil,44179754.0,CAN,1,1,0,12502,12502,0
Adventure Travel|Augmented Reality|Games|MMO Games|Mobile|Transportation,275000.0,USA,2,1,216,16001,16217,0
Manufacturing,24692000.0,USA,1,1,0,15554,15554,0
Data Security|Information Technology|VoIP,26298436.0,USA,3,5,3962,12570,16532,1
Digital Media|Publishing|Service Providers,5000000.0,CAN,1,4,0,11464,11464,0
Delivery|Subscription Service,18000000.0,USA,1,5,0,11603,11603,0
Face Recognition|Games,99000000.0,CHN,6,8,665,15904,16569,0
Curated Web,8130000.0,CHN,1,4,0,16152,16152,0
Hospitality|Manufacturing|Online Reservations,33000000.0,CHN,3,7,1161,15371,16532,0
Fashion,30000000.0,CHN,2,6,441,16308,16749,0
E-Commerce|Furniture,40000000.0,CHN,1,6,0,15499,15499,0
Consulting,162364.0,CHN,1,1,0,15796,15796,0
E-Commerce,30000000.0,CHN,5,10,1350,14944,16294,0
Mobile,1210000.0,FRA,1,1,0,13235,13235,0
Real Estate,2908200.0,FRA,2,1,562,14031,14593,0
Renewable Energies,3240000.0,CHN,1,1,0,16300,16300,0
Curated Web|Internet|Mobile|Retail|Sales and Marketing,3929098.61819979,AUT,2,10,457,15857,16314,0
Mobile|Social Media,360000000.0,CHN,3,8,1401,15034,16435,0
Discounts|E-Commerce|Group Buying|Internet|Online Shopping,1070000000.0,CHN,4,9,1632,14822,16454,0
Software,1000000.0,CHN,1,1,0,16071,16071,0
Android|Hardware|Mobile|Mobile Commerce,890000000.0,CHN,2,1,202,16273,16475,0
Curated Web,20000.0,MEX,1,1,0,16130,16130,0
Crowdsourcing|E-Commerce|Fashion|Jewelry,43889.0,CAN,1,1,0,16405,16405,0
Apps|Internet|Restaurants|Search,3227861.0,TUR,1,1,0,15841,15841,1
Hardware + Software,2830520.0,FIN,1,2,0,16134,16134,0
Fashion,3000000.0,USA,1,1,0,16132,16132,0
Marketplaces|Nightclubs|Restaurants,170353.0,USA,2,2,352,15505,15857,0
Internet|Mobile|Music,100000.0,USA,1,5,0,16101,16101,0
Consumer Internet|Enterprise Software|IT Management,1000000.0,USA,1,4,0,15903,15903,1
Apps,300538.979534392,KOR,1,3,0,16734,16734,0
Biotechnology,282500000.0,USA,7,19,2327,14269,16596,0
Biotechnology,5816599.0,USA,5,2,2934,12808,15742,0
Apps|Mobile,690819.69045024,BGR,3,3,427,16252,16679,0
Advertising|Coupons|Discounts|E-Commerce,240000.0,BRA,3,7,1604,15074,16678,0
Big Data|Cloud Computing|Semiconductors,56000000.0,USA,1,14,0,11729,11729,1
Analytics,48349999.0,USA,4,1,722,14510,15232,0
Marketplaces|Social Network Media,205000.0,ARE,1,4,0,16563,16563,0
Music,7900000.0,USA,1,2,0,13804,13804,1
Apps|iOS|Messaging,900620.0,FIN,1,1,0,16161,16161,0
Music,250000.0,USA,1,1,0,14699,14699,0
Hardware + Software,331000.0,USA,5,3,602,15391,15993,1
Bitcoin,1175000.0,HKG,1,5,0,16353,16353,0
Internet|News|Social Media|Social Network Media,15620074.330029199,FRA,2,4,1238,15527,16765,0
Health and Wellness,28753.0,AUS,1,2,0,15870,15870,0
Software,2500000.0,USA,1,2,0,15974,15974,0
Nonprofits,4800000.0,USA,2,2,455,16069,16524,0
Hardware|Manufacturing,24860000.0,CHN,3,3,947,15340,16287,0
Beauty|Curated Web|E-Commerce|Services,30720000.0,USA,4,39,457,16048,16505,0
Health Care|Internet|Software,24390.243902439,BRA,3,2,415,15706,16121,0
Mobile|Speech Recognition,2131303.0,USA,3,4,549,14791,15340,0
Enterprise Software|Security,27500000.0,USA,5,11,2097,12887,14984,1
Flash Storage|Software|Storage,11100000.0,USA,3,2,771,13514,14285,0
Curated Web|Email|Printing|Textbooks,597320.0,ITA,3,3,558,15561,16119,0
Games,100000.0,USA,1,1,0,15254,15254,0
Biotechnology,2300000.0,CHE,1,3,0,16638,16638,0
Biotechnology|Health Diagnostics,720000.0,BEL,1,1,0,13088,13088,0
Software,1470000.0,FRA,1,1,0,13886,13886,0
Mobile|Photography|Photo Sharing|Social Media,6718000.0,USA,4,24,1420,14975,16395,0
Semiconductors,5100000.0,USA,1,1,0,14886,14886,1
Curated Web,2500000.0,USA,2,3,415,14864,15279,0
Curated Web|Productivity Software|Software,2700000.0,CHE,3,5,1140,14245,15385,0
Education|Games,4600000.0,DEU,2,5,204,16316,16520,0
Biotechnology|Medical Devices|Neuroscience,41000000.0,USA,2,1,554,13047,13601,1
Hardware + Software,10500000.0,ISR,1,5,0,13103,13103,0
Consumers|Education|Finance|Hardware|Language Learning,6278000.0,GBR,5,8,828,14853,15681,0
Public Relations,1330000.0,AUS,1,1,0,13098,13098,0
Manufacturing,1900000.0,CHN,2,2,1362,10592,11954,1
Analytics|Databases,45000000.0,USA,4,25,1172,15167,16339,0
Healthcare Services|Life Sciences|Medical,250000.0,USA,2,1,70,16085,16155,0
Technology,8000000.0,USA,1,3,0,12095,12095,0
Fashion|Mobile|Online Shopping,388890.0,ESP,3,3,248,16188,16436,0
Agriculture|Biotechnology,20234078.0,USA,2,4,1610,13677,15287,1
Social Media|Social Network Media,2125000.0,GBR,2,5,1058,14300,15358,1
Software,34700000.0,USA,3,12,1007,12507,13514,0
Health and Wellness,26527436.0,FIN,4,7,1112,15146,16258,0
Agriculture|Promotional|Water,7367387.0,CHN,1,1,0,14791,14791,0
E-Commerce|Fashion|Technology,140000.0,USA,1,1,0,16640,16640,0
Software,6500000.0,ISL,1,4,0,15897,15897,0
Computers|Networking|Security,35000000.0,USA,2,6,202,16392,16594,0
Consumer Goods|E-Commerce|Fashion|Lifestyle|Lifestyle Products|Retail,38206353.653119706,GBR,3,6,917,15461,16378,0
Legal|Outsourcing|Services,230337.0,COL,4,4,608,15918,16526,0
Advertising|Advertising Platforms|E-Commerce,4700000.0,USA,2,6,199,16405,16604,0
Graphics|Software,6000000.0,USA,1,1,0,12345,12345,1
Health Care Information Technology|mHealth,276672.0,SVK,1,1,0,16189,16189,0
Marketplaces|Mobile Coupons|Services,118000.0,CAN,1,1,0,16643,16643,0
Enterprise Software,800000.0,FRA,1,4,0,15778,15778,0
Facebook Applications|Mobile|Mobile Games|Social Games|Social Media,250000.0,USA,2,2,156,15286,15442,0
Business Services,4500000.0,USA,1,1,0,11645,11645,0
Education|Teachers,175000.0,USA,2,2,368,15736,16104,0
Education|Teachers|Training,15000.0,USA,1,1,0,15765,15765,0
Software,3500000.0,ISR,2,3,876,12785,13661,1
Delivery|E-Commerce|Hospitality,720000.0,GBR,1,1,0,16749,16749,0
Software|Sports|Tourism|Weddings,270000.0,USA,3,3,646,15857,16503,0
Cloud Computing|Finance Technology|FinTech|Mobile Payments|Security,1795958.0,FIN,3,1,1221,15095,16316,0
Health and Wellness,14300000.0,USA,3,5,1310,15231,16541,0
Events|Technology|Ticketing,2200000.0,IND,3,7,1131,15429,16560,0
Networking|Network Security,80000000.0,USA,5,9,2048,13483,15531,1
SEO|Software,24500000.0,USA,2,7,818,12678,13496,1
E-Commerce|Local Based Services,40000.0,GBR,1,1,0,15306,15306,0
E-Commerce,27000000.0,USA,3,1,890,13501,14391,1
Mobile Commerce,41600000.0,JPN,4,11,442,15910,16352,0
E-Commerce,1365100.0,DEU,1,1,0,13738,13738,0
Energy IT|Hardware + Software,10409401.0,USA,3,8,879,15866,16745,0
Fashion|Retail|Retail Technology,800000.0,USA,3,3,700,15979,16679,0
Advertising|E-Commerce|Search,13200001.0,USA,5,6,2131,12802,14933,1
Curated Web,1000000.0,USA,1,4,0,15860,15860,0
Advertising|Analytics|SaaS|Sales and Marketing|Sales Automation|Social Media,8666048.0,USA,5,17,1198,14944,16142,0
Advice|Business Services|Consumers|Curated Web|Direct Marketing|Estimation and Quoting|Local,14300000.0,USA,2,9,453,13304,13757,1
E-Commerce|Marketplaces,15900000.0,USA,2,5,953,14879,15832,1
E-Commerce|Gift Card|Marketplaces|Online Shopping,1000000.0,USA,1,3,0,16418,16418,0
Curated Web,5000000.0,USA,1,1,0,12784,12784,0
Web Hosting,230000.0,USA,2,1,267,15539,15806,0
Career Management|Curated Web|Human Resources|Recruiting|Skill Assessment|Social Network Media,357125.0,DEU,1,1,0,15218,15218,0
Big Data Analytics|Social Media Platforms,80000.0,USA,3,3,53,16268,16321,0
E-Commerce,56667.0,CHL,2,2,291,15566,15857,0
Biotechnology,28000000.0,USA,1,5,0,16485,16485,0
Augmented Reality|Consumer Electronics|Consumer Goods|Entertainment|Mobile Games|Technology|Virtual Worlds|Wearables,1380000.0,USA,3,2,312,16097,16409,0
E-Commerce|Payments,140000.0,RWA,3,1,701,16071,16772,0
Finance,5150000.0,FIN,1,2,0,13292,13292,0
Enterprise Software|Gps|Location Based Services|Mobile,1975000.0,USA,2,3,351,15231,15582,1
Clean Technology,690000.0,USA,1,1,0,14216,14216,0
Commercial Real Estate,13700000.0,AUS,1,1,0,16658,16658,1
Biotechnology,58972055.0,USA,3,3,1249,14046,15295,1
Education|K-12 Education|Online Education,4000000.0,IND,1,1,0,16587,16587,0
Internet,567160.2851681911,ITA,1,1,0,16729,16729,0
Web Hosting,54000000.0,CAN,1,9,0,12961,12961,1
Advertising,75000000.0,USA,1,1,0,14896,14896,0
Advertising|Consulting|Design|Sales and Marketing|Software,2200.0,RUS,1,1,0,15958,15958,0
Employment|Human Resources|Recruiting,10000000.0,USA,1,1,0,13920,13920,0
Electronics|Lighting|Video,575108.0,KOR,1,1,0,16359,16359,0
Biotechnology|Health Care,107440000.0,USA,5,11,3390,11688,15078,1
Biotechnology,110005371.0,USA,6,18,3401,13095,16496,0
Collaboration|Software,11248028.0,USA,5,2,1139,15219,16358,0
Automotive|Public Transportation,50000000.0,IND,1,1,0,16510,16510,0
Communications Hardware|Mobile|Technology,180600000.0,USA,7,47,2968,12530,15498,1
Biotechnology,149330143.0,NLD,3,20,1913,14638,16551,0
Clean Technology,1259000.0,FIN,1,1,0,15522,15522,0
Aerospace|In-Flight Entertainment|Travel,30000000.0,USA,1,1,0,16295,16295,0
Professional Services,85000000.0,USA,1,4,0,11702,11702,0
Software,8831615.19828463,KOR,4,8,1015,15723,16738,0
Social Media|Social Media Marketing|Software,405000.0,USA,3,2,946,15685,16631,0
Mobile,355000.0,USA,3,4,587,15757,16344,0
Brokers|Finance|Intellectual Asset Management|Trading,3775000.0,SGP,2,1,694,15897,16591,0
E-Commerce,5260160.0,FRA,2,4,697,15535,16232,0
Ediscovery|Games|Video,900000.0,GBR,1,8,0,13787,13787,1
Nanotechnology,220000.0,USA,2,2,305,14287,14592,0
Software,6000000.0,USA,1,2,0,13618,13618,0
Cloud Computing|Cloud Infrastructure|Data Center Automation|Enterprise Software|Software,48750000.0,USA,3,14,573,15839,16412,0
Email|Messaging|Services|Utilities,19300000.0,USA,4,21,1156,15062,16218,0
Cloud Infrastructure|Email|Software,72999998.0,USA,4,7,1791,14693,16484,0
Messaging,1500000.0,USA,1,2,0,12843,12843,1
Messaging,10700000.0,USA,3,8,2188,12285,14473,0
Chat|Messaging|Mobile,11900000.0,USA,3,19,319,15522,15841,1
Location Based Services|Mobile,80733.0,GBR,4,3,619,15848,16467,0
Messaging,21250000.0,USA,2,7,807,11757,12564,1
Blogging Platforms|Location Based Services|Mobile,275000.0,USA,1,1,0,14761,14761,0
Computers|Software|Technology,6000000.0,USA,1,4,0,11589,11589,1
Manufacturing,3267440.0,GBR,3,5,1115,14397,15512,0
Technology,35000.0,USA,1,1,0,16266,16266,0
Enterprise Software,13500000.0,USA,2,2,1012,14882,15894,0
Consumer Electronics|Hardware + Software|Sunglasses|Technology,23000000.0,USA,3,13,637,15826,16463,0
Electronics|Industrial Automation|Semiconductors|Software,500000.0,CAN,1,1,0,13984,13984,0
News,1000000.0,RUS,1,1,0,15079,15079,1
Risk Management,34800000.0,USA,2,22,426,16149,16575,0
Games,7910000.0,FRA,1,5,0,13969,13969,0
Biotechnology,46543600.0,USA,4,1,1797,14906,16703,0
Biotechnology|Chemicals|Clean Technology,31000000.0,USA,2,5,1187,15099,16286,1
Biotechnology|Health Diagnostics,56420551.0,USA,7,23,4238,12265,16503,0
Entertainment|Games|Music|Sports|Television|Video|Video Games,50000000.0,USA,3,10,1434,13330,14764,1
Content|Local|Mobile|Monetization|Public Transportation|Video on Demand|Web Development,18349000.0,USA,3,11,1952,12424,14376,1
Cloud Computing|Cloud Data Services|Content Delivery|Enterprise Software|Optimization|Video Streaming,2300000.0,AUS,1,2,0,15630,15630,0
Cloud Computing|Cloud Management|Enterprises|Enterprise Software,25000000.0,USA,3,12,569,15628,16197,1
Digital Media|Finance|Project Management|Reviews and Recommendations|Software,8000000.0,USA,1,3,0,16685,16685,0
Biotechnology|Health Care|Medical,36000000.0,USA,1,4,0,16652,16652,0
Medical Devices,2000000.0,USA,1,1,0,16489,16489,0
Biotechnology|Diabetes|Electronics,20000000.0,ISR,1,1,0,14374,14374,0
Software,10000000.0,USA,2,5,929,14153,15082,1
B2B|Biometrics|Image Recognition|Security,2881355.93220339,ISR,1,2,0,13545,13545,0
Analytics|Big Data|Internet of Things|Marketing Automation|Performance Marketing,700000.0,GBR,4,1,811,15857,16668,0
Biotechnology,700000.0,USA,1,2,0,14712,14712,0
Android|Mobile,550000.0,USA,1,2,0,15159,15159,0
Advertising|Content|Graphic Design,5100000.0,USA,1,4,0,11151,11151,0
Customer Service|E-Commerce|Fashion|Health and Wellness|Internet|Retail|Social Media|Startups|Technology,19492871.0,GBR,3,3,1326,15034,16360,0
Heavy Industry|Industrial,5000000.0,USA,1,1,0,16386,16386,0
Messaging,8750000.0,USA,1,3,0,12975,12975,1
Clean Technology,32540000.0,NOR,1,1,0,14231,14231,0
Biotechnology,46759287.0,USA,4,1,1289,14370,15659,0
Advertising|Analytics,43500000.0,USA,5,35,1729,14761,16490,0
Aerospace|Defense|Lighting|Solar,3435208.1572562,CAN,1,5,0,16548,16548,0
Analytics|Big Data Analytics|Doctors|Health and Wellness|Health Care|Medical|Personalization,500000.0,USA,1,1,0,15584,15584,0
Artificial Intelligence|Big Data|Computer Vision|Image Recognition|Machine Learning|Software,8000000.0,USA,1,2,0,16409,16409,0
Health Care,3668184.0,USA,6,1,1783,14827,16610,0
Games|Mobile|Mobile Games|Video Games,5038868.0,USA,4,11,650,14761,15411,1
Analytics|Big Data Analytics,7000000.0,USA,2,3,343,16287,16630,0
Logistics|Real Time|Service Providers,30000000.0,CHN,1,4,0,16392,16392,0
E-Commerce|Online Shopping|Software,30772028.0,GBR,2,3,2676,13360,16036,0
Facebook Applications|Games|MMO Games|Social Media,9400000.0,USA,3,4,1169,13514,14683,1
Big Data|Mobile,52500000.0,SGP,4,10,1147,15330,16477,1
Semiconductors,11500000.0,USA,1,4,0,13102,13102,0
Advertising|Mobile,1850000.0,USA,1,5,0,15418,15418,1
Software,21850000.0,USA,1,7,0,12929,12929,1
Medical|Medical Professionals|Therapeutics,43865175.0,USA,7,15,1262,13038,14300,0
Pharmaceuticals,20000000.0,USA,1,1,0,13794,13794,0
Enterprise Software,34000000.0,USA,2,4,2213,11533,13746,1
Enterprise Software,27101994.0,USA,4,14,2354,12303,14657,1
Telecommunications|Television|TV Production,21000000.0,USA,1,2,0,11953,11953,1
Analytics|Big Data|Polling|Social News|Surveys|Text Analytics,974509.0,USA,2,1,1975,14245,16220,0
Application Platforms|Software,5500000.0,USA,1,2,0,16678,16678,0
Curated Web|Databases,57000000.0,USA,2,8,685,13208,13893,1
Web Hosting,7000000.0,CAN,1,4,0,13172,13172,0
Algorithms|Big Data|Commodities|Energy|Machine Learning|Trading,3000000.0,ISR,1,1,0,15951,15951,0
Software,31200000.0,USA,3,11,1316,15258,16574,0
Entertainment|Games|Software,28000000.0,USA,2,6,245,15397,15642,0
Consumer Electronics,50000.0,USA,1,1,0,16495,16495,0
Biotechnology,2946020.0,FIN,1,3,0,15747,15747,0
Accounting|CRM|Enterprise Software|Network Security|SaaS|Software,6081858.0,CAN,2,3,897,14853,15750,0
Clean Technology|Consumer Goods|Curated Web|Green Consumer Goods,10000000.0,USA,1,3,0,12823,12823,0
Biotechnology,60625730.0,CAN,2,2,437,15228,15665,1
Enterprise Software,8000000.0,ISR,1,2,0,14007,14007,0
Mobile|Mobile Video,2000000.0,CAN,1,1,0,14236,14236,0
Security,2280161.0,GBR,2,3,1104,14666,15770,0
Cloud Computing|Freelancers|Monetization|Payments|Software,37500000.0,USA,2,6,2860,12739,15599,1
Networking|Software|VoIP,4355000.0,USA,2,5,574,12131,12705,1
Analytics|Business Intelligence,3758835.0,USA,2,5,458,16040,16498,0
Analytics|Enterprise Software|Mobile,20000.0,EST,2,1,17,16312,16329,0
Analytics|B2B|Internet Marketing|SaaS,118000.0,USA,2,3,192,16517,16709,0
Risk Management|Software,125020000.0,USA,6,9,2897,13420,16317,0
Clinical Trials|Health Care Information Technology|Market Research,120000.0,CAN,1,1,0,16405,16405,0
Business Development,151584.07644630302,BGR,3,4,304,16222,16526,0
Software,3646260.0,FRA,2,4,486,14183,14669,0
Mobile,4880000.0,IND,1,1,0,14614,14614,0
Games,5000000.0,USA,1,1,0,14684,14684,0
Clean Technology,16000000.0,USA,3,8,1568,13741,15309,0
Cars|Consumer Internet|Curated Web|Insurance|Technology,14000000.0,USA,2,7,146,15679,15825,0
Mobile,739000000.0,USA,1,2,0,13061,13061,1
Curated Web|Semantic Search,190000.0,USA,2,1,305,15554,15859,0
Automotive|Big Data|Cars|Enterprise Software|SEO,1100000.0,USA,2,1,30,15857,15887,0
Skill Assessment|Software|Testing,4430000.0,IND,3,10,714,14851,15565,0
Analytics|Big Data|News|Social Media,25000.0,GBR,1,1,0,15582,15582,0
Education|K-12 Education,7515.51013403912,BRA,1,1,0,16709,16709,0
Consumer Internet|E-Commerce|Fashion|Retail,7147215.0,USA,3,16,1341,15339,16680,0
Hardware + Software,1070000.0,FRA,1,1,0,13943,13943,0
Games|Video Streaming,48900000.0,USA,4,9,2441,12965,15406,0
Biotechnology|Health Care,435235853.0,USA,8,17,2864,13794,16658,0
P2P Money Transfer|Trading,150000.0,MEX,1,1,0,16085,16085,0
E-Commerce,625324.0,GBR,1,1,0,15226,15226,0
Big Data|Enterprise Software,40000.0,USA,2,2,419,16076,16495,0
B2B|Manufacturing,44000000.0,USA,4,8,852,13027,13879,0
Health Diagnostics|Software,48131961.0,USA,6,15,2733,12773,15506,1
Mobile|Mobile Payments,40300000.0,USA,4,13,2085,13228,15313,1
Mobile,6490000.0,GBR,1,1,0,13201,13201,1
Biotechnology,11614359.0,GBR,3,9,1631,14699,16330,0
Business Development|Messaging|Subscription Service,2000000.0,IND,1,2,0,13846,13846,1
Analytics|Health Diagnostics|Information Services|Monetization,10000.0,RUS,1,1,0,15492,15492,0
Health Care,1100000.0,USA,1,1,0,16512,16512,0
Network Security|SaaS|Small and Medium Businesses|Software|Startups|Venture Capital,500000.0,USA,1,1,0,16252,16252,1
Mobile|Payments,6888548.0,GBR,3,3,2247,13844,16091,0
Baby Accessories|Marketplaces|Online Shopping,150000000.0,CHN,1,1,0,16686,16686,0
Apps|Venture Capital|Video,250000000.0,CHN,2,8,425,16338,16763,0
Apps|Brand Marketing|Mobile|Social Media|Software,685628.0,GBR,4,4,846,15706,16552,0
Hardware|Semiconductors,23800000.0,CHN,4,5,2740,12600,15340,0
Clean Technology,471400000.0,USA,6,24,2857,12549,15406,1
E-Commerce,660552.0,DEU,2,4,243,15706,15949,0
Photography,40000.0,CHL,1,1,0,15406,15406,0
Analytics|Journalism|Media|News|Opinions,32000000.0,USA,4,21,823,15765,16588,0
Health Care,22538940.0,USA,4,6,1997,13438,15435,0
Marketplaces|Public Transportation|Shipping|Transportation,47500.0,ARG,1,3,0,15765,15765,0
Event Management|Events|Online Reservations,30000.0,JOR,1,1,0,16283,16283,0
Biotechnology,27300055.0,USA,4,5,875,13706,14581,0
Real Estate,5000000.0,JPN,1,1,0,14090,14090,0
Biotechnology|Health Diagnostics,10839271.0,GBR,5,10,1867,14615,16482,0
Auto|Automotive|Cars|E-Commerce,3037092.0,IRL,1,3,0,15706,15706,0
Biotechnology,5780037.0,GBR,3,7,2380,13215,15595,0
Finance,5400000.0,IND,1,2,0,15964,15964,0
Health Care,3850000.0,USA,3,4,320,15399,15719,0
Hardware,9000000.0,USA,1,3,0,12551,12551,1
Biotechnology,90000000.0,USA,2,9,1031,12542,13573,1
Clean Technology|Environmental Innovation|Technology|Waste Management,3109003.0,GBR,2,5,2579,13900,16479,0
Biotechnology,2043445.0,USA,2,1,551,16059,16610,0
Semiconductors,5740000.0,CAN,1,1,0,12975,12975,0
Manufacturing,5500000.0,CAN,1,6,0,12825,12825,0
Health Care|Medical Devices,44361046.0,USA,3,9,2288,14322,16610,0
Curated Web,471938.0,GBR,4,2,264,15714,15978,0
Communications Infrastructure|Optical Communications|Semiconductors,8500000.0,GBR,2,4,336,10451,10787,0
Consumer Electronics|Electronics|Manufacturing,18000000.0,USA,1,4,0,12431,12431,0
Semiconductors,35280599.0,GBR,4,7,2027,11747,13774,0
Health and Insurance|Insurance|Insurance Companies,10400000.0,ZAF,1,4,0,16230,16230,0
Customer Service|Financial Services,12300000.0,USA,1,1,0,16561,16561,0
Energy|Hardware|Hardware + Software,48499999.0,USA,4,19,2865,12479,15344,0
Finance,22000000.0,USA,1,1,0,14955,14955,0
Analytics,18300000.0,IND,2,6,572,12797,13369,0
Marketplaces,1000000.0,USA,1,1,0,12118,12118,0
Mobile,88000000.0,IND,2,4,251,14621,14872,0
Health Care|Medical Devices|Pharmaceuticals,23000000.0,USA,1,6,0,11962,11962,0
Semiconductors,50410400.0,USA,4,2,2503,13446,15949,1
Semiconductors,14535150.0,DEU,2,7,2226,13236,15462,0
Health Care,1300000.0,CHN,3,2,242,11627,11869,0
Security,18909999.0,USA,4,1,1236,15348,16584,0
Analytics|Environmental Innovation|Nanotechnology|Technology,6515581.0,GBR,1,1,0,15853,15853,0
Biotechnology|Health Care|Medical,36400000.0,GBR,1,4,0,11738,11738,0
Hardware + Software,2000000.0,USA,2,2,1420,12375,13795,0
Clean Technology,40000.0,CHL,1,1,0,15940,15940,0
Clean Technology|Local Businesses|Semiconductors,27195554.0,USA,3,3,751,14144,14895,0
Biotechnology,3273650.0,DEU,3,8,1685,14280,15965,0
Messaging,800000.0,ISR,1,1,0,13163,13163,0
Health Care,8079068.0,USA,3,3,1226,14725,15951,0
Crowdfunding|Finance|Venture Capital,450000.0,USA,2,2,50,15274,15324,0
Biotechnology|Clean Technology|Green|Water,6500000.0,USA,4,1,2205,14245,16450,0
All Students|Education|Universities,25000.0,ARG,1,1,0,15918,15918,0
Biotechnology,35000000.0,USA,2,4,2250,13689,15939,0
Health Care|Medical|Medical Devices,51000000.0,USA,1,2,0,16359,16359,0
Automotive|Manufacturing,66000.0,MEX,2,2,295,15659,15954,0
Manufacturing,24930754.0,GBR,2,1,670,15344,16014,0
Cloud Computing|SaaS|Software,1622703.0,FIN,1,1,0,16525,16525,0
Biotechnology,11500000.0,USA,2,8,124,15882,16006,0
Clean Technology,1520000.0,FRA,1,1,0,14851,14851,0
Cloud Computing|Cloud Management|Networking|Software|Virtualization,18643106.0,JPN,3,9,1269,15077,16346,0
Apps|Automotive|EdTech|Education|Marketplaces,4787280.0,GBR,2,2,479,15857,16336,0
Games,6500000.0,USA,1,3,0,16129,16129,0
Curated Web,1400100.0,USA,1,1,0,15776,15776,0
Software,60000.0,JPN,1,1,0,15079,15079,0
Consumer Goods|Flowers|Gift Exchange,3051243.0,DEU,3,6,492,15867,16359,0
Email Marketing|Tech Field Support,1850000.0,USA,1,1,0,11971,11971,0
Android|Apps|Chat|Communities|Entertainment|Games|Internet|Messaging|Mobile|Software,44600000.0,SGP,6,14,3049,13640,16689,1
Advertising,2878000.0,USA,4,12,699,15584,16283,0
Curated Web,300000.0,USA,2,2,83,14735,14818,0
E-Commerce,685000.0,USA,2,1,574,15405,15979,0
B2B|SaaS,2510000.0,USA,2,11,81,16388,16469,0
Mobile,750000.0,USA,3,14,670,14975,15645,0
Software,8330000.0,USA,3,3,672,13145,13817,0
Homeless Shelter|Real Estate|Travel|Vacation Rentals,505829.0,ESP,1,1,0,16344,16344,0
Curated Web|Online Dating|Social Network Media,300000.0,USA,1,1,0,15902,15902,0
Bridging Online and Offline|Internet|Marketplaces,250000.0,IND,1,1,0,16292,16292,0
Consumer Lending|Financial Services|Health Care|Identity Management|Payments|Recruiting|Security|Virtual Currency,8610000.0,GBR,5,6,1173,15232,16405,0
B2B|E-Commerce|Enterprise Software|SaaS,90000.0,RUS,2,6,324,15651,15975,0
Fashion,6000000.0,DNK,1,1,0,15573,15573,0
Artists Globally|Creative Industries|Test and Measurement,30000.0,USA,1,1,0,16130,16130,0
Fashion,1700000.0,USA,2,5,259,15492,15751,0
Crowdfunding|Education|Enterprises|Finance|Water,1350000.0,SGP,5,11,1733,14853,16586,0
Local Businesses|SaaS,700094.0,DEU,5,3,1035,14610,15645,0
Development Platforms,4464259.0,USA,2,2,912,11292,12204,0
E-Commerce,10000000.0,CHN,1,1,0,15086,15086,0
E-Commerce,2200000.0,USA,3,6,517,15513,16030,0
Mobile|Small and Medium Businesses,15113623.0,USA,2,8,135,16329,16464,0
Automotive|Electric Vehicles,56000000.0,USA,3,2,675,13931,14606,0
Biotechnology,30000000.0,CAN,2,9,1463,15138,16601,0
Health and Wellness,350000.0,USA,1,4,0,16055,16055,0
Biotechnology,14350000.0,USA,3,1,594,16028,16622,1
Data Centers|Information Technology|Video Conferencing,42500000.0,USA,1,2,0,16658,16658,0
Travel,2460000.0,USA,3,20,905,14823,15728,1
Furniture,8603341.0,FRA,2,4,861,14998,15859,0
Broadcasting|Digital Media|News,2044050.0,FRA,1,1,0,15279,15279,0
News,5500000.0,USA,1,4,0,11561,11561,1
Apps|Mobile,1700000.0,USA,2,26,220,15065,15285,1
Curated Web|Group Buying,165000.0,MYS,1,1,0,15126,15126,0
Health and Wellness,13080000.0,IND,2,3,1244,15007,16251,0
Bicycles|Design|Hardware + Software,880848.0,ITA,1,1,0,15539,15539,0
Curated Web,900000.0,USA,1,4,0,13879,13879,1
Biotechnology,14180000.0,CAN,2,3,273,13105,13378,0
Advertising|App Marketing|Brand Marketing|Marketplaces|Mobile Advertising,240245382.0,USA,5,14,2501,13529,16030,1
Energy Efficiency|Networking|Wireless,6000000.0,USA,1,3,0,12156,12156,0
Biotechnology,47074808.0,USA,2,4,1380,13677,15057,1
Mobile,5650000.0,GBR,1,1,0,13279,13279,1
Advertising|Internet Marketing|Social Media|Video Streaming|Web Tools,30000.0,USA,1,2,0,15040,15040,0
Financial Services|Internet|Monetization|Payments,1245352.0,CHE,5,1,1550,15020,16570,0
Comparison Shopping|Curated Web|Local|Real Time|Reviews and Recommendations|Shopping|Software,4950000.0,USA,2,26,388,14184,14572,1
Biotechnology,250000.0,USA,1,1,0,15384,15384,0
Android|Apps|Mobile,5000000.0,JPN,2,2,655,14463,15118,0
Games|Social Buying,30143747.0,USA,3,4,1206,15119,16325,1
Email|Software,89878098.0,GBR,4,5,1510,14099,15609,1
Curated Web,5428197.0,USA,3,1,1040,14747,15787,0
Curated Web,25000000.0,USA,2,5,973,12784,13757,0
Entertainment|Games,575608.0,FRA,1,1,0,14730,14730,0
3D|Health Care Information Technology|Medical Devices,6800000.0,NLD,2,2,27,16324,16351,0
Biotechnology,3648000.0,CAN,3,3,2817,13087,15904,0
Education,700000.0,USA,1,1,0,16665,16665,0
Semiconductors,19800000.0,USA,4,7,1720,12357,14077,1
Hardware + Software,1500000.0,USA,3,2,816,14245,15061,0
Software,1254300.0,DEU,3,3,2519,13432,15951,0
Mobile|Networking,20000000.0,USA,1,2,0,16211,16211,0
Software,55420776.0,USA,7,21,1499,13122,14621,1
Semiconductors,5500000.0,USA,1,1,0,14755,14755,0
Games,22360000.0,GBR,3,3,1651,13475,15126,0
EdTech|Education|Games|Kids,25000.0,ARG,1,1,0,15431,15431,0
Biotechnology,23522600.0,CHE,3,4,1043,14909,15952,0
Augmented Reality|Internet of Things|Mobile|User Experience Design|Wearables,2500000.0,USA,1,2,0,15897,15897,0
Software,108869760.0,USA,6,12,3488,13057,16545,1
Health Services Industry,13806361.0,USA,2,1,567,16188,16755,0
Hospitality|Marketplaces|SaaS|Sustainability,1200000.0,USA,1,2,0,15989,15989,0
E-Commerce|Gift Card|Mobile Commerce|Social Commerce,20000.0,USA,1,1,0,15797,15797,0
Health Care|Medical|Medical Devices,2100000.0,USA,2,5,13,16708,16721,0
Games,375247.0,FIN,1,2,0,16389,16389,0
Curated Web|EdTech|Education|Software|Systems|Training,7500000.0,USA,2,2,630,15127,15757,0
Analytics|Application Performance Monitoring|Application Platforms,5600000.0,USA,1,3,0,11717,11717,0
Medical Devices,15000000.0,ISR,1,7,0,12233,12233,0
Music,1200000.0,USA,1,13,0,16086,16086,0
Chat|Collaboration|Document Management|Software|Video Conferencing,25000000.0,USA,2,6,3478,12906,16384,0
Facebook Applications|Games|Networking|Social Games|Social Network Media,22000000.0,USA,1,1,0,14671,14671,1
Security,850000.0,SWE,2,3,945,13846,14791,0
Communities|Government Innovation|SaaS,23200000.0,USA,4,7,1281,15034,16315,0
Artificial Intelligence|Augmented Reality|Image Recognition|Virtual Worlds,329000.0,USA,3,2,322,16120,16442,0
Software,1400000.0,NZL,1,4,0,16194,16194,0
Application Platforms|Apps|Design,164302.0,CHL,3,3,335,15461,15796,0
Apps|Games|Social Games,250000.0,ARG,1,1,0,14944,14944,0
Apps|Education|Games|Kids|Textbooks|Virtual Worlds,9000000.0,GBR,2,1,210,15279,15489,0
Automotive|Beauty|Enterprise Software|Finance|FinTech|Hospitality|Restaurants|Retail|Travel,20000000.0,USA,1,1,0,15251,15251,0
Enterprise Software,44097622.0,USA,4,7,2622,12363,14985,1
Games|Language Learning,7700000.0,USA,2,14,512,15042,15554,0
University Students,1000000.0,USA,1,6,0,15400,15400,0
Enterprise Software|Gamification|Human Resources|SaaS|Sales and Marketing|Sales Automation|Training,14300000.0,USA,2,5,405,16353,16758,0
Mobile,600000.0,USA,1,1,0,15614,15614,0
Curated Web|Local|Service Providers,5500000.0,USA,3,4,914,14061,14975,0
Advertising|Analytics|Business Intelligence|Enterprise Software,25000.0,USA,1,1,0,15240,15240,0
Curated Web,3600000.0,USA,2,4,243,13483,13726,0
Software,4660480.0,CHN,2,2,1887,14123,16010,0
E-Commerce|Fashion|Mobile|Mobile Shopping,2075000.0,USA,3,6,994,15685,16679,0
Real Estate,40000.0,CHL,1,1,0,15301,15301,0
Accounting|Banking|Finance|Financial Services|FinTech|Payments,22700000.0,USA,3,7,1190,15287,16477,0
Bio-Pharm|Health and Wellness|Health Care|Neuroscience,46000000.0,USA,2,8,63,16455,16518,1
Health and Wellness|Health Care|Medical Devices,45000000.0,USA,2,1,638,15698,16336,0
Software,15298678.0,CAN,3,6,812,15777,16589,0
Analytics,4089000.0,USA,5,5,924,15674,16598,0
Manufacturing,3977006.0,CHN,2,1,1476,13488,14964,0
Software,52583.0,TUR,1,1,0,15799,15799,0
Enterprise 2.0|Enterprise Software,3240000.0,CHN,1,1,0,15938,15938,0
Social Media,7000000.0,IND,1,1,0,13634,13634,0
3D|Audio|Messaging|Public Relations|Real Time|Telephony|Virtualization,1840000.0,CAN,2,2,636,14309,14945,0
Social Media,500000.0,USA,1,3,0,15287,15287,0
E-Commerce,15000000.0,CHN,1,1,0,15156,15156,0
Public Relations,500000.0,USA,1,4,0,15888,15888,0
Entertainment,604811.0,FRA,1,1,0,15868,15868,0
Internet|Social Media,50000.0,RUS,1,1,0,14481,14481,0
Location Based Services|Mobile Commerce|Wine And Spirits,1800000.0,USA,1,3,0,16282,16282,0
E-Commerce|Online Travel|Price Comparison|Transportation,2769294.33276163,GBR,4,5,1120,15614,16734,0
Travel,2573200.0,GBR,1,4,0,15918,15918,0
Hardware + Software,6000000.0,CHE,1,2,0,14692,14692,0
Translation,1100000.0,JPN,2,3,374,16311,16685,0
Enterprise Software,34968523.0,USA,7,11,3213,13545,16758,0
Games,550000.0,NZL,2,4,826,14647,15473,0
Internet|Open Source|Software,3300000.0,USA,1,10,0,16603,16603,0
Games,2033657.0,FIN,1,4,0,16597,16597,0
E-Commerce|Fashion|Manufacturing|Retail,6337270.0,USA,5,5,966,15636,16602,0
Travel,1000000.0,USA,1,2,0,15662,15662,0
Fashion,630000.0,CAN,1,1,0,15961,15961,0
Fashion,40000.0,CHL,1,1,0,15538,15538,0
Curated Web,65000.0,USA,1,2,0,15675,15675,0
Games,4868000.0,USA,5,22,1741,14975,16716,0
Biotechnology,25849354.5253743,ESP,3,10,923,15799,16722,1
Insurance|Insurance Companies|Venture Capital,50700000.0,GBR,1,1,0,16226,16226,0
Mobile,8500000.0,USA,2,4,303,13256,13559,0
Curated Web|Finance,31775000.0,USA,5,25,1046,13422,14468,1
Big Data|Biotechnology|Cloud Computing|Health Care,831916.0,ESP,4,4,730,15796,16526,0
Health Care|Hospitals|Medical,6019299.0,NLD,3,4,1559,14700,16259,0
Art|Crowdsourcing|Design|E-Commerce|Home Decor,89100000.0,USA,5,15,2295,14078,16373,0
Hardware + Software,88150000.0,USA,8,21,3434,11302,14736,1
B2B|Big Data|Big Data Analytics|CRM|Enterprise Software|Internet Marketing|Machine Learning|Marketing Automation|Predictive Analytics|SaaS,19000000.0,USA,2,5,757,15238,15995,0
Advertising|SaaS,50000.0,USA,1,1,0,16328,16328,0
Finance|Marketplaces|Peer-to-Peer,1159173.89540388,LVA,1,1,0,16456,16456,0
Apps|Reviews and Recommendations|Social Media|Social Travel|Travel,2903873.0,ESP,2,5,489,16056,16545,0
Analytics|Business Analytics|Business Intelligence|Cloud Data Services|E-Commerce|Information Technology|Internet|SaaS,2886600.0,DEU,2,13,440,15975,16415,0
Curated Web|File Sharing|Web Hosting,12117870.0,USA,5,5,1386,15188,16574,0
Media,1318044.0,FRA,1,1,0,16310,16310,0
Hardware + Software,55795767.0,USA,5,3,1539,14805,16344,0
Finance|Messaging|P2P Money Transfer|Payments,20000.0,ROM,2,3,0,15795,15795,0
Mobile,500000.0,CAN,1,3,0,16107,16107,0
Beauty,4000000.0,MEX,1,3,0,16715,16715,0
Application Platforms|Data Visualization|Video,30000000.0,ARG,1,5,0,16476,16476,0
Clean Technology,43307984.0,USA,8,5,3197,13538,16735,0
Billing|Software|Subscription Businesses,19713.0,NLD,1,1,0,15434,15434,0
3D|Art|CAD|Consulting|Design|Manufacturing|Printing|Rapidly Expanding|Services,81845.0,GBR,3,6,167,15584,15751,0
Apps|Music|Software,1015000.0,HKG,4,3,1248,15400,16648,0
Internet|Internet Marketing|Medical|Pharmaceuticals,1400000.0,RUS,1,1,0,15492,15492,0
Fashion|Lifestyle Products|Online Shopping,7500.0,USA,1,1,0,15857,15857,0
Biotechnology,4000000.0,USA,1,1,0,14791,14791,0
Medical Devices,9000000.0,USA,1,1,0,12878,12878,0
Health Care,23420000.0,USA,7,6,2809,13747,16556,0
Health Care,28164774.0,AUT,4,11,2443,14000,16443,0
Hardware + Software,1854512.0,GBR,2,2,238,16163,16401,0
Semiconductors,67300000.0,USA,3,19,1066,12660,13726,0
Biotechnology,1500000.0,USA,1,3,0,15163,15163,0
Banking|Financial Services|FinTech|Information Technology,9700000.0,USA,3,10,480,16289,16769,0
Enterprise Software|Mobile Devices,1523520.0,FIN,2,3,812,14845,15657,0
Hardware + Software,7500000.0,ISR,1,3,0,13048,13048,0
Security,12000000.0,USA,1,5,0,13105,13105,1
Biotechnology,94500000.0,USA,7,29,2731,14018,16749,0
Software,23000000.0,FRA,2,7,978,15660,16638,0
Health Care,90058213.0,USA,6,7,2396,13953,16349,0
Games,4254942.0,CAN,2,2,1185,14975,16160,0
Cloud Computing|Enterprise Software|Infrastructure|Open Source,220000000.0,USA,4,20,956,15715,16671,0
Messaging,10300000.0,USA,1,6,0,13046,13046,1
Finance|Financial Services|Portals,1000000.0,RUS,1,1,0,16049,16049,0
Health and Wellness,645000.0,USA,1,1,0,16184,16184,0
Biotechnology|Innovation Management|Startups,350000.0,USA,1,1,0,16142,16142,0
Software,1310000.0,GBR,1,1,0,13696,13696,1
Biotechnology|Health Care|Therapeutics,82800000.0,USA,4,16,1961,14594,16555,1
Software,40000.0,CHL,1,1,0,15376,15376,0
Diagnostics|Health Care|Health Care Information Technology|Medical Devices,2800000.0,USA,2,1,296,16252,16548,0
Biotechnology,28597346.0,USA,2,1,1134,15541,16675,0
Software,8000000.0,USA,1,3,0,12502,12502,1
Advertising,11963544.0,GBR,7,7,1638,14937,16575,0
Bitcoin|Finance|FinTech,12800000.0,USA,2,9,392,16197,16589,0
Business Intelligence|SaaS|Software|Web Development,1200000.0,NLD,1,2,0,13848,13848,1
Artificial Intelligence|Energy Efficiency|Startups,1066096.0,ESP,4,5,913,15309,16222,0
Legal|Local Search|Service Providers,40000.0,CHL,1,1,0,16222,16222,0
E-Commerce,2566700.0,ESP,2,1,326,15346,15672,0
Android|iOS|iPad|Music|Wireless,6000000.0,USA,2,2,30,15126,15156,0
Analytics|Brand Marketing|Media|Mobile|SaaS|Software,46500.0,NZL,3,3,401,16191,16592,0
Hospitality,1905417.0,ITA,3,9,799,15553,16352,0
Entertainment|Mobile|Real Time|Twitter Applications,5500000.0,USA,3,12,558,14751,15309,1
Music,3000000.0,USA,2,11,268,14963,15231,0
Software,959498.0,JPN,2,2,388,15978,16366,0
Educational Games|Games|Kids,20265.0,UKR,1,1,0,16102,16102,0
E-Commerce,40000.0,CHL,1,1,0,16029,16029,0
Manufacturing,22800000.0,USA,1,1,0,15766,15766,0
Finance|FinTech,2755747.0,USA,3,2,853,15622,16475,0
Automotive|Clean Technology|Software,14069797.0,USA,3,1,1050,14153,15203,0
Nanotechnology,1500000.0,USA,2,2,452,13482,13934,1
Biotechnology,43200045.0,GBR,3,9,1492,15211,16703,0
Cloud Computing|Cloud Management|Mobile|Software,300000.0,USA,1,5,0,16247,16247,0
Audio|Information Services|Information Technology,5930000.0,FRA,2,2,674,13514,14188,0
Advertising|Franchises|Mobile|Publishing|SEO,3500000.0,FRA,2,3,731,14822,15553,0
Search|Web Tools,33023.0,ITA,1,1,0,15911,15911,0
Rental Housing|Vacation Rentals,2000000.0,USA,1,8,0,16559,16559,0
Internet|Local Businesses,20000000.0,PER,1,1,0,15306,15306,0
Aerospace|Defense|Embedded Hardware and Software|Homeland Security|Product Development Services,6500000.0,IND,1,2,0,13915,13915,0
Clean Technology,25000000.0,USA,1,1,0,15639,15639,0
Biotechnology,4158499.0,USA,2,2,720,14265,14985,0
Bio-Pharm|Biotechnology|Pharmaceuticals,300000.0,USA,1,1,0,16379,16379,0
Fitness|Healthcare Services|Therapeutics,245560.0,GBR,1,1,0,16040,16040,0
Biotechnology,2216560.0,FRA,2,1,413,12920,13333,0
Health Care,4250000.0,SWE,1,2,0,12877,12877,0
Health and Wellness,74000000.0,USA,4,14,2363,13878,16241,0
Biotechnology,1000000.0,ISR,1,1,0,15887,15887,0
Commodities|Finance|Financial Services|Media|News,8600000.0,CAN,1,4,0,15544,15544,0
Software,9000000.0,SWE,2,6,776,12873,13649,0
Software,2400000.0,USA,2,2,330,15624,15954,1
Digital Media|Direct Marketing|Media,18000000.0,USA,3,9,784,15686,16470,0
Hardware + Software|Mobile Payments|NFC|Payments|Point of Sale,16000000.0,GBR,1,1,0,16597,16597,0
Public Relations,11420000.0,FRA,2,3,339,14040,14379,0
Software,11843959.0,USA,4,2,1645,14452,16097,1
Social Media,400000.0,USA,1,1,0,13967,13967,0
Curated Web,11000000.0,USA,2,3,1308,13879,15187,0
Internet|Social Media,1000000.0,USA,2,2,147,16616,16763,0
Software,7553998.0,USA,3,2,1095,14837,15932,0
Curated Web|Web Tools,16950000.0,USA,4,9,1447,12904,14351,0
Facebook Applications|Online Dating|Psychology|Social Media,100000.0,ISR,1,6,0,15146,15146,0
Music|Music Services|SaaS|Social Network Media,10138503.0,CAN,4,13,1001,15614,16615,0
Entertainment,1800000.0,USA,1,2,0,16226,16226,0
Software,1500000.0,USA,1,9,0,16546,16546,0
Application Platforms|Music,1350000.0,USA,2,2,730,15979,16709,0
Mobile Analytics,77015000.0,USA,5,13,1996,14426,16422,0
Advertising|Video,10500000.0,USA,2,6,1129,13149,14278,0
Advertising|Analytics|B2B|Lead Generation|Mobile|Sales and Marketing,1500000.0,USA,1,17,0,15296,15296,0
Coffee|E-Commerce|Mass Customization,2800000.0,RUS,3,3,699,15523,16222,0
Curated Web|Social Bookmarking|Social Media|Web Tools,3500000.0,USA,3,3,396,13514,13910,1
E-Commerce|Online Shopping|Retail,80000000.0,JPN,2,4,147,16272,16419,0
Social Media,11725600.0,USA,2,4,612,13395,14007,1
E-Commerce,1603420.0,CHN,1,1,0,15716,15716,0
E-Commerce|Fashion|Retail,1550000.0,USA,3,3,300,16010,16310,0
Manufacturing,817953.0,GBR,2,4,728,14792,15520,0
Software,5000000.0,USA,1,1,0,16623,16623,0
Collaboration|Language Learning|Open Source|Productivity Software|Security|Software,2797920.0,FRA,1,1,0,14245,14245,0
E-Commerce,74945600.0,CHN,4,7,2374,14245,16619,0
Application Platforms|Customer Service|Embedded Hardware and Software|Internet of Things|Marketplaces,3000000.0,CAN,1,1,0,16040,16040,0
Content|Games,2977800.0,ESP,2,2,29,13910,13939,0
Semiconductors,7149177.0,GBR,2,7,577,13452,14029,0
Credit|Financial Services|Services,5900000.0,USA,1,4,0,16708,16708,0
Advertising|Mobile|Virtualization,9625000.0,USA,3,6,500,15949,16449,0
Biotechnology,11400000.0,USA,2,4,491,15386,15877,0
Analytics|Big Data|Cloud Computing|Internet of Things|M2M,6000000.0,CAN,2,2,1071,15498,16569,0
Hospitality,6187982.0,USA,3,2,1230,15098,16328,0
Advertising|Creative|Displays|Search,17500000.0,USA,3,19,843,14610,15453,0
Location Based Services|MicroBlogging|Mobile|Reviews and Recommendations|Social Search,1100000.0,USA,1,8,0,13939,13939,1
Consulting,59376.0,JPN,1,1,0,15274,15274,0
Games,9575857.0,GBR,2,2,446,13523,13969,0
Android|iPhone|Mobile|Technology,73703.0,USA,2,2,91,15949,16040,0
Android|iOS|Mobile Games|Video Streaming,15900000.0,USA,2,22,105,16574,16679,0
Mobile,28491285.0,USA,13,9,2008,14727,16735,0
Analytics|Crowdsourcing,6100000.0,USA,2,14,1009,15663,16672,0
Public Relations|VoIP,5500000.0,GRC,2,2,938,13827,14765,0
Semiconductors,6500000.0,CAN,1,1,0,16482,16482,0
Messaging,13120000.0,SWE,1,1,0,13243,13243,0
Crowdsourcing|Curated Web|Mobile|Retail,1420922.0,FRA,1,1,0,16489,16489,0
Advertising|Android|Apps|iPhone|Mobile,69830.0,AUT,1,1,0,14639,14639,1
Apps|Mobile Commerce|Point of Sale,130608.0,FRA,1,2,0,15901,15901,0
Mobile|Telecommunications,35000000.0,USA,1,1,0,16643,16643,0
Mobile,163309.0,CHN,1,1,0,15979,15979,0
Mobile,3196320.0,FRA,1,1,0,13604,13604,0
Mobile|Web Development,50000.0,ZAF,1,1,0,15006,15006,0
Android|E-Commerce|iOS|iPad|iPhone|Mobile|Mobile Commerce|SaaS,1055811.0,SGP,3,10,1171,15051,16222,0
Mobile,4000000.0,USA,1,2,0,13669,13669,1
Mobile,500000.0,USA,1,1,0,13416,13416,0
Mobile,19272264.7272727,CAN,7,9,3492,12831,16323,1
Chat|Curated Web|Internet|Mobile|Online Dating|Social Network Media,205861.0,ESP,3,1,730,13149,13879,0
Mobile,3700000.0,USA,2,3,3081,13587,16668,0
Apps|Design|Real Estate,40000.0,COL,1,1,0,16222,16222,0
CRM|Marketing Automation|Mobile Commerce|Restaurants,4000000.0,SGP,3,4,1182,15534,16716,0
Curated Web|Internet|Mobile|Mobile Payments|Payments|Service Providers|Telecommunications,30250000.0,IND,3,6,934,15599,16533,0
Graphics|Internet|Mobile Games,1362814.0,KOR,1,1,0,16427,16427,0
Advertising|App Marketing|Business Intelligence,2805000.0,USA,2,11,281,16274,16555,0
Security,10000000.0,USA,4,2,993,13678,14671,1
Enterprise Software,5450000.0,USA,4,3,992,10073,11065,1
Mobile,1302500.0,FIN,1,2,0,15468,15468,0
App Marketing|Mobile,3500000.0,CHE,1,1,0,16071,16071,0
Payments,2800000.0,RUS,1,1,0,16048,16048,0
Software,4800000.0,GBR,1,4,0,13416,13416,0
Mobile,16000000.0,USA,2,9,91,13445,13536,0
Software,2000000.0,USA,1,2,0,13966,13966,0
Real Estate,750000.0,USA,1,1,0,16707,16707,0
Mobile,147584247.0,USA,5,1,1477,14469,15946,0
Mobile|Unifed Communications,5000000.0,ISR,1,1,0,14665,14665,0
3D|Mobile|SaaS|Ticketing|Visualization,400000.0,USA,1,3,0,16241,16241,0
Mobile,2565000.0,USA,3,1,1455,15156,16611,0
Enterprise Software,3076171.0,CHN,1,1,0,14245,14245,0
Advertising|App Marketing|Market Research|Messaging,15000000.0,USA,2,9,1656,13860,15516,0
Enterprises|Internet|Mobile|Mobility|Wireless,3130473.0,USA,5,1,1123,15086,16209,0
Mobile|Systems|Telecommunications,21300000.0,USA,1,2,0,12556,12556,0
Security,6280000.0,ESP,1,2,0,13301,13301,0
Document Management|Finance Technology|Mobile Commerce,50000.0,USA,1,1,0,15534,15534,0
Groceries|Mobile|Retail Technology|Shopping,10000.0,USA,1,1,0,16071,16071,0
Mobile,224000.0,SWE,1,1,0,13633,13633,0
Analytics|Enterprises|Mobile|SaaS|Security,2400000.0,USA,4,7,802,15688,16490,0
Enterprises|Mobile|Task Management|Web Development,558288.0,FRA,1,1,0,14031,14031,0
Apps|Mobile|Software|Travel & Tourism,5000000.0,IRL,1,1,0,15498,15498,0
Emerging Markets|Mobile,280000.0,USA,1,1,0,13801,13801,0
Mobile,15000000.0,IND,1,2,0,13465,13465,0
Mobile,37037399.0,USA,5,18,1790,12921,14711,1
Android|Apps|App Stores|Mobile|News,400000.0,SGP,1,1,0,15126,15126,0
Internet|Mobile|Software|Startups,6960000.0,USA,2,8,817,13285,14102,0
Enterprise Software,1000000.0,USA,1,1,0,13286,13286,0
Android|iPhone|Mobile|Productivity Software,10009001.0,USA,4,13,967,15335,16302,0
Analytics|Finance|Internet Marketing,650000.0,USA,3,9,1418,14276,15694,1
Public Relations,791080.0,FRA,2,3,553,13090,13643,0
Android|Apps|Internet of Things|iOS|Mobile|SaaS,311000.0,USA,3,5,486,15309,15795,0
Apps|Mobile|Mobile Devices|Mobile Security,144800000.0,USA,8,28,2208,13780,15988,1
Electronic Health Records|Health and Wellness,4700000.0,USA,1,1,0,14640,14640,1
Location Based Services|Mobile,3791750.0,DEU,1,1,0,13939,13939,0
Mobile,7520000.0,DNK,1,1,0,14153,14153,0
Android|Brokers|iPad|iPhone|Mobile|Real Estate|Realtors|Search|Tablets,3020000.0,USA,2,3,616,15845,16461,0
Big Data Analytics|Financial Services|Hospitality|Loyalty Programs|Mobile|Retail|SaaS|Social + Mobile + Local|Specialty Retail|Travel,2805000.0,USA,3,7,644,15959,16603,0
Design|Entertainment|Games|Mobile,2888200.0,ESP,1,1,0,14125,14125,0
Cloud Computing|Enterprises|Mobile|Mobile Devices|Security,11600000.0,USA,2,3,335,15575,15910,1
Enterprise Software,2328000.0,USA,2,3,200,15522,15722,1
Hospitality|Mobile|Travel,40000.0,USA,2,2,364,16223,16587,0
Data Visualization|Mobile,20356600.0,FRA,3,6,897,14123,15020,0
Mobile,14000000.0,USA,2,3,968,13071,14039,0
Mobile,9000.0,IND,1,1,0,13604,13604,0
Big Data|Big Data Analytics|Mobile,8362914.0,USA,3,4,933,15717,16650,0
Services,17000000.0,GBR,1,3,0,12346,12346,0
Wireless,23000000.0,USA,1,3,0,12516,12516,0
Mobile|Photo Sharing|Social Media,95359.0,USA,1,1,0,15222,15222,0
Crowdsourcing|Enterprise Software|Lead Generation|Outsourcing|Sales and Marketing|Sales Automation,6000000.0,USA,4,25,1225,15126,16351,0
Mobile Software Tools|Software,1500000.0,USA,1,1,0,16266,16266,0
Analytics|Automotive|Cars|Transportation,515000000.0,NLD,3,6,2614,13279,15893,1
E-Commerce|Mobile|Mobile Commerce|Retail,2100000.0,ISR,2,3,297,16102,16399,0
Mobile|Security,1200000.0,USA,1,2,0,15095,15095,1
Software,12100000.0,USA,1,4,0,12821,12821,0
Mobile,425000000.0,USA,2,3,994,15755,16749,0
Apps|B2B|Consumers|Enterprises|Mobile|Retail|Sales and Marketing|Subscription Service|Technology|Web Development,300000.0,LTU,2,2,916,15218,16134,0
Customer Service|Location Based Services|Mobile Payments|Payments,151693.527681759,USA,2,2,638,15614,16252,0
Communities|Enterprise Software|Productivity Software|SaaS,1200000.0,USA,1,1,0,16399,16399,0
Health Care|Medical,350000.0,USA,3,6,245,15838,16083,0
Mobile|Payments,3530000.0,USA,4,4,902,15582,16484,0
Semiconductors,10000000.0,USA,1,2,0,13257,13257,0
Guides|Mobile|Offline Businesses|Real Time|Social Media|Travel,367800.0,FRA,1,1,0,15532,15532,0
Mobile,3400000.0,CHN,1,1,0,14590,14590,0
Mobile,350000.0,USA,1,2,0,14153,14153,0
Android|Apps|Design|Events|Hotels|iPhone|Mobile|Mobility|Sales and Marketing|Software|Weddings,946000.0,ESP,1,3,0,15971,15971,0
Social Media,13834534.0,CAN,6,6,1187,14956,16143,0
Software,40000.0,USA,1,1,0,15440,15440,0
Gift Card|Mobile|Photo Sharing,1000000.0,USA,1,1,0,14610,14610,0
Android|Mobile,4400000.0,USA,2,1,71,15643,15714,0
Mobile,33000000.0,USA,6,9,1660,15062,16722,0
Software,23888600.0,USA,4,1,442,16107,16549,1
Health Care,4200000.0,USA,1,1,0,15861,15861,0
Cloud Computing|Cloud Data Services|Mobile|SaaS,600000.0,USA,2,2,61,15584,15645,0
Travel,1000000.0,USA,1,3,0,12509,12509,0
Software,8300000.0,USA,1,5,0,12900,12900,1
Ad Targeting|Advertising|Coupons|Mobile|Sales and Marketing,18885.0,PRT,1,1,0,15522,15522,0
Games|Mobile Video|Software|Video Streaming,142799000.0,USA,7,20,4293,11503,15796,0
Hardware + Software,20220000.0,USA,2,6,678,13179,13857,1
Biotechnology,8500000.0,USA,3,2,2262,13726,15988,0
Apps|Mobile|Mobility,4845320.0,ESP,16,1,2092,13970,16062,0
Internet|Mobile Commerce|Video Streaming,135000.0,RUS,1,1,0,15412,15412,0
Mobile|Telephony|VoIP,11000000.0,CAN,1,4,0,13787,13787,1
Mobile,24000000.0,USA,3,13,1558,13398,14956,1
Apps,375000.0,PHL,1,1,0,16645,16645,0
Apps|Mobile|Mobile Devices,1572469.0,USA,2,3,125,16436,16561,0
Curated Web|iPhone|Media|Mobile|Photography|Real Time|Social Media|Transportation|Video,86045000.0,ISR,4,10,743,15272,16015,0
Wireless,1400000.0,USA,2,3,282,16293,16575,0
Energy|SaaS,2100000.0,USA,1,3,0,13426,13426,0
E-Commerce,20000000.0,BRA,1,4,0,15825,15825,0
Games,19130000.0,USA,8,6,1522,13514,15036,0
Cloud Computing|Mobile,10000000.0,USA,2,3,411,15173,15584,1
Apps|Consumer Electronics|Entertainment|Mobile|Social Television|Sports,790145.0,CAN,1,1,0,14335,14335,0
Apps|Augmented Reality|Games|Software|Travel,70000.0,ITA,1,2,0,15915,15915,0
Web Hosting,50000.0,USA,1,1,0,14496,14496,0
Accounting|Advertising|App Marketing|Incentives|Mobile,3500000.0,FRA,1,3,0,15062,15062,1
Advertising,575000.0,USA,2,1,231,14844,15075,1
Mobile|Publishing,2000000.0,IND,1,2,0,16040,16040,0
Advertising|App Marketing|Brand Marketing|Mobile,500000.0,USA,1,1,0,16189,16189,0
Mobile Advertising|Mobile Games,10000000.0,HKG,1,1,0,16344,16344,0
Mobile,71620000.0,CHN,3,5,1388,15340,16728,0
E-Commerce Platforms|Online Rental|Parking,842000.0,FRA,2,1,197,15992,16189,0
Designers|Health and Wellness|Health Care|Innovation Engineering,4000000.0,USA,1,2,0,16673,16673,0
Cyber|Mobile Security|Security,69737075.0,USA,7,17,3401,13239,16640,0
Software,8190219.0,USA,3,3,797,13706,14503,0
Automotive|Cars|Services,10000000.0,CHN,1,1,0,16577,16577,0
Families|Search,5100000.0,USA,3,10,289,15187,15476,0
E-Commerce,162425.0,CHN,2,3,396,15887,16283,0
Advertising|Content Syndication|Media|News|Web Tools,11116771.0,USA,4,7,1441,13515,14956,1
Advertising|Games,14000000.0,USA,4,7,1206,12842,14048,1
Education,400000.0,IND,1,1,0,16686,16686,0
Games,10500000.0,USA,3,7,1123,13752,14875,0
Retail,5613247.0,GBR,1,1,0,16360,16360,0
Distribution|Logistics|Storage,750000000.0,USA,1,1,0,16511,16511,0
Fashion,138414215.0,USA,5,15,1696,14783,16479,0
Colleges|E-Commerce|Fashion|Finance|Marketplaces|Shopping,120000.0,USA,1,1,0,15888,15888,0
E-Commerce,8500000.0,TUR,3,4,700,15796,16496,0
Finance|FinTech,1310000.0,CAN,1,2,0,13214,13214,0
E-Commerce|Environmental Innovation|Fashion|Startups|Sustainability,300000.0,USA,1,2,0,15857,15857,0
Technology,1566772.48598298,SWE,2,4,151,16611,16762,0
E-Commerce|Fashion|Lifestyle|Marketplaces|Social Network Media|Trading,16000.0,USA,1,1,0,15887,15887,0
Architecture|Clean Energy|Clean Technology|Energy Efficiency,471951.0,MEX,4,4,577,15614,16191,0
CRM|Software,6482605.0,USA,2,1,776,14180,14956,1
Software,11000000.0,USA,1,3,0,12446,12446,1
Curated Web|Fashion,5000000.0,USA,1,1,0,13978,13978,0
3D|Architecture|Industrial|SaaS,1100000.0,USA,2,1,75,16375,16450,0
Fashion,279792.0,DEU,1,2,0,14245,14245,0
Advanced Materials|Food Processing,11200000.0,USA,3,10,297,16070,16367,0
Android|Software|Software Compliance,85000.0,USA,2,1,512,16269,16781,0
Biotechnology,674600044.0,USA,5,9,760,15680,16440,0
Investment Management,2200000.0,CAN,1,1,0,16701,16701,0
Health Care Information Technology|Software,101561000.0,USA,8,10,2069,14630,16699,0
E-Commerce|Fashion|Lifestyle,1800000.0,USA,1,3,0,15364,15364,1
Public Relations,12155342.0,USA,3,5,602,13861,14463,1
Curated Web|E-Commerce|Fashion|Marketplaces|Social Buying,275000.0,FRA,1,4,0,15866,15866,0
Android|iOS|iPad|iPhone|Mobile|Open Source,8050000.0,USA,4,2,1975,14740,16715,0
Customer Support Tools|Legal,13283042.0,USA,3,7,977,15659,16636,0
Advanced Materials|Advertising|Aerospace|Automotive|Displays|Hardware + Software|Wearables,137104.0,FIN,2,3,404,16205,16609,0
Mobile|Wireless,85000000.0,ISR,3,5,580,13665,14245,0
Blogging Platforms|Publishing|Service Providers|Web Tools,2000000.0,ISR,1,1,0,14719,14719,0
Education|Manufacturing|Robotics,7575614.0,USA,4,3,1677,14711,16388,0
Application Platforms|Game|Information Services|Information Technology|Software|Web Hosting,270000.0,USA,2,2,183,15523,15706,1
Brokers|Finance|FinTech|Software|Stock Exchanges|Trading,8450000.0,USA,1,3,0,15340,15340,0
Cable|Video|Video on Demand,18704000.0,USA,3,4,693,12363,13056,1
Manufacturing,42206408.0,USA,5,14,3066,13606,16672,0
Legal,10000000.0,USA,1,3,0,15867,15867,0
Consulting,9000000.0,RUS,2,3,361,15404,15765,0
Mobile|Mobile Enterprise|SaaS,6835114.0,IND,2,5,5,16687,16692,0
Clean Technology,1343266.0,GBR,2,4,1184,15522,16706,0
Games,17624255.0,CHN,2,3,574,15887,16461,0
Apps,1300000.0,USA,1,3,0,16689,16689,0
Mobile|Publishing,1825000.0,USA,6,8,1684,14112,15796,1
Internet Radio Market|Music,24900000.0,USA,7,12,1394,13272,14666,1
Facebook Applications|Messaging|Networking|Web Hosting,500000.0,USA,1,3,0,13726,13726,1
E-Commerce|Payments,480000.0,SGP,1,1,0,15756,15756,0
Technology,45236966.0,USA,7,16,1679,14975,16654,0
Android|Apps|Artists Globally|Games|iPad|iPhone|Mobile|Publishing|Software|Writers,1215000.0,USA,3,1,904,14953,15857,0
Consumers|E-Commerce|Finance,200000000.0,CAN,1,1,0,16680,16680,1
Cloud Computing|Finance|Security|Software|Web Design,12000.0,USA,1,1,0,14669,14669,0
Events|Mobile|Ticketing,115000.0,USA,1,4,0,14823,14823,0
Advertising|App Marketing|Messaging|Mobile|Sales and Marketing|SMS|Wireless,13988210.0,USA,4,12,1708,13726,15434,1
Beauty|E-Commerce|Fashion|Online Shopping|Retail|Women,412000000.0,CHN,6,15,1756,15006,16762,0
Software,680000.0,NZL,2,2,388,15652,16040,0
Software,2000000.0,NOR,1,1,0,12972,12972,1
Big Data Analytics,28000.0,USA,1,1,0,15896,15896,0
Broadcasting|Entertainment|Mobile Video|Social Media|Video Chat|Video Streaming,5640000.0,JPN,2,3,400,15847,16247,0
Cloud Security|Fraud Detection|Mobile,5000000.0,USA,1,2,0,16027,16027,1
Android|Application Platforms|Apps|App Stores|Developer APIs|Development Platforms|Gps|Hardware + Software|Internet|iOS|Mobile|Wireless,10300000.0,CAN,2,7,524,15994,16518,0
Advertising|App Marketing|Mobile|Music|Wireless,45799999.0,USA,6,9,2046,13879,15925,0
Supply Chain Management|Technology|Wireless,80000000.0,USA,3,6,3154,13377,16531,0
Automotive|Cars|Classifieds,6457640.0,USA,4,8,1144,14641,15785,0
Local Search|Reviews and Recommendations|Search|Social Media,5000000.0,USA,1,1,0,14425,14425,0
Enterprise Software|Software,104300012.0,USA,8,11,3080,13285,16365,0
Cloud Computing|Mobile|Mobile Devices,11410828.0,USA,2,8,817,15798,16615,0
Video Games,2000000.0,USA,2,3,599,15340,15939,0
Biotechnology,224071696.0,USA,5,3,1603,14032,15635,0
B2B|Colleges|Curated Web|Education|SaaS|Sales and Marketing|Universities,20000.0,ITA,1,1,0,15706,15706,0
Collaboration|Finance|Startups,1597440.0,ESP,1,3,0,15400,15400,0
Biotechnology,2031932.0,JPN,5,2,597,15743,16340,0
Biotechnology,24500000.0,USA,2,4,428,14193,14621,0
Biotechnology,9749590.0,USA,5,9,1035,14411,15446,0
Health and Wellness|Health Diagnostics|Information Technology|Medical,26714063.3515108,DEU,1,1,0,16757,16757,0
Biotechnology,21935000.0,USA,4,6,1324,15103,16427,0
Hardware|Nanotechnology|Semiconductors,44310000.0,USA,4,12,3663,12522,16185,1
Biotechnology,59760000.0,CHE,2,9,855,13739,14594,1
Health Care,6533492.0,GBR,1,1,0,16336,16336,0
Biotechnology|Health Care Information Technology|Medical Devices,6695000.0,USA,7,12,900,15400,16300,0
Biotechnology|Health and Wellness|Health Care,33509621.0,USA,6,7,1961,14367,16328,0
Medical Devices,500000.0,GBR,1,1,0,13760,13760,0
Biotechnology|Health Diagnostics,8500000.0,USA,2,1,413,15432,15845,0
Energy|Enterprise Software|Finance,2330000.0,USA,3,6,810,15576,16386,0
Music|Musical Instruments|Technology,70000.0,USA,1,2,0,15736,15736,0
Biotechnology,6182936.0,USA,4,6,931,15643,16574,0
Hardware|Health Care,4000000.0,CAN,1,1,0,16220,16220,0
Curated Web|Music|Networking,55600000.0,USA,2,4,365,13514,13879,0
Advertising|Brand Marketing|Technology,4000000.0,USA,3,13,637,16071,16708,0
Biotechnology,4596738.35876011,GBR,1,1,0,16735,16735,0
Games|Gamification|iOS|Mobile|Windows Phone 7,11700.0,SGP,1,1,0,15946,15946,0
Broadcasting|Entertainment|Television,11200000.0,FRA,1,1,0,16604,16604,0
Biotechnology,713882.0,GBR,2,2,847,14761,15608,0
Biotechnology,765800.0,LVA,2,3,864,14953,15817,0
E-Commerce|PaaS|SaaS,120000.0,USA,1,3,0,16405,16405,0
Babies|Curated Web|Medical|Parenting|Social Network Media,10000.0,NGA,1,1,0,16040,16040,0
Social Media,1000000.0,USA,1,4,0,15529,15529,0
Messaging,5400000.0,SWE,1,2,0,13900,13900,0
Health Care,5000000.0,USA,1,1,0,15174,15174,0
Hardware + Software|Mobile|Photography,3326424.0,USA,2,10,295,16322,16617,0
Curated Web|Photo Sharing|Social Media|Video,3150000.0,USA,2,4,762,15475,16237,1
Biotechnology,39500000.0,USA,2,9,286,12193,12479,1
Application Platforms|Apps|Employment|Human Resource Automation|Mobile|Recruiting|Skill Assessment|Social Recruiting,74036.0,CZE,3,1,403,15913,16316,0
Advertising|Analytics|Digital Media|Internet Marketing|SaaS|Social Media Marketing|Software,11237305.0,USA,4,24,1542,15166,16708,0
Clean Technology,3150000.0,NOR,1,1,0,13948,13948,0
Finance|Financial Services|Legal|Venture Capital,30000000.0,USA,1,1,0,16448,16448,0
Location Based Services|Online Dating|SNS,102500000.0,CHN,3,2,1188,15187,16375,0
Digital Media|Mobile Payments|Startups,1200000.0,IND,2,3,130,16363,16493,0
Social Media|Travel,8371002.0,DNK,2,1,1164,15062,16226,1
Online Travel|Vertical Search,151959528.0,GBR,3,2,460,16225,16685,0
Babies|E-Commerce|Parenting,2000000.0,TUR,1,2,0,15859,15859,0
Apps|Location Based Services|Photography|Photo Sharing|Software,500000.0,USA,1,3,0,16587,16587,0
Social Media|Software|Twitter Applications,425000.0,USA,3,8,674,15456,16130,0
Enterprise Software|Location Based Services|Mobile|SaaS,1840000.0,USA,2,1,175,15712,15887,0
Software,5500000.0,IND,1,1,0,14880,14880,0
Video,45039.0,KOR,1,1,0,15949,15949,0
Software,699000.0,FRA,1,2,0,13329,13329,0
Finance,3143047.0,GBR,1,1,0,16616,16616,0
DIY|E-Commerce|Energy|Home & Garden|Internet|Marketplaces|Plumbers,612329.0,FRA,2,1,273,15737,16010,0
Banking|Finance|Financial Services,1800000.0,GBR,1,3,0,16582,16582,0
Telecommunications,32000000.0,USA,1,4,0,11757,11757,0
Enterprise Software|Testing,48047540.0,USA,7,9,2165,13879,16044,0
Bitcoin|Crowdfunding|E-Commerce|Startups,300000.0,USA,2,1,91,16100,16191,0
Software,1000000.0,CAN,2,2,1582,14466,16048,0
Peer-to-Peer,500000.0,HKG,1,1,0,16405,16405,0
Curated Web|Personal Finance,7791178.0,GBR,2,5,424,16037,16461,0
Software,30900000.0,JPN,3,13,725,16005,16730,0
Financial Services,1991592.0,GBR,3,3,495,16143,16638,0
Curated Web|Mobile,10000000.0,IND,1,1,0,15964,15964,0
Android|Finance|iPhone|Personal Finance,144439.0,GBR,2,1,245,15034,15279,0
Finance|FinTech,50000000.0,USA,2,12,177,16377,16554,0
Finance,49673284.0,GBR,1,1,0,13969,13969,0
Finance|Financial Services,22806526.3474125,ITA,4,8,1714,15034,16748,0
Credit|Service Providers|Social Network Media,16249.0,DEU,1,1,0,16635,16635,0
Finance,9000000.0,RUS,2,3,614,15966,16580,0
Finance|Insurance,1731783.0,DEU,3,1,957,15340,16297,0
Billing|Customer Service|Finance Technology|FinTech|Software,3637012.0,POL,3,6,237,16071,16308,0
Insurance,2000000.0,SGP,1,4,0,16714,16714,0
Billing|Mobile Payments|Payments,3700000.0,USA,2,2,132,16541,16673,0
Education|Financial Services|Nonprofits|Ventures for Good,100000.0,USA,1,1,0,16008,16008,0
Banking|Big Data|Credit Cards|Finance|FinTech|Personal Finance,1600000.0,JPN,2,9,708,16022,16730,0
Agriculture|Manufacturing|Software|Technology|Web Tools,1286600.0,IRL,1,1,0,15922,15922,0
Cloud Computing|Databases|Open Source|PaaS|Software,311100000.0,USA,8,30,2363,14081,16444,0
Cloud Computing|Databases|Networking|Web Hosting,6417000.0,USA,2,8,483,15149,15632,1
Big Data|Business Intelligence|Data Integration|Information Technology,30000.0,USA,2,1,56,16252,16308,0
FinTech,1450000.0,GBR,1,7,0,16750,16750,0
Finance|Financial Services|Mobile|Mobile Payments|P2P Money Transfer,5120000.0,GBR,3,2,487,15857,16344,0
Mobile,232329416.0,GBR,4,5,1598,14803,16401,1
Energy Efficiency,40000.0,CHL,1,1,0,16222,16222,0
Software,65000.0,IRL,2,2,185,15793,15978,0
Curated Web,16000000.0,USA,2,7,55,13398,13453,0
Social Media,3850000.0,AUS,1,2,0,13937,13937,0
Games,40000.0,CHL,1,1,0,15376,15376,0
Advertising|App Marketing|Networking|Social Media,79248.0,GBR,1,3,0,15584,15584,0
Artificial Intelligence|Developer APIs|Machine Learning|SaaS|Text Analytics,675000.0,USA,3,7,403,16262,16665,0
Kids|Language Learning|Mobile Games,2000000.0,USA,3,6,242,16283,16525,0
Mobile,10606760.0,GBR,1,1,0,16129,16129,0
E-Commerce|Marketplaces|Social Commerce,1168000.0,JPN,6,6,1114,14847,15961,0
iPad|News|Online Shopping|Shopping,1240000.0,USA,2,2,63,15583,15646,0
Fashion|Hardware + Software|Internet of Things|Lifestyle Products,968000.0,USA,3,1,407,16085,16492,0
Language Learning|Speech Recognition,25000.0,ESP,1,1,0,16130,16130,0
Web Tools,18584.0,NLD,1,1,0,15492,15492,0
Semiconductors,16700000.0,USA,1,3,0,11943,11943,1
Health Care,1800000.0,USA,1,1,0,16184,16184,0
Software,2049999.0,USA,1,2,0,16202,16202,0
Hardware + Software,2000000.0,USA,1,8,0,16353,16353,0
Consumer Goods,159790.0,GBR,1,1,0,16252,16252,0
Application Platforms|Internet|Web Development,1174745.0,JPN,1,3,0,16290,16290,0
Analytics,10000000.0,USA,1,1,0,14998,14998,0
Health and Wellness|Manufacturing,460000.0,USA,2,2,608,14518,15126,0
Games,400000.0,USA,2,1,583,14599,15182,0
Enterprise Software,14700000.0,USA,3,13,1364,14862,16226,0
Semiconductors,21930000.0,CHN,7,8,1461,13300,14761,1
Semiconductors,26300000.0,USA,1,4,0,13231,13231,1
Software,24766667.0,USA,2,5,980,13487,14467,1
Hospitals|Medical|Services,3500000.0,USA,1,1,0,16387,16387,0
Software,35200000.0,USA,2,6,964,11299,12263,1
Health Care|Medical Devices,77468460.0,USA,9,10,1879,14508,16387,0
Games,1826030.05848369,GBR,1,3,0,16715,16715,0
Education,1000000.0,USA,2,2,322,16314,16636,0
Curated Web,1000000.0,USA,1,1,0,15400,15400,0
Games,3250000.0,GBR,1,2,0,14593,14593,0
Banking|Financial Services|FinTech|Personal Finance,447883.0,NLD,1,1,0,16687,16687,0
Business Services|Curated Web|Mass Customization|Photography|Photo Sharing,9717821.0,GBR,2,4,3376,13239,16615,0
Manufacturing,52000000.0,USA,3,2,1226,13706,14932,0
Apps|Startups|Technology,31205.0,GBR,1,1,0,16660,16660,0
Consumer Goods|Eyewear|Sunglasses,472422.0,PRT,1,1,0,16363,16363,0
Android|iPhone|Social Media,20000.0,AUS,1,1,0,16222,16222,0
Analytics|Enterprise Software|IT Management,21300000.0,USA,2,4,510,15854,16364,0
Space Travel,31500000.0,USA,3,26,1461,14853,16314,0
Fashion|Lingerie,20000000.0,CHN,1,2,0,14789,14789,0
Game,15000000.0,IND,1,2,0,16505,16505,0
Design,2250000.0,GBR,2,2,189,14845,15034,1
Algorithms|Mobile|Online Dating|Optimization,4000000.0,USA,3,1,328,16070,16398,0
Human Resources|Information Services|Information Technology|Marketplaces,1900000.0,USA,2,3,376,16222,16598,0
Curated Web,6760000.0,USA,2,3,773,14658,15431,0
Advertising|Analytics|Communities|E-Commerce|Networking|Social Commerce,17998631.0,USA,5,3,1806,14412,16218,0
Distribution|Music|Promotional,70000.0,RUS,1,1,0,15614,15614,0
Consumer Electronics|Fitness|Health and Wellness|Sports|Wearables,4000000.0,USA,2,1,222,16143,16365,0
E-Commerce|Internet|Transportation,60000.0,ITA,1,1,0,16461,16461,0
Collaboration|Project Management|Social Media|Social Network Media,400000.0,BRA,1,1,0,15706,15706,0
Crowdsourcing|Navigation|Public Transportation|Transportation,81500000.0,ISR,4,14,1311,15431,16742,0
Cloud Computing|Content|Design|Education|Graphics|Media|Sales and Marketing,1318679.0,BEL,3,1,648,15756,16404,0
Apps|Mobile,16700000.0,USA,2,5,1547,14245,15792,0
Analytics|Android|Apps|Graphics|iPhone|Mobile|Music|RIM|Sales and Marketing|Shopping,430855.0,GBR,2,2,455,14610,15065,0
Hardware + Software,1000000.0,USA,2,3,1462,13361,14823,1
Distribution|Film|Games,68000.0,USA,2,2,111,15248,15359,0
Mobile,6059507.04782396,GBR,3,3,365,15582,15947,1
Customer Service|Marketplaces|Services,374157.957825345,FIN,2,2,89,16596,16685,0
Enterprise Software,2238055.0,USA,2,1,91,15163,15254,0
Advertising|Mobile|Mobile Advertising,18500000.0,USA,4,10,750,14853,15603,1
Manufacturing,15000000.0,TWN,2,3,472,16040,16512,0
Healthcare Services,3410000.0,USA,2,1,30,16527,16557,0
Marketing Automation,17000000.0,GBR,1,1,0,16707,16707,0
Software,20000000.0,CAN,2,6,1092,13726,14818,0
Finance,4125000.0,USA,1,3,0,12963,12963,1
Business Intelligence|Search|Technology,21000000.0,USA,1,5,0,11120,11120,0
Banking|Financial Services|FinTech|Startups,20000.0,UKR,1,2,0,16538,16538,0
Hospitality,8000000.0,USA,1,1,0,16077,16077,0
Clean Technology,930000.0,GBR,1,1,0,14030,14030,0
Clean Technology,38200000.0,CAN,4,4,784,14523,15307,0
Services|Supply Chain Management,2000000.0,USA,1,2,0,14056,14056,0
Manufacturing,68897.0,DEU,1,1,0,16135,16135,0
Games,8246289.0,CHN,2,2,221,15857,16078,0
Investment Management|Software,91000000.0,USA,1,1,0,10781,10781,1
Cloud Computing|Cloud Management|Enterprise Software|IaaS|PaaS|SaaS,22750000.0,USA,6,10,2780,13965,16745,0
Gift Card|Software,20000.0,USA,2,1,100,15340,15440,0
Cyber|Cyber Security|Security,10000000.0,USA,1,1,0,16699,16699,0
Software,7000000.0,ISR,1,4,0,16714,16714,0
Semiconductors,11540000.0,USA,2,3,1042,12891,13933,1
Innovation Management|Medical|Medical Professionals,26000000.0,USA,1,10,0,12468,12468,0
Consumer Goods|Health and Wellness,1920000.0,USA,2,3,292,16344,16636,0
Consumers|Food Processing|Restaurants,800000.0,USA,1,3,0,16350,16350,0
Security,1000000.0,USA,1,7,0,15749,15749,1
Big Data|Cloud Computing|Finance|FinTech|Open Source|PaaS|Software,3150000.0,USA,4,5,702,15363,16065,1
Commercial Real Estate|Real Estate|Technology,1750000.0,USA,1,1,0,11645,11645,1
Biotechnology,3274000.0,USA,2,3,825,15286,16111,0
Cloud Computing|iOS|iPad|iPhone|Photo Editing|Photography|Software|Synchronization,1542844.0,USA,3,7,719,15365,16084,0
Fruit,1000000.0,IND,2,2,811,15706,16517,0
Agriculture|Farming|Technology,90000.0,GEO,2,2,245,16495,16740,0
Aerospace,1000000.0,USA,1,1,0,16248,16248,0
Media|Recruiting|Social Media,6814196.0,CHN,2,6,336,16343,16679,0
Curated Web|Internet,5700000.0,USA,3,5,501,14680,15181,0
Clean Technology,92500000.0,IND,1,5,0,14126,14126,0
Games|Manufacturing,14688086.0,CHN,3,3,791,14031,14822,0
Manufacturing,1500000.0,USA,1,5,0,15370,15370,0
Automotive|Cars|E-Commerce|Enterprises|Finance|Price Comparison|Trusted Networks,9500000.0,USA,3,1,1165,13991,15156,0
Mobile|Wireless,1999999.0,USA,2,3,293,14412,14705,1
Health and Wellness|Health Care|Parenting,3450000.0,USA,3,7,642,15079,15721,0
Biotechnology,2870000.0,USA,2,2,399,13209,13608,0
Brokers|Consumers|Finance|Financial Services,126500000.0,USA,6,18,1293,15162,16455,0
Curated Web|Self Development|Task Management,20000.0,UKR,1,1,0,15607,15607,0
Games,22500000.0,USA,3,1,720,15546,16266,0
Biotechnology|Diagnostics|Mens Specific,646551.0,DNK,2,2,928,15228,16156,0
Software,47799995.0,USA,4,9,2245,12363,14608,1
Retail|Software,160000.0,CHL,2,1,242,15289,15531,0
EdTech|Education|Games|Mobile,500000.0,USA,3,12,893,15056,15949,0
Digital Media|Fitness|Freemium|Health and Wellness|Mobile|Publishing,50000.0,USA,1,1,0,16168,16168,0
Advertising,15700000.0,JPN,1,1,0,14055,14055,0
Games|Video|Video Editing|Video Streaming,17200000.0,USA,3,8,866,13392,14258,1
SaaS|Software|Technology,500000.0,USA,5,5,454,16091,16545,0
Software,21799976.0,USA,5,5,1503,14855,16358,0
Hardware + Software|Wearables,1220000.0,USA,2,4,324,16141,16465,0
Enterprise Software,3450000.0,USA,3,1,2267,12797,15064,0
Software,6000.0,POL,1,1,0,14883,14883,0
Automotive|Electric Vehicles|Manufacturing,15652000.0,USA,3,1,1778,14805,16583,0
E-Commerce|Fashion|Internet,650100.0,ESP,1,1,0,15620,15620,0
E-Commerce,5000000.0,CHN,2,5,1370,13848,15218,0
Automotive,25000.0,ARG,1,1,0,16588,16588,0
Public Safety,1000000000.0,USA,1,1,0,16652,16652,1
Automotive|Interest Graph|Mobile|Social Media Platforms,118000.0,USA,1,1,0,16595,16595,0
Automotive,40000.0,IND,1,1,0,15940,15940,0
Mobile,150000.0,GBR,2,1,84,15857,15941,0
Big Data Analytics|Cars|Diving|Insurance|Maps|Public Transportation|Sensors|Transportation,500000.0,BEL,1,1,0,16424,16424,0
Education,7090000.0,USA,2,1,104,15863,15967,0
Aerospace|Big Data Analytics|Drones|Environmental Innovation|Public Safety|Sensors|Utilities|Ventures for Good,25000.0,USA,1,1,0,16467,16467,0
Software,3000000.0,USA,2,7,468,11676,12144,0
E-Commerce,100000.0,USA,1,1,0,16375,16375,0
E-Commerce|Travel,1000000.0,SVN,1,1,0,14944,14944,0
E-Commerce|Internet|Specialty Foods,8411685.0,USA,4,9,1388,15340,16728,0
Fitness|Hardware + Software|Wearables,2045000.0,USA,2,6,841,15019,15860,0
Advertising|Email|Email Marketing|Real Time|Sales and Marketing,9290000.0,USA,3,20,827,15006,15833,0
Online Travel,10302581.7887628,DEU,2,11,114,16648,16762,0
Software,24000000.0,USA,3,10,1394,11981,13375,1
Web Hosting,20000000.0,USA,1,6,0,13174,13174,0
Enterprise Software|Human Resource Automation|Local Based Services|Navigation|Technology,26224193.0,GBR,4,21,1193,15522,16715,0
Consumer Goods|E-Commerce|Furniture|Retail|Specialty Retail|Sustainability,21800000.0,USA,3,20,418,16230,16648,0
Hardware + Software,29468580.236289196,FRA,3,10,1705,13848,15553,1
Android|Games|iOS|iPhone|Location Based Services|Mobile,350000.0,USA,2,2,1186,14245,15431,0
Curated Web,20000.0,USA,1,1,0,15964,15964,0
Software,4000000.0,IND,2,4,342,16289,16631,0
Curated Web|Finance|Local Based Services,4750000.0,USA,7,28,1050,15330,16380,0
Curated Web|Education|Networking|Publishing|Social Media|Teenagers,500000.0,GBR,2,1,713,15248,15961,0
E-Commerce Platforms|Entrepreneur|Startups,8127390.0,USA,2,4,399,16331,16730,0
Banking|Lifestyle|Mobile|Personal Finance,24410000.0,USA,4,10,1158,15563,16721,0
Content Delivery|Software|Video Streaming,102083349.0,USA,6,12,1204,13551,14755,1
Cloud Computing|Cloud Data Services|Curated Web|File Sharing|Flash Storage|Synchronization,1040000.0,CAN,5,10,913,15180,16093,0
Enterprise Software,5000000.0,USA,1,1,0,13418,13418,0
Enterprise Software,5992316.0,USA,2,2,1013,13678,14691,0
Biotechnology,191229400.0,BEL,2,8,1060,13521,14581,1
Mobile|Semiconductors|Software,86500000.0,USA,5,30,2370,14169,16539,0
Software,40000.0,BRA,1,1,0,14957,14957,0
Celebrity|Curated Web|Entertainment|Film|Media|Promotional|Sales and Marketing|Social Network Media,750000.0,USA,2,10,166,16023,16189,0
Entertainment|Games,3700000.0,USA,2,26,1311,15028,16339,0
Entertainment|News|Publishing|Social Network Media,30000000.0,USA,3,4,1223,15470,16693,0
Curated Web,6500000.0,CAN,2,3,44,14040,14084,0
Graphics|Software|Startups,5500559.0,GBR,3,3,1218,12935,14153,0
Mobile,44000000.0,USA,4,10,1154,13910,15064,0
Apps|Mobile|Mobile Commerce|Telecommunications,96000000.0,BRA,5,8,5585,10957,16542,0
Automotive,9600000.0,USA,2,3,478,13200,13678,0
Curated Web,129517.0,DEU,1,2,0,15645,15645,0
Health and Wellness|Health Care Information Technology,115000.0,USA,4,5,645,15826,16471,0
Enterprises|Nonprofits|Travel,412000.0,USA,2,1,432,15771,16203,0
E-Commerce,6819163.36442367,DEU,1,8,0,16674,16674,0
Software,1500000.0,USA,1,1,0,13587,13587,0
Games,489703.0,SWE,1,2,0,14905,14905,0
Entertainment,950000.0,USA,1,2,0,15629,15629,0
Audio|Emerging Markets|Information Technology|Infrastructure|Messaging|Mobile|Networking|SMS|Social Entrepreneurship|Social Media|Software|Technology|Telecommunications|Telephony|Wireless,5500000.0,GBR,1,1,0,14924,14924,1
Curated Web,1300000.0,USA,1,5,0,14870,14870,1
Mobile,39728460.0,USA,2,1,375,15870,16245,0
Entertainment|Film|Games|Search|Social Network Media,1500000.0,ISR,1,1,0,14975,14975,0
Cars|E-Commerce|Online Rental|Peer-to-Peer,308420.0,ESP,3,3,641,15826,16467,0
Messaging|Video,300000.0,USA,1,1,0,16071,16071,0
Collaborative Consumption|Home & Garden|Mobile|Startups,125000.0,USA,3,6,536,16161,16697,0
Facebook Applications|Games|Music|Social Games|Social Media,550000.0,USA,1,12,0,15344,15344,0
Health Care,100000.0,USA,1,2,0,15614,15614,0
Babies|E-Commerce|Fashion|Kids|Startups,1885539.0,USA,3,3,804,15492,16296,1
E-Commerce|Enterprise Software|Software,35000000.0,USA,3,6,2746,13579,16325,0
Biotechnology,80607656.0,USA,3,9,1249,15313,16562,0
E-Commerce|Fashion|Shopping,4700000.0,USA,2,1,745,14057,14802,0
Mobile,20000000.0,USA,2,5,504,15972,16476,0
Education|Mobile|Services,10000.0,RUS,1,1,0,15461,15461,0
News|Services,25000.0,RUS,1,1,0,16040,16040,0
Search|Semantic Search|SEO|Software,19250000.0,USA,2,4,1704,13757,15461,0
Internet,60000.0,MEX,2,1,48,16375,16423,0
Education|Games|Green|Mobile|Skill Assessment,500000.0,IDN,1,5,0,15438,15438,0
Tourism|Travel,27200000.0,ZAF,1,1,0,16265,16265,0
Analytics|Business Intelligence,1500000.0,USA,2,1,480,14365,14845,0
App Marketing|Audio|Brand Marketing|Mobile|Music|SMS|Wireless,22299999.0,USA,3,5,1279,13566,14845,0
Enterprise Software|Mobile Commerce|Mobile Payments,307161792.0,USA,4,5,1318,15047,16365,0
Browser Extensions|Curated Web|Open Source,2300000.0,USA,2,2,536,12248,12784,0
Mobile|Public Transportation|Search|Travel,750000.0,USA,3,13,712,15492,16204,0
Flash Storage|Web Hosting,1900000.0,USA,1,3,0,12904,12904,1
Big Data|Enterprise Software|Mobile|Software,8805000.0,USA,3,14,625,15993,16618,0
Software,9164123.0,USA,4,2,1478,14123,15601,0
Biotechnology,32000000.0,USA,1,6,0,13004,13004,0
Health Care|Hospitals|Medical,2000000.0,USA,2,1,202,16547,16749,0
Health Care|Health Care Information Technology|Information Technology|Medical,1750000.0,USA,1,1,0,16463,16463,0
Mobile,4000000.0,USA,1,1,0,13052,13052,1
Distribution|Mobile,3750000.0,ISR,5,4,565,13444,14009,0
Advice|Investment Management|Service Providers,36000000.0,USA,1,5,0,11346,11346,1
Finance,4000000.0,USA,1,4,0,16715,16715,0
Mobile,5000000.0,USA,1,1,0,14545,14545,0
Software|Web Development,3710000.0,IRL,2,4,1676,14544,16220,0
Health Care|mHealth|Mobile,1700000.0,USA,1,4,0,16651,16651,0
Health and Wellness|Health Care,14000000.0,USA,1,5,0,13236,13236,0
Apps|Machine Learning|Public Safety,650000.0,FRA,1,1,0,16629,16629,0
Mobile,4797338.0,USA,1,1,0,15189,15189,0
E-Commerce|Finance|Investment Management,700000.0,ARG,2,4,577,15918,16495,0
Advertising|Digital Media|Public Relations|Sales and Marketing|Social Media,15100000.0,USA,2,2,2315,11961,14276,1
Service Providers|Task Management,4400000.0,USA,2,1,1034,12691,13725,1
Crowdsourcing,77000.0,IND,1,1,0,16724,16724,0
Biotechnology,18400033.0,CAN,2,2,1272,15246,16518,0
Mobile,1201000.0,USA,2,5,1055,14827,15882,1
Advertising,5000000.0,USA,1,1,0,13300,13300,1
Music,2330000.0,USA,1,1,0,12996,12996,1
Dental|Doctors|Health and Wellness|Health Care|Search,57166.0,ESP,1,3,0,14881,14881,0
Medical Devices|Technology,13500000.0,ISR,2,7,517,16100,16617,0
Incubators|Venture Capital|Young Adults,300000.0,RUS,1,2,0,15793,15793,0
Financial Services,25000000.0,IND,3,9,923,15715,16638,0
Curated Web,32000000.0,GBR,1,2,0,14131,14131,0
3D|Mobile Games|Sports,5500.0,PAK,1,1,0,16104,16104,0
Apps|Automotive|Events|Fleet Management|Information Technology|Media|Mobile|Public Transportation|Recruiting|Sales and Marketing|Taxis,1839281.0,EST,2,6,239,16183,16422,0
Energy Management|Oil & Gas|Surveys,13234657.0,GBR,1,3,0,12677,12677,1
Databases|Delivery|Professional Services,15000000.0,USA,1,1,0,12774,12774,0
Fashion,14000000.0,CHN,4,4,2769,13149,15918,0
Enterprise Software,9680000.0,GBR,2,7,745,12972,13717,0
Biotechnology|Health Diagnostics,81574940.0,USA,4,11,4088,10833,14921,1
Mobile,26660000.0,CHN,6,4,2831,8947,11778,0
Software,91914.0,KOR,2,1,428,15958,16386,0
Clean Technology,21325293.0,USA,4,8,1225,15041,16266,0
Web Hosting,24000000.0,USA,3,9,1234,12784,14018,1
Android|Educational Games|Games|iPhone|Software,1470000.0,HKG,3,1,1191,15340,16531,0
Analytics,178000000.0,USA,3,3,610,15131,15741,0
Entertainment|Film|Social Media|Social Network Media|Video,24645630.0,GBR,5,20,2714,13726,16440,0
Collaboration|SaaS|Social Games|Social Media|Software,101000.0,HKG,2,2,263,14276,14539,0
Computers|Design|Internet Service Providers,61895.0,IND,1,2,0,16414,16414,0
Games,1300000.0,JPN,2,2,638,15309,15947,0
Curated Web|Social CRM,30000.0,IND,1,1,0,16102,16102,0
Automotive|Enterprise Software|Manufacturing|Robotics,6953944.0,JPN,2,2,702,15581,16283,0
Mobile|Music|Wearables,50000.0,USA,1,1,0,16191,16191,0
Enterprise Software,259000000.0,USA,7,43,3152,13422,16574,0
Biotechnology,762237.0,DEU,2,2,631,13248,13879,0
Advertising|Sales and Marketing,3421250.0,HKG,3,3,668,15584,16252,0
Semiconductors,37891054.0,USA,3,6,954,14011,14965,1
Consulting|Document Management|Health Care|Legal,10300000.0,USA,1,1,0,15930,15930,0
Technology,7500000.0,USA,1,1,0,12382,12382,0
Data Center Infrastructure|Semiconductors,7200000.0,USA,1,4,0,14756,14756,0
Biotechnology|Health Diagnostics,10298650.0,BEL,2,5,656,15091,15747,0
E-Commerce|Social Media,26600000.0,IDN,4,6,1112,13088,14200,0
Semiconductors,500000.0,ISR,1,1,0,13362,13362,0
Security|Software|Technology,16390.0,NLD,1,1,0,16529,16529,0
Biotechnology,600000.0,USA,1,1,0,13787,13787,0
Communications Hardware|Wireless,5750000.0,USA,2,1,378,16071,16449,0
Hardware + Software,7720000.0,PRT,1,2,0,14010,14010,0
Curated Web|E-Commerce|Social Commerce,3641507.0,USA,6,10,451,15706,16157,0
Audiobooks|Digital Media,40000.0,ARG,1,1,0,15820,15820,0
Collaboration|Design|Enterprise Software|Experience Design|SaaS|Visualization,920000.0,USA,3,6,453,15400,15853,0
E-Commerce|Finance|Marketplaces|Media|Music|Technology,3166074.0,USA,4,3,1088,15363,16451,0
Apps|Mobile|Music,715000.0,GBR,2,1,210,16209,16419,0
Fitness|Health and Wellness|Nutrition,500000.0,GBR,1,1,0,16273,16273,0
Health and Wellness,15670000.0,USA,4,2,1194,14735,15929,0
Curated Web|E-Commerce,3400000.0,JPN,1,3,0,15842,15842,1
Music,93700.0,NOR,4,1,301,16231,16532,0
Music,1500000.0,USA,2,1,932,13604,14536,0
Art|E-Commerce|Ediscovery|Software|Ticketing|Tourism|Travel,6539215.0,ITA,2,6,491,16008,16499,0
Hardware + Software|Robotics|Technology,120000.0,USA,2,3,87,16504,16591,0
Curated Web,1429763.0,USA,2,2,546,13149,13695,0
Local Businesses,1000000.0,USA,1,1,0,15595,15595,0
Advertising|Brand Marketing|Digital Media|Licensing|Music,9249999.0,USA,5,1,1147,14846,15993,0
Distribution|Music,1034279.0,FIN,2,3,703,15300,16003,0
Apps|Audio|Entertainment|Mobile Games|Music|Social Network Media,36530301.0,USA,7,3,1931,14664,16595,0
Music,6493024.0,USA,2,2,786,13528,14314,0
Advertising|Independent Music|Musicians,109932.0,USA,2,2,334,15857,16191,0
Music Education|Online Education,268505.116940371,GBR,1,2,0,16687,16687,0
Analytics|SaaS,1000000.0,USA,3,6,730,14641,15371,0
Music,2000000.0,USA,1,1,0,13300,13300,0
Data Mining|Machine Learning|Music,5356025.0,GBR,3,3,1514,14214,15728,0
Curated Web|Music,42230000.0,USA,5,15,1339,10925,12264,1
Big Data Analytics|Music|Music Venues,20000.0,USA,1,1,0,16269,16269,0
Music,651750.0,DEU,1,1,0,15633,15633,0
Music,477181.0,ITA,1,2,0,16246,16246,0
Music,3500000.0,USA,2,2,396,13361,13757,0
Music,200000.0,USA,2,1,19,15675,15694,0
E-Commerce|Marketplaces|Music,70000.0,USA,2,4,92,16222,16314,0
Music,318339.0,PRT,1,2,0,16540,16540,0
Facebook Applications|Information Technology|Music|Reviews and Recommendations|Search,416595.0,GBR,1,1,0,16345,16345,0
Audio|Collaboration|Digital Media|Marketplaces|Music|Music Services|Social Network Media|Technology,614302.0,USA,3,4,825,15737,16562,0
Entertainment|Mobile|Music,3904597.0,FRA,1,2,0,11942,11942,1
Apps|Entertainment|Music,10100000.0,GBR,5,10,1627,14688,16315,0
Crowdsourcing|Public Safety|Social + Mobile + Local,1200000.0,USA,1,1,0,16251,16251,0
Apps|Mobile|Music,966285.0,FIN,4,1,1270,15242,16512,0
Software,7365000.0,USA,3,11,517,15701,16218,0
Health Care|Medical|Medical Devices,284240.0,IRL,2,2,538,14610,15148,0
Biotechnology|Food Processing,2060000.0,IRL,2,4,151,16192,16343,0
Blogging Platforms|Content|Forums|Opinions|Real Time|Social Media|Software,770000.0,USA,1,3,0,16169,16169,0
EdTech|Education|Hardware + Software|Internet of Things|Presentations|Wearables,4000000.0,ISR,2,3,1155,14975,16130,0
Mobile,16231320.0,GBR,2,6,91,14561,14652,0
Music,525000.0,USA,2,1,38,15553,15591,0
Curated Web|Music|Video|Web Development,8000000.0,IRL,1,1,0,14075,14075,0
Curated Web,4400000.0,USA,1,5,0,15874,15874,0
Art,18192.0,NLD,1,1,0,16436,16436,0
Internet of Things,1885000.0,USA,3,4,445,15684,16129,0
E-Books,450000.0,USA,1,1,0,16539,16539,0
Legal,350000.0,USA,2,2,123,15927,16050,0
Software,6000000.0,USA,1,3,0,13122,13122,1
Medical Devices,15000000.0,ISR,1,1,0,16258,16258,0
Software,93000.0,KOR,1,1,0,15651,15651,0
Software,100000.0,USA,1,1,0,15938,15938,0
Content Creators|Internet Marketing|Marketing Automation|Search Marketing|SEO|Social Media Marketing|Web Design,350000.0,USA,3,2,2922,10592,13514,0
Consulting,822000.0,SWE,1,2,0,13117,13117,0
Security,4000000.0,USA,1,5,0,13459,13459,1
Software,1775000.0,USA,3,6,785,15495,16280,0
B2B|E-Commerce|Fashion|Mobile Commerce,500000.0,ISR,1,1,0,15675,15675,0
Games,17200000.0,FRA,4,10,1144,13581,14725,0
E-Commerce,10000000.0,CHN,1,1,0,15095,15095,0
Advertising,50000.0,USA,1,1,0,14031,14031,0
Apps|Infrastructure Builders|Mobile,1700000.0,RUS,3,3,322,15355,15677,0
E-Commerce|Personal Health,365000.0,USA,1,2,0,15385,15385,0
Gps|Location Based Services|Mobile,6000000.0,USA,2,6,276,14754,15030,0
Fashion,15000.0,USA,2,1,334,16375,16709,0
Games|Video,8655804.0,USA,4,6,1816,13756,15572,0
Automotive|SaaS|Technology|Transportation,145000.0,USA,2,2,465,16130,16595,0
Cyber Security|Information Security|Network Security,800000.0,USA,2,2,189,16260,16449,0
Curated Web,22568120.0,USA,9,6,1750,14601,16351,0
E-Commerce,40000.0,CHL,1,1,0,15954,15954,0
Finance|Financial Services,100000.0,USA,1,1,0,16357,16357,0
Logistics,265064.0,ESP,1,1,0,15867,15867,0
Enterprise Software,1000000.0,GBR,1,1,0,15279,15279,0
Cloud Computing|Curated Web,1000000.0,USA,1,3,0,15415,15415,1
Public Transportation,500000.0,IND,1,2,0,16657,16657,0
Software,40000.0,FRA,1,1,0,16034,16034,0
Fashion,9000000.0,GBR,1,1,0,14795,14795,0
Cloud Computing|Security,1500000.0,USA,2,6,437,15443,15880,0
3D Printing,40000.0,CHL,1,1,0,16222,16222,0
Web Hosting,5000000.0,USA,1,1,0,16097,16097,0
Education,25000.0,USA,1,1,0,16251,16251,0
Customer Service|Sales Automation|Training,969533.0,AUS,2,1,34,16241,16275,0
Clean Technology,36781282.0,GBR,2,8,484,14406,14890,1
Music,30968.0,KOR,1,1,0,15856,15856,0
Mobile,95000.0,USA,2,1,97,16318,16415,0
E-Commerce,314905.0,GBR,1,1,0,16224,16224,0
Art|Design|E-Commerce|Fashion|Marketplaces|Sales and Marketing,1531083.0,POL,3,2,320,16010,16330,0
Services,2850000.0,USA,1,1,0,11593,11593,0
Elder Care|Peer-to-Peer,100000.0,CAN,3,3,584,15382,15966,0
Lifestyle|Local Search|Match-Making|Real Estate|Software,20000.0,USA,1,2,0,16556,16556,0
Curated Web|Plumbers|Startups,418525.0,GBR,3,7,751,13757,14508,0
Advertising|Displays|Email|Media|Mobile|Personalization|Reviews and Recommendations|Social Media,37300000.0,USA,4,8,2430,13565,15995,1
Marketplaces|Mobile,1550000.0,USA,2,3,542,15033,15575,0
Curated Web,3958200.0,FIN,1,3,0,15706,15706,0
Automotive|Cars|Women,48632.0,GBR,1,1,0,15706,15706,0
Banking|Finance|Financial Services|Wealth Management,978000.0,IND,1,1,0,16615,16615,0
Cars|E-Commerce|Transportation,60000000.0,CHN,2,6,333,16324,16657,0
Mobile,11100000.0,ISR,4,4,1548,14975,16523,0
Education|Kids|Parenting,905480.0,PRT,1,1,0,16080,16080,0
B2B|Curated Web|Networking|Online Dating|Sales and Marketing,88000.0,USA,1,1,0,16279,16279,0
Biotechnology,500000.0,CAN,1,1,0,16561,16561,0
Android|Curated Web|Hardware|iPhone|Mobile|Social Media,500000.0,USA,1,1,0,15887,15887,0
Android|Batteries|Energy|iOS|Social + Mobile + Local,500000.0,USA,2,5,334,16010,16344,0
Disruptive Models|Material Science|Specialty Foods,10565000.0,USA,5,3,786,15937,16723,0
Big Data Analytics|Business Analytics|Business Intelligence|Enterprise Software|Predictive Analytics|SaaS|Sales Automation,110000.0,USA,2,2,273,16283,16556,0
Security,10000000.0,USA,1,2,0,13733,13733,0
Software,150000.0,USA,1,1,0,16133,16133,0
Content|Curated Web|Networking|Social Media|Social Network Media,15107000.0,SGP,2,1,988,14130,15118,0
Broadcasting|Internet|Social Television|Sports,1029800.72626887,CHE,2,1,276,16191,16467,0
E-Commerce|Mass Customization|Online Shopping,50349.0,CAN,1,1,0,15675,15675,0
3D|Curated Web|E-Commerce|Home & Garden,19679275.0,GBR,2,5,578,13514,14092,1
Health Care,18000000.0,IND,2,5,897,15706,16603,0
Education,59844.0,JPN,2,1,19,15400,15419,0
Curated Web|Recipes|Social Network Media,771000.0,GBR,1,1,0,13951,13951,0
Advertising|Analytics|CRM|Email|Mobile|Productivity Software,4600000.0,USA,2,6,460,15770,16230,0
Collaborative Consumption|Marketplaces|Peer-to-Peer|Pets,3166107.0,GBR,3,7,669,15826,16495,0
Mobile,300000.0,USA,1,1,0,15506,15506,0
Data Security|Document Management|Fraud Detection|Privacy,1000000.0,IND,1,1,0,16337,16337,0
Colleges|Education|Employment|Identity|Recruiting,18700000.0,USA,3,2,1026,14245,15271,1
Manufacturing,250000.0,USA,1,1,0,14593,14593,0
E-Commerce,10168600.0,FRA,2,3,426,13981,14407,0
Consulting|Employment|Human Resources|Recruiting|Search|Staffing Firms,620968.0,GBR,1,4,0,14245,14245,0
Analytics|Big Data|Mass Customization|SaaS|Sales and Marketing|Software|Surveys,1400000.0,FRA,2,3,903,15428,16331,0
Education|Health and Wellness,1000000.0,USA,2,1,263,14304,14567,0
Exercise|Fitness|Health and Wellness|Nutrition|Personal Health|Social Network Media,18000000.0,USA,1,2,0,15930,15930,1
Security,3203515.0,USA,3,1,752,15456,16208,0
Consumer Electronics|Security,4107812.0,FRA,1,2,0,15791,15791,0
Curated Web|Real Estate|Social Media,3000000.0,CAN,1,1,0,14098,14098,0
Games,1400000.0,USA,1,1,0,16281,16281,0
Travel,2658000.0,USA,3,4,1310,14685,15995,1
Health and Wellness,743420.0,USA,1,3,0,16521,16521,0
Health and Wellness,10110000.0,USA,3,15,1175,15566,16741,0
Social Media,49000000.0,ISR,5,15,3254,12418,15672,0
Legal,11374792.0,GBR,3,3,1579,13111,14690,0
Browser Extensions|Personalization|Security|Software|Web Design|Web Tools,1094162.0,GBR,7,9,1095,14245,15340,0
Digital Media|Lead Generation|Real Estate,1300000.0,USA,1,2,0,16109,16109,0
Events|Location Based Services|Messaging|Mobile Advertising|Mobile Coupons|Social + Mobile + Local,33333.0,CZE,1,1,0,16589,16589,0
Software,4000000.0,USA,1,2,0,15362,15362,1
Software,153499.0,GBR,1,1,0,15815,15815,0
Internet|Messaging|Networking|Online Identity|Privacy|Search|Social Search,26370000.0,USA,2,1,455,13149,13604,0
Advertising|Social Media Advertising|Twitter Applications|Video Streaming,6230000.0,USA,2,15,231,14712,14943,0
E-Commerce|Food Processing|Local Businesses|Logistics|Mobile|Transportation,1090279.0,DEU,2,1,77,16010,16087,0
Assisitive Technology|Fitness|Health and Wellness,765000.0,USA,2,2,559,15857,16416,0
Pharmaceuticals,1296635.0,GBR,2,2,185,16192,16377,0
Health and Wellness|Health Care|Health Care Information Technology|Personal Health,19615.0,USA,1,1,0,15762,15762,0
Games,430000.0,USA,3,5,365,13467,13832,1
Finance|Financial Services|Information Technology|Software,75000.0,FRA,1,1,0,16290,16290,0
Software,289256.0,ISL,1,1,0,15857,15857,0
Health and Wellness|Health Care Information Technology|Medical,880000.0,ISR,1,7,0,16553,16553,0
Networking|Professional Networking,700000.0,USA,2,1,608,15887,16495,0
Automotive|Cars,250000.0,IND,1,1,0,16756,16756,0
Finance|FinTech,1500000.0,USA,1,1,0,15959,15959,0
Real Estate,20000000.0,USA,2,6,180,13229,13409,1
E-Commerce|Marketplaces|Sports,2240532.0,FIN,4,5,790,15779,16569,0
Education,2365800.0,NLD,2,2,343,13966,14309,0
E-Commerce,500000.0,USA,1,1,0,14718,14718,0
Human Resources|Recruiting,3330100.0,IND,2,6,158,16317,16475,0
E-Commerce,158750000.0,IND,9,29,2587,13514,16101,1
Health Care|Medical|Medical Devices,42750000.0,USA,2,8,203,12570,12773,1
Pharmaceuticals,106400000.0,USA,3,19,731,11562,12293,1
Biotechnology,98000000.0,USA,4,6,952,15603,16555,1
Biotechnology,12616765.0,USA,3,1,1972,14596,16568,0
E-Commerce,314000.0,IND,1,1,0,16638,16638,0
Health Care,21061753.0,CHE,2,6,1442,15160,16602,0
E-Commerce,102232479.0,GBR,5,8,2309,14355,16664,0
Biotechnology,107400000.0,USA,4,9,1889,14071,15960,0
File Sharing|Photo Sharing|Storage|Video|Web Hosting,1000000.0,USA,1,2,0,14092,14092,0
Internet,2483233.0,GBR,2,1,93,16105,16198,0
Advertising Networks|Facebook Applications|Mobile|Recruiting|Search|Social Media,250000.0,IND,1,1,0,15248,15248,0
Cloud Security|Security,2600000.0,ISR,2,4,7,15763,15770,0
Software,8900000.0,USA,1,7,0,13757,13757,1
Events|Software,5798482.0,USA,6,7,2480,13789,16269,0
Biotechnology,9521365.0,USA,2,3,1268,15106,16374,1
Collaborative Consumption|Marketplaces|Travel,1371646.17594753,KOR,4,6,1299,15372,16671,0
Analytics|Big Data|Employment|File Sharing|Human Resources|Mobile Social|Recruiting|Social Media,600000.0,IND,2,1,409,15949,16358,0
Internet|Internet Service Providers,43587872.0,SGP,3,4,492,16211,16703,0
Social Media,1787500.0,USA,1,1,0,15189,15189,0
Software|Television,29500000.0,USA,2,8,1046,11323,12369,0
Online Reservations|Online Travel|Travel & Tourism,889386.0,FRA,1,1,0,16660,16660,0
Social Media,3104264.0,USA,3,1,900,15608,16508,0
E-Commerce|Shopping,28000000.0,USA,4,12,1212,13711,14923,0
Curated Web,1200000.0,CAN,1,3,0,16190,16190,0
Cosmetics,1851937.0,GBR,1,2,0,16490,16490,0
Apps|Electronics|Manufacturing,200000.0,CHN,1,1,0,16689,16689,0
Mobile,3650000.0,ISR,3,4,1091,14853,15944,0
Software,11000000.0,IND,2,4,537,16092,16629,0
Software,575000.0,GBR,1,1,0,14796,14796,0
Social Media|Social Network Media|Web Hosting,37790000.0,USA,1,2,0,12858,12858,1
Databases|Enterprise Software|Lighting|Open Source,40800000.0,USA,4,19,2241,11638,13879,1
E-Commerce,1045040.0,ESP,1,4,0,15635,15635,0
Apps,15000.0,USA,1,1,0,16205,16205,0
Software,40000.0,CHL,1,1,0,15406,15406,0
Education,500000.0,USA,1,3,0,16188,16188,0
Data Centers|Enterprises|Networking|Storage,28000000.0,ISR,1,10,0,11607,11607,0
Classifieds|E-Commerce|Mobile Commerce|Social Buying,1120000.0,USA,3,3,802,13187,13989,0
Diabetes|Gamification|Health and Wellness|mHealth|Mobile,6179354.0,AUT,3,7,1165,15340,16505,0
Curated Web,32800000.0,GBR,10,14,2545,12904,15449,0
Internet|Portals|Social Network Media,95737.0,GBR,2,2,242,15949,16191,0
Accounting|Advertising|Performance Marketing,37000000.0,GBR,5,19,2180,13239,15419,0
E-Commerce|Social Network Media,695149.0,ESP,5,4,1249,14761,16010,0
Advertising|Apps|Curated Web|E-Commerce|iPhone|Local|Mobile,12250000.0,USA,2,20,1085,15461,16546,0
Application Platforms|Social Media,76800.0,USA,1,1,0,16227,16227,0
Customer Support Tools|SaaS|Software|User Experience Design,164000.0,USA,3,2,275,16008,16283,0
Biotechnology|Medical,11610972.0,NLD,3,2,1040,15340,16380,0
Education,550000.0,USA,5,5,745,15069,15814,0
Games,3500000.0,USA,2,2,425,13879,14304,1
Energy Efficiency|Renewable Energies|Wind,130000000.0,GBR,2,2,146,16395,16541,0
E-Commerce|Online Rental|Tracking,17000.0,USA,1,1,0,15584,15584,0
Collaborative Consumption|Marketplaces|Travel|Vacation Rentals,290992.0,ESP,3,3,642,15825,16467,0
Career Management|Curated Web|Finance|Health and Wellness|Internet|Teenagers,400000.0,USA,1,2,0,14820,14820,0
Software,1400000.0,USA,1,11,0,15611,15611,0
Mobile|Video,9040000.0,USA,2,2,298,13192,13490,0
Curated Web,2000000.0,USA,1,1,0,14286,14286,0
Advertising|Groceries|Online Shopping,61000000.0,USA,2,3,1406,14461,15867,0
All Markets|Apps|Curated Web|Internet|Software|Storage|Web Development,470000.0,POL,2,2,730,14610,15340,0
E-Commerce|Mobile|Social Media,880000.0,RUS,2,2,414,15645,16059,0
Advertising Networks|All Students|Contests|Entertainment Industry|Fashion|Media|Mobile Advertising|Music|Restaurants|SEO|Social Media|Travel & Tourism|Weddings,13000.0,USA,1,2,0,16469,16469,0
Curated Web|Security,1300000.0,FIN,2,6,1381,14290,15671,0
Mobile|Music|Video Streaming,6500000.0,USA,1,3,0,13781,13781,0
Apps|Games|Social Media,17100000.0,USA,2,5,547,13542,14089,1
Credit Cards|Curated Web|Discounts|E-Commerce,95000.0,USA,2,3,354,15719,16073,0
Communities|Social Business|Social Media|Social Media Management,37501105.0,USA,2,7,569,13941,14510,0
Apps|Mobile,40000.0,USA,1,1,0,16033,16033,0
Security,3850000.0,CAN,1,2,0,15545,15545,0
Mobile|Services|Startups,1398947.0,CHE,2,1,245,16436,16681,0
Software,2500000.0,CAN,1,1,0,13836,13836,0
Biotechnology,2448955.0,USA,2,1,595,15460,16055,0
Software,1200000.0,USA,2,1,736,15581,16317,0
Software,378000.0,USA,1,1,0,13318,13318,0
Software,5600000.0,USA,1,2,0,16469,16469,0
Embedded Hardware and Software|Hardware + Software,159968498.0,ISR,10,43,3014,13361,16375,1
Cable|Entertainment,7000000.0,USA,1,1,0,11474,11474,1
E-Commerce,30000000.0,USA,1,2,0,13881,13881,0
Information Technology,35000000.0,USA,1,1,0,16741,16741,0
Biotechnology|Pharmaceuticals,40000000.0,USA,2,8,1591,14802,16393,1
Mobile Games,12000000.0,USA,1,3,0,15861,15861,0
iPad|Mobile|Tablets,25000.0,USA,1,1,0,15232,15232,0
E-Commerce,106200000.0,IND,4,13,1924,14839,16763,0
E-Commerce,22071177.0,USA,3,1,1001,14110,15111,0
Games,400000.0,USA,2,3,336,15490,15826,0
Biotechnology,120000000.0,AUT,1,8,0,16532,16532,1
Biotechnology,84299975.0,USA,6,8,2039,14271,16310,0
Technology,889590.0,LVA,4,4,1652,14839,16491,0
Mobile,2065000.0,JPN,3,3,1165,15040,16205,0
Education,1330000.0,USA,3,2,916,15257,16173,0
Beauty|Fashion|Technology,300000.0,USA,1,1,0,16071,16071,0
Curated Web,10000000.0,GBR,1,1,0,15939,15939,0
Web Hosting,10000000.0,CAN,1,4,0,12892,12892,0
E-Commerce,5000000.0,CHN,1,1,0,14944,14944,0
E-Commerce|Fashion,19000.0,USA,1,1,0,15449,15449,0
Hardware + Software,15399186.0,GBR,4,7,2237,11292,13529,0
Artificial Intelligence|Games,815000.0,USA,1,2,0,16087,16087,0
Internet,1000000.0,USA,2,1,247,16375,16622,0
Employer Benefits Programs|Enterprise Software|Human Resources|Startups,77800000.0,USA,7,43,1265,15339,16604,0
Mobile,1875000.0,USA,1,14,0,15765,15765,1
Business Services|E-Commerce|Internet|Services,2000000.0,IND,2,4,0,16758,16758,0
Computers|Security,5000000.0,ISR,1,4,0,16488,16488,0
E-Commerce,33000000.0,ARE,2,3,223,15615,15838,0
Curated Web,290000.0,JPN,1,2,0,16048,16048,0
Semiconductors,14109347.0,DEU,3,11,1221,13486,14707,1
Biotechnology,2254102.0,GBR,2,3,3168,13203,16371,0
Semiconductors,35000000.0,USA,3,5,797,13243,14040,0
Advertising|Advertising Platforms|Analytics|Mobile Advertising|Predictive Analytics|SaaS|Social Media Marketing,32850000.0,USA,3,5,1324,15195,16519,0
E-Commerce,1633097.0,CHN,1,1,0,15979,15979,0
Software,25783619.0,CHN,1,1,0,15006,15006,0
Analytics,164473.0,CHN,1,1,0,16054,16054,0
Child Care,276938.0,GRC,2,2,273,16231,16504,0
Health Care|Medical|Nanotechnology,681663.0,BRA,1,1,0,11443,11443,0
Printing,13100000.0,ISR,2,1,156,16587,16743,1
Hardware + Software,963000.0,GBR,1,2,0,14579,14579,0
Software,6000000.0,USA,1,2,0,13422,13422,0
Technology,3700000.0,AUS,1,3,0,16612,16612,0
Biotechnology,26438098.0,USA,4,1,1409,14957,16366,0
Consumer Electronics,224811.0,LTU,1,1,0,16568,16568,0
Biotechnology,69000000.0,USA,4,3,2230,13442,15672,0
Biotechnology|Medical,1000000.0,GBR,1,2,0,13703,13703,0
Biotechnology,14602480.0,FRA,2,6,1156,14734,15890,0
Biotechnology,124592500.036124,JPN,2,2,1331,15365,16696,1
Hardware|Semiconductors,48800000.0,USA,3,12,1415,12485,13900,0
Nanotechnology,1890000.0,DEU,1,2,0,13327,13327,0
Biotechnology,6250000.0,USA,1,1,0,13766,13766,0
Nanotechnology,2070000.0,SWE,1,2,0,14197,14197,0
Biotechnology,1500000.0,USA,2,1,598,15453,16051,0
Nanotechnology,54700000.0,USA,3,21,1470,13166,14636,1
Nanotechnology,9200000.0,USA,1,6,0,12090,12090,1
Nanotechnology,95500000.0,USA,3,10,1796,13664,15460,1
Biotechnology,8801767.0,USA,2,2,945,14034,14979,0
Biotechnology,100000000.0,USA,2,1,1386,13959,15345,0
Manufacturing,849689.0,FRA,1,2,0,16435,16435,0
3D Technology|Biotechnology|Software,3049871.0,CHE,1,1,0,16161,16161,0
Nanotechnology,3200000.0,USA,1,3,0,14196,14196,0
Nanotechnology,22639501.0,USA,3,3,1056,15274,16330,0
Biotechnology|Health Diagnostics|Medical Devices,1900000.0,USA,2,2,174,16547,16721,0
Diagnostics,33000000.0,USA,3,9,3642,12458,16100,0
Biotechnology,25523512.0,USA,5,7,2002,14057,16059,0
Electronics,14000000.0,USA,1,6,0,12363,12363,0
Nanotechnology,2570000.0,DNK,1,2,0,13385,13385,0
Development Platforms|Mobile Games,150000.0,KOR,1,1,0,16386,16386,0
Art|Career Management|Collaboration|Curated Web|Education|Entertainment|File Sharing|High Schools|Kids|Life Sciences|Parenting|Social Media|Teachers,150000.0,USA,2,2,155,15492,15647,0
Nanotechnology,24000000.0,USA,3,17,1013,12305,13318,0
Material Science|Startups|Technology,68777.0,LVA,1,1,0,16056,16056,0
Nanotechnology,1100000.0,USA,1,4,0,14207,14207,0
E-Commerce|Information Security|Loyalty Programs|Mobile Payments|Payments|Point of Sale|Retail|Transaction Processing,339805.0,CAN,1,1,0,15983,15983,0
Advanced Materials|Medical Devices|Nanotechnology,50000.0,USA,1,2,0,15584,15584,0
Health Care,4500000.0,CHE,1,3,0,14761,14761,0
Manufacturing|Nanotechnology|Technology,30000.0,CAN,1,1,0,16495,16495,0
Nanotechnology,2600000.0,USA,2,3,731,15126,15857,0
Semiconductors,91004842.05875859,SWE,6,31,1864,12928,14792,0
Biotechnology,1238277.0,USA,2,1,883,15695,16578,0
Aerospace|Robotics|Software,69500000.0,USA,6,18,1081,15535,16616,0
Nanotechnology,1491477.0,GBR,1,2,0,14184,14184,0
Clean Technology|Nanotechnology,540000000.0,USA,7,37,3265,12227,15492,0
Biotechnology|Health Care,39270000.0,USA,3,3,4526,12058,16584,1
Manufacturing,640181.0,USA,3,1,959,13588,14547,0
Browser Extensions|Nanotechnology,35000000.0,USA,3,5,1081,14477,15558,0
Nanotechnology,13050000.0,USA,3,8,1343,12593,13936,0
Health Care,38000903.0,USA,5,6,819,15009,15828,0
Medical Devices,22000000.0,USA,2,7,797,11410,12207,0
Biotechnology|Diagnostics|Health Diagnostics|Medical,110250000.0,USA,9,26,2938,12900,15838,1
Nanotechnology,144273501.0,USA,9,34,4422,12166,16588,0
Semiconductors,13500000.0,GBR,3,6,1175,12928,14103,0
Nanotechnology,6820000.0,GBR,1,4,0,12907,12907,0
Nanotechnology,3453953.0,GBR,1,2,0,15572,15572,0
Nanotechnology|New Product Development|Textiles,35000000.0,USA,1,5,0,12850,12850,1
Biotechnology|Manufacturing|Pharmaceuticals,66500000.0,USA,3,2,288,16224,16512,0
Biotechnology,1742189.0,GBR,2,3,874,14006,14880,0
Software,16338400.0,USA,2,1,477,16054,16531,0
Nanotechnology,3120000.0,USA,1,1,0,13848,13848,0
Health Care,4700000.0,USA,1,2,0,13969,13969,0
Health Care,4195228.0,DNK,4,3,640,15702,16342,0
Biotechnology,46000000.0,USA,6,2,1139,15182,16321,1
Biotechnology|Health Diagnostics,1500000.0,USA,1,2,0,16445,16445,0
Early-Stage Technology|Medical Devices,1500000.0,USA,1,2,0,16323,16323,0
Chemicals|Manufacturing|Services,3000000.0,CAN,1,3,0,12261,12261,0
Hardware|Nanotechnology|Semiconductors,82392020.0,USA,6,29,5062,11596,16658,0
Health and Wellness|Health Diagnostics,680000000.0,USA,5,6,979,15638,16617,0
Software,110000000.0,USA,4,1,758,15616,16374,0
Semiconductors,140000000.0,USA,2,1,662,15546,16208,0
Design,170000.0,FRA,1,1,0,15908,15908,0
Local|Q&A|Social Media,113000.0,USA,1,5,0,15949,15949,0
Hardware + Software,15034262.0,USA,3,7,995,12585,13580,0
Networking|Network Security|SaaS|Security,6600000.0,USA,2,1,277,14212,14489,1
Music|Video,250000.0,CAN,1,1,0,15187,15187,0
Artificial Intelligence|Big Data|Neuroscience|PaaS|Personalization|Reviews and Recommendations,13000000.0,USA,1,2,0,16358,16358,0
Business Services|Cable|Software,26250000.0,USA,2,14,1559,12006,13565,0
Digital Media|Mobile|Video,1320000.0,USA,2,20,185,16251,16436,0
Apps|Games|Mobile,9000000.0,RUS,2,2,153,15584,15737,0
Audio|K-12 Education|Photo Sharing,165000.0,USA,1,3,0,15360,15360,0
Chat|Real Time|Search|Social Media|Social Media Monitoring|Twitter Applications,794109.0,AUS,1,1,0,15912,15912,0
Artificial Intelligence|Big Data|Big Data Analytics,32400000.0,USA,6,10,1681,14721,16402,0
Health and Wellness|Health Care Information Technology|Natural Language Processing,2218000.0,USA,4,5,406,16239,16645,0
Analytics|Data Visualization|Predictive Analytics,1225000.0,USA,2,2,261,16287,16548,0
Cloud Computing|Curated Web|Mobile,226252.0,GBR,3,2,304,15706,16010,0
Software,50000.0,USA,1,1,0,16495,16495,0
Security,38700000.0,USA,2,8,993,13452,14445,1
Facebook Applications|Games|Social Games|Startups,3100000.0,USA,2,3,1571,14921,16492,0
E-Commerce|Enterprise Software|Retail|SaaS|Shipping|Supply Chain Management|Transportation,12000000.0,USA,2,10,452,16222,16674,0
Software,8332219.0,USA,2,1,441,16262,16703,0
Mobile,1500000.0,USA,1,1,0,13440,13440,0
Video,564971.0,TUR,1,1,0,15735,15735,0
Software,13400000.0,USA,2,6,453,13315,13768,0
Curated Web,8500000.0,PAK,4,7,4189,12387,16576,0
Application Platforms|Recruiting|Training,4000000.0,CHN,1,3,0,16478,16478,0
Biotechnology,22500000.0,USA,2,6,724,15821,16545,0
Health Care,2341899.0,USA,3,1,659,15753,16412,0
E-Commerce|Fashion|Retail,65000000.0,USA,3,4,1088,15404,16492,0
Cloud Data Services|Enterprise Software,53000000.0,USA,4,11,1701,14592,16293,0
Social Media,55630000.0,POL,2,2,365,13514,13879,0
Oil and Gas,15000000.0,USA,1,1,0,12128,12128,0
Biotechnology|Health Diagnostics,154100000.0,USA,7,23,2313,14218,16531,1
Billing|Investment Management|Payments,1000000.0,USA,1,1,0,14776,14776,0
Business Services|Financial Services,105000000.0,USA,2,1,721,16000,16721,0
Medical|Services|Software,3000000.0,USA,1,2,0,13123,13123,1
Finance,4930000.0,USA,2,4,477,13768,14245,0
Medical Professionals,128000000.0,USA,1,1,0,13634,13634,1
Enterprises|Enterprise Software|Facebook Applications|Networking|Social Media|Twitter Applications|Web Development|Web Tools,1500000.0,USA,1,2,0,15643,15643,1
Health and Wellness,1000000.0,IND,1,1,0,15973,15973,0
Apps|Curated Web|Local Based Services|Mobile,118000.0,USA,1,1,0,16265,16265,0
Networking,11500000.0,GBR,1,8,0,12251,12251,0
Apps,100000.0,USA,1,1,0,16375,16375,0
Advertising|Advertising Platforms|Internet Marketing,2150000.0,USA,2,10,481,15945,16426,0
Clean Technology,28700000.0,CAN,3,7,3221,13052,16273,0
Clean Technology,1900000.0,USA,1,1,0,14118,14118,0
Software,19114247.0,CAN,2,13,837,12636,13473,1
Dental|Health Care|Medical,12643989.0,USA,2,4,979,13469,14448,0
Games|Graphics,11000000.0,GBR,3,3,4158,11354,15512,1
Advertising|Green|Media,250000.0,USA,1,2,0,13483,13483,1
Environmental Innovation|Services|Technology,4000000.0,USA,1,3,0,13209,13209,1
E-Commerce|Retail,58500000.0,USA,4,16,874,15686,16560,0
Education,4000000.0,USA,1,1,0,14978,14978,0
Health and Wellness,1469331.0,FIN,1,3,0,16301,16301,0
Education|Teachers|Training,6597.0,BGR,1,1,0,15706,15706,0
Biotechnology,162106599.0,USA,5,13,1398,15009,16407,1
Leisure|Service Providers|Travel & Tourism|Vacation Rentals,250611.0,ESP,1,2,0,16107,16107,0
Biotechnology,20829400.0,FRA,2,9,788,12845,13633,0
Biotechnology,25755532.0,USA,2,1,0,14711,14711,0
Clean Technology,89000000.0,USA,2,2,2554,13890,16444,0
Curated Web,109361.0,ESP,1,3,0,15942,15942,0
E-Commerce|Fashion|Retail|Textiles,45431351.0,DEU,4,9,1634,14822,16456,0
Software,1000000.0,CAN,1,1,0,13999,13999,0
Cars|Displays|Mobile Commerce,26500000.0,USA,2,17,197,16344,16541,0
Location Based Services|Service Providers|Transportation,132694.0,FRA,1,1,0,15916,15916,0
Employment|Real Estate|Search,50000000.0,ARG,2,3,640,15657,16297,0
Consulting,13500000.0,USA,5,7,1266,15098,16364,0
Public Transportation,14000000.0,USA,2,4,414,13937,14351,1
Clean Technology,5790000.0,GBR,1,3,0,14767,14767,0
Advertising,42000000.0,USA,3,8,378,11001,11379,1
Biotechnology|Health Diagnostics,92500000.0,USA,3,2,475,16091,16566,1
Public Transportation|Transportation,32290000.0,CHN,3,5,1035,14396,15431,0
Mobile,155000.0,POL,1,1,0,13448,13448,0
Manufacturing,46000000.0,IDN,2,3,147,16048,16195,0
Health and Wellness|SaaS,15250000.0,USA,3,4,1393,15274,16667,0
Biotechnology,43000000.0,USA,2,7,820,13824,14644,1
Health and Wellness,4099999.0,USA,2,5,37,15820,15857,1
Health and Wellness|Health Care|Health Care Information Technology,27000000.0,USA,1,7,0,11542,11542,0
Web Hosting,80920000.0,USA,3,9,651,13005,13656,1
Biotechnology,19330001.0,USA,4,4,2057,13636,15693,0
Hardware + Software,1151108.0,CHE,1,2,0,16059,16059,0
Energy|Natural Resources|Oil & Gas,500000000.0,USA,1,1,0,16226,16226,0
Biotechnology,23500000.0,USA,1,4,0,16240,16240,0
Automotive|Maps|Mobile|Navigation,4241446.0,USA,2,6,1080,14457,15537,0
Automotive|Gps|Location Based Services|Mobile|Navigation,4068970.0,FRA,2,1,365,13147,13512,0
Health Care|Technology,100000.0,IND,1,1,0,16569,16569,0
Educational Games|Games|K-12 Education|Kinect|PC Gaming|Skill Gaming|Virtual Worlds,320000.0,IND,1,1,0,16538,16538,0
Android|Navigation|Travel|Web Development,27034.0,DEU,1,1,0,15979,15979,0
Digital Media|SaaS|Social Media,120000.0,USA,2,7,96,16267,16363,0
Analytics|Databases,100000.0,BRA,1,2,0,16102,16102,0
Mobile,9301500.0,IND,3,2,2962,13075,16037,0
Educational Games|Social Games|Sports,50000.0,USA,2,2,920,15636,16556,0
Finance|FinTech|Nanotechnology,7408000.0,USA,4,7,721,15575,16296,0
Biotechnology|Medical|Therapeutics,3097541.0,CHE,1,1,0,16518,16518,0
News,18000000.0,NZL,2,2,30,14811,14841,0
Data Integration|E-Commerce,5022837.0,USA,4,5,1445,15156,16601,0
Enterprise Software|Finance,49000002.0,USA,4,14,756,15734,16490,0
Security,52300999.0,USA,5,22,3400,11565,14965,1
Consulting|Education|Games,38924.0,USA,1,1,0,16436,16436,0
Software,57800000.0,USA,3,8,2010,13439,15449,0
Health Care,51954587.0,USA,6,3,2044,14343,16387,1
Advertising,7100000.0,USA,2,6,732,15095,15827,0
Collaboration|Enterprise Software|Privacy|Security,9250000.0,USA,3,5,836,15534,16370,0
Hardware + Software,1270324.0,GBR,1,1,0,15656,15656,0
Analytics|Energy Management|Home Automation,3826452.0,GBR,1,1,0,16556,16556,0
Games|Virtual Worlds,3164683.0,GBR,2,1,287,16167,16454,0
Clean Technology|Energy Efficiency|Manufacturing|Renewable Energies|Sustainability,1400000.0,USA,2,1,1720,14975,16695,0
Consumer Internet|Marketplaces,290000.0,IND,1,4,0,16441,16441,0
Software,17000000.0,USA,1,1,0,15510,15510,0
Local|Location Based Services|Mobile|Social Network Media,25000.0,POL,1,1,0,15746,15746,0
Analytics|Retail,3282327.0,USA,3,6,491,15176,15667,1
Design|E-Commerce|Fashion|Marketplaces,1125000.0,TUR,2,2,231,15706,15937,0
Curated Web,19250000.0,USA,3,7,1031,13319,14350,1
Mobile,1000000.0,USA,2,2,132,14568,14700,0
Advertising|Analytics|Location Based Services|Media|Mobile Analytics|Technology,25500000.0,SGP,2,7,686,15672,16358,0
Biometrics|Sensors,1996837.0,GBR,3,4,471,15784,16255,0
Events|Local Search,300000.0,IND,1,3,0,16327,16327,0
Software,35000000.0,USA,2,6,536,11799,12335,1
SaaS|Telecommunications|Wireless,65000.0,CHL,2,2,92,16130,16222,0
Hardware + Software,43843083.0,USA,4,2,1076,14854,15930,0
Software,250000.0,RUS,2,3,305,15340,15645,0
E-Commerce|Fashion|Jewelry,2000000.0,RUS,2,1,18,16036,16054,0
Biotechnology,300000.0,BEL,1,1,0,12870,12870,0
Advertising,30150000.0,USA,2,3,62,13695,13757,0
Cloud Computing|Enterprise Software|Hardware,38500000.0,USA,4,11,1078,15095,16173,0
Cloud Data Services|Data Integration|SaaS,253000.0,USA,3,1,548,16161,16709,0
Collaboration|Music|Music Services|SaaS,25000.0,USA,2,2,205,16222,16427,0
Content Discovery|Curated Web|News,140449.0,TUR,1,1,0,15559,15559,0
E-Commerce|Fashion|Lifestyle|Mobile|Technology,615000.0,USA,2,11,345,15873,16218,0
Advertising|Charity|Curated Web|Sales and Marketing|Services|Social Media,100000.0,NOR,1,4,0,15807,15807,0
B2B|E-Commerce,10000.0,CHL,1,1,0,15896,15896,0
Internet|Reviews and Recommendations|Social Media,350000.0,USA,1,1,0,15431,15431,0
Enterprise Software|Local|Search|Social Media,1000000.0,CAN,1,1,0,13757,13757,0
Chat|Crowdsourcing|E-Commerce|Mobile Commerce|Social Commerce|Software,19500003.0,USA,3,4,1204,15009,16213,0
Creative|Curated Web|Human Resources|Recruiting|SaaS,80000.0,CAN,1,1,0,15826,15826,0
Advertising,987500.0,USA,1,1,0,15938,15938,0
Creative Industries|Freelancers|Recruiting,50000.0,USA,1,1,0,15989,15989,0
Credit|Financial Services|FinTech,10000000.0,USA,1,3,0,16688,16688,0
Semiconductors,36000000.0,USA,1,7,0,13268,13268,0
Legal|Real Estate|Services,13058.0,SVK,1,1,0,15468,15468,0
Finance|FinTech|Governments|Software,5675000.0,USA,2,7,819,15874,16693,0
Biotechnology,3298998.0,USA,3,2,420,15345,15765,0
Business Analytics|Social Media|Social Media Platforms|Social Network Media|Sustainability,1557308.0,GBR,2,1,873,15765,16638,0
Apps|Real Estate,20000.0,USA,1,1,0,16293,16293,0
Biotechnology,25000000.0,USA,1,1,0,15945,15945,1
Hardware + Software,1719000.0,FRA,2,6,700,14011,14711,0
Health Care,6500000.0,USA,1,2,0,13953,13953,1
Biotechnology,1500000.0,USA,1,2,0,14034,14034,0
Curated Web,5300000.0,USA,1,1,0,12916,12916,0
Health and Wellness|Software,2250070.0,SWE,2,4,150,14418,14568,0
Gps|Semiconductors,60388934.0,CHE,3,13,1340,12433,13773,0
Design|Digital Media|Displays|Manufacturing,13960000.0,FRA,1,9,0,13285,13285,0
Pharmaceuticals,6180089.0,USA,4,1,304,16363,16667,1
E-Commerce,10000000.0,CHN,1,1,0,16161,16161,0
Education|SaaS,35000.0,IND,2,1,662,15501,16163,0
Analytics|Big Data|Databases|Enterprise Software|Software,44100000.0,USA,4,13,1905,14545,16450,0
Biotechnology|Health Diagnostics,3025713.0,USA,2,2,317,16173,16490,0
Software,16500000.0,USA,2,3,773,13444,14217,0
Biotechnology,31433055.0,USA,4,7,2184,14411,16595,0
Health Care|Medical Devices|Robotics,2423000.0,USA,2,1,689,15614,16303,0
Enterprise Software,22478077.0,USA,3,4,935,13629,14564,0
Clinical Trials|Medical,933360.0,AUS,2,2,210,16287,16497,0
Health Care|Technology,785000.0,ESP,1,1,0,13237,13237,0
Electronics|Innovation Engineering|Manufacturing,56831957.0,USA,6,12,2816,13149,15965,0
Software,2260000.0,FRA,1,2,0,14580,14580,0
Music,5500000.0,ISR,1,2,0,13221,13221,0
Advertising,3293750.0,ITA,1,1,0,15371,15371,0
Biotechnology,6764177.0,USA,2,1,780,14046,14826,0
Advertising,10000000.0,CAN,3,5,1291,13672,14963,1
Health Care,34299994.0,USA,5,1,1633,14634,16267,0
Finance,8620000.0,IND,2,6,496,16155,16651,0
Biotechnology,39000000.0,USA,2,11,1046,12374,13420,1
Artificial Intelligence|Computer Vision|Cyber Security|Machine Learning,1100000.0,USA,2,3,341,16283,16624,0
Software,41874460.803319894,FRA,4,8,3526,11822,15348,1
App Marketing|Mobile,11365000.0,USA,2,2,125,14756,14881,0
Biotechnology,61702727.0,USA,5,7,1481,13708,15189,1
Mobile Commerce|Mobile Payments,13500000.0,ITA,2,3,338,14166,14504,0
Curated Web,4724999.0,USA,2,7,468,15798,16266,0
Advertising|Marketing Automation|Mobile|Social + Mobile + Local,220000.0,USA,2,1,350,15972,16322,0
Health Care|Medical|Therapeutics,55000000.0,USA,1,3,0,16709,16709,0
Cable|CRM|Customer Service|Internet|Internet Service Providers|Telecommunications|Web Hosting|Wireless,2000000.0,USA,1,2,0,14505,14505,0
Nanotechnology|New Product Development|Services,14000000.0,USA,1,4,0,14057,14057,0
Enterprise Software,29000000.0,USA,3,12,805,12485,13290,1
Semiconductors|Web Hosting,194673840.0,USA,6,23,2972,12495,15467,1
Curated Web,3170000.0,USA,1,2,0,13692,13692,0
Advertising Platforms|Marketing Automation|SaaS|Social Media Marketing,1800000.0,USA,2,9,290,16019,16309,0
Curated Web,7700000.0,JPN,1,1,0,14474,14474,0
3D Technology|Energy|Natural Resources|Oil|Predictive Analytics,60000000.0,USA,1,4,0,14992,14992,0
Biotechnology,96278860.0,USA,6,5,1913,14572,16485,1
Banking|Curated Web,16437900.0,USA,6,8,1363,13601,14964,0
Security,24000000.0,USA,2,5,695,12163,12858,0
Biotechnology,49000000.0,USA,2,1,1862,14347,16209,1
Software,20100000.0,USA,2,2,2026,14302,16328,0
Medical,13100000.0,USA,1,6,0,12159,12159,0
Health Care,125964844.0,USA,4,6,2861,13237,16098,0
Trading,227000.0,IND,1,1,0,16699,16699,0
Biotechnology,26212042.0,FRA,2,2,2904,13711,16615,0
Data Visualization,7000000.0,USA,1,4,0,11372,11372,1
Health Care,130003458.0,USA,7,23,2065,13409,15474,0
Business Services|Cloud Computing|Information Services,1222384.0,FIN,1,2,0,12676,12676,0
Environmental Innovation,1074925.0,SWE,2,2,480,15575,16055,0
Software,809000.0,DNK,1,1,0,13165,13165,0
Health Care|Medical Devices,2800000.0,ISR,1,3,0,14839,14839,0
Cloud Data Services|Enterprise Software|Licensing|Networking|Software|Web Hosting,1000000.0,USA,1,1,0,15906,15906,0
Enterprise Software|Health Care|Health Care Information Technology|Medical,20000.0,USA,1,1,0,15340,15340,0
Biotechnology|Health Care,21800000.0,USA,4,3,3052,13700,16752,1
Health and Wellness,14000000.0,IND,2,3,1159,14975,16134,0
Charter Schools|EdTech|Education|K-12 Education|Teachers|Technology,1000000.0,USA,2,5,154,16196,16350,0
Games,470000.0,KOR,1,1,0,15667,15667,0
Cloud Computing|Cloud Infrastructure|Enterprise Software|IT Management|SaaS,120000.0,USA,2,13,118,16267,16385,0
Defense|Mobile Devices|Software,100000.0,USA,1,1,0,14822,14822,0
Apps|Mobile,35000.0,MYS,1,1,0,15034,15034,0
Consumers|Credit Cards|Curated Web|Incentives|Personal Finance|Search,102000000.0,USA,3,6,163,16566,16729,0
Biotechnology,107600000.0,USA,3,32,1710,13075,14785,0
Biotechnology,45000000.0,USA,1,1,0,15272,15272,0
Computers,24400000.0,USA,3,25,413,16177,16590,0
Enterprise Software,866000.0,FIN,1,2,0,14714,14714,1
Analytics|Brand Marketing|Machine Learning|Social Search|Video|Visual Search,5300000.0,USA,3,2,790,15573,16363,0
Fashion,3715648.0,USA,1,1,0,16533,16533,0
Apps|App Stores|iPhone|Restaurants|Search,20000000.0,USA,2,8,399,15174,15573,1
Technology,15000000.0,KOR,1,4,0,11515,11515,0
Real Estate,13200000.0,IND,2,4,127,16510,16637,0
Software,22250000.0,IND,1,1,0,13149,13149,0
Home Automation,80000000.0,USA,3,11,862,14873,15735,1
Financial Services,1500000.0,CAN,1,1,0,16652,16652,0
3D Printing|Bio-Pharm|Biotechnology,16227.0,NLD,1,1,0,16525,16525,0
Real Estate,3000000.0,USA,1,1,0,16551,16551,0
Online Rental|Real Estate|Rental Housing,11000000.0,DEU,3,6,621,16120,16741,1
Messaging,10000000.0,CHN,1,1,0,12784,12784,0
E-Commerce|Mobile Commerce|Mobile Payments|Payments|Technology,156400000.0,USA,11,9,1097,15459,16556,1
Enterprise Software,15790000.0,ESP,2,3,466,12790,13256,0
Software,12420000.0,SWE,2,3,693,13411,14104,0
Agriculture|Clean Technology,500000000.0,ISR,1,5,0,16500,16500,0
Curated Web,2230000.0,FRA,1,1,0,14873,14873,0
Information Security|Security|Services,14795722.0,FRA,4,9,1827,10957,12784,1
Hardware|Mobile,38556054.0513776,FRA,2,7,882,15862,16744,0
Analytics|Enterprise Search|Semantic Search|Social Media,84600000.0,USA,8,26,3619,12935,16554,0
Home Automation|Internet of Things|Telecommunications,140000.0,DEU,2,2,178,16501,16679,0
Software,125000.0,USA,4,3,833,15796,16629,0
Enterprise Software,227171.0,GBR,1,1,0,16457,16457,0
Mobile|Web Design|Web Development,27000000.0,DEU,3,7,2115,13514,15629,0
Internet|Internet Service Providers|Wireless,975000.0,USA,2,2,154,16534,16688,0
Curated Web,16356028.0,USA,4,2,1700,13761,15461,0
Internet Service Providers|Security|Services,7000000.0,USA,1,1,0,12191,12191,0
Software,30000000.0,USA,1,1,0,16176,16176,0
Software,956000.0,DEU,1,2,0,13335,13335,0
Semiconductors,13700000.0,USA,1,4,0,12556,12556,0
Enterprise Software,6500000.0,USA,1,1,0,15828,15828,1
Broadcasting|Internet|Real Time|SaaS,141699.0,FRA,1,1,0,15065,15065,0
Enterprise Software,41000000.0,USA,2,9,1609,11464,13073,1
Information Technology|Networking|Software,13000000.0,USA,2,3,398,12962,13360,1
Software,25000000.0,USA,1,5,0,13011,13011,1
Cloud Data Services,25000000.0,USA,1,1,0,16266,16266,0
Education|Internet|Mobile|Software,52500000.0,CHN,1,2,0,16441,16441,0
Semiconductors|Web Hosting,103030000.0,USA,5,32,2471,11170,13641,1
Hardware + Software,57680000.0,USA,4,11,1967,12062,14029,1
Brand Marketing|Business Services|Networking|Sales and Marketing|Software,2260020.0,ESP,2,2,236,13586,13822,0
Analytics|Big Data|Databases|Enterprise Software|Storage,40000000.0,USA,2,8,504,11757,12261,1
Software,845000.0,FRA,1,1,0,12975,12975,0
Consumer Electronics|Entertainment|Games|Video,1730000000.0,USA,3,1,5689,10779,16468,1
Design|Enterprise Software|Software,12000000.0,USA,1,2,0,14592,14592,0
Digital Media|Facebook Applications|Games|Social Games|Social Network Media,132885.0,USA,3,2,260,15262,15522,0
Hardware + Software|Telecommunications,98000000.0,USA,1,3,0,12265,12265,1
Construction|Industrial|Software,33000.0,USA,1,1,0,15522,15522,0
Optimization|SEO|Services,4000000.0,USA,1,1,0,14106,14106,0
Security,5249215.0,CHE,1,2,0,16367,16367,0
Software,352000.0,FRA,1,2,0,13692,13692,0
Semiconductors,14000000.0,USA,1,5,0,13455,13455,0
Analytics|Business Intelligence|Enterprise Software|Sales and Marketing|Semantic Web,451422.0,COL,4,5,458,15248,15706,0
Communications Hardware|Data Security|Service Providers,55000000.0,USA,1,6,0,12851,12851,0
IT Management|Software,7400000.0,USA,1,3,0,13116,13116,1
Computers|Security|Software,12500000.0,USA,2,12,1247,11372,12619,1
Cloud Computing|Internet|Legal|Mobile|SaaS|Software,451804.0,ITA,2,6,301,15859,16160,0
Web Hosting,18000000.0,USA,1,7,0,13192,13192,1
Mobile|Payments|Public Transportation,443539.0,CAN,4,3,769,15706,16475,0
Semiconductors,16648351.0,USA,2,1,15,15904,15919,1
Curated Web|Social Media,6671232.75486333,BEL,1,3,0,13604,13604,0
Hardware|Semiconductors,32000000.0,USA,1,1,0,11961,11961,1
Web Hosting,2710000.0,FRA,1,1,0,14776,14776,0
Web Hosting,36000000.0,IND,2,4,968,13921,14889,1
Software,2700000.0,USA,1,1,0,13681,13681,1
Health Care|Medical|Service Providers,237912.0,FIN,1,1,0,15949,15949,0
Recruiting|Sales and Marketing|Trusted Networks,150000.0,USA,1,1,0,16155,16155,0
Aquaculture|Services,150000.0,USA,1,1,0,16421,16421,0
Advertising,323025.0,USA,1,1,0,13542,13542,0
Mobile|Trusted Networks|Wireless,10800000.0,USA,1,4,0,12041,12041,1
Analytics,40000.0,CHL,1,1,0,15539,15539,0
Online Education,2700000.0,RUS,2,3,296,16175,16471,0
E-Commerce|Incentives|Retail Technology|SaaS,15200000.0,USA,3,1,689,15908,16597,0
Curated Web,1900000.0,USA,1,9,0,15463,15463,0
Analytics|B2B|Contact Management|Lead Generation,27500000.0,USA,7,9,2776,13392,16168,1
Fitness|Health and Wellness|Mobile|SaaS,39300000.0,USA,4,12,1799,14543,16342,0
Networking|Software,5000000.0,USA,1,1,0,12192,12192,1
Software,381000.0,DEU,1,1,0,13330,13330,0
Software,40000000.0,USA,2,7,453,11984,12437,1
Cloud Data Services|Data Centers|Flash Storage|Services|Web Hosting,400000.0,USA,3,1,2028,13938,15966,0
Finance,56428000.0,NLD,2,4,986,13882,14868,1
Semiconductors,73197633.0,USA,4,14,2348,13465,15813,0
Security,13000000.0,USA,6,11,1918,10560,12478,1
Security,30000000.0,USA,1,4,0,11600,11600,1
Advertising,14400000.0,USA,2,3,692,14252,14944,0
Advertising|Internet|Internet Marketing|Local|Local Businesses|Sales and Marketing|Search|Small and Medium Businesses|Technology,51489170.0,USA,7,15,1759,14956,16715,0
E-Commerce|Fashion|Shopping|Sporting Goods,214999816.0,BRA,2,5,331,16196,16527,0
Curated Web|Music|Video Streaming,152102.0,BRA,3,3,397,16190,16587,0
Cloud Security|Data Security|Information Security|Software,131400000.0,USA,4,10,975,15706,16681,0
Enterprise Software,4500000.0,USA,1,3,0,13045,13045,0
Cloud Management|Networking|Virtualization,21657412.0,USA,4,5,1409,14566,15975,0
Software,794000.0,PRT,1,1,0,14013,14013,0
Enterprise Software|Internet|Software|Web Tools,2000000.0,USA,2,1,1191,13879,15070,0
Mobile,5330000.0,USA,3,3,1149,11390,12539,0
Games,20950000.0,USA,3,2,1841,12418,14259,1
Hardware + Software,9250000.0,USA,5,1,2056,14274,16330,0
Android|Curated Web|Entertainment|Film|Internet|iPad|iPhone|Local|Mobile|Social Media|Software,500000.0,USA,1,3,0,15197,15197,0
Music,10250000.0,CAN,1,6,0,15825,15825,0
Software,29500000.0,USA,4,18,3422,12921,16343,0
Social Media|Web Design|Web Development,16000000.0,FRA,2,7,153,13208,13361,1
Software,23980000.0,DEU,3,5,1232,12947,14179,1
Software,5689647.0,USA,1,1,0,14623,14623,1
Technology,3000000.0,USA,1,4,0,10948,10948,1
Software,6000000.0,USA,1,2,0,12887,12887,0
Information Technology,1075000.0,USA,5,7,983,15584,16567,0
Nonprofits|SaaS|Social Fundraising,10000000.0,USA,1,1,0,16071,16071,0
Advertising,10000000.0,CHN,1,1,0,13693,13693,0
Security,12000000.0,USA,1,5,0,14303,14303,1
Media|Software|Video,750000.0,USA,1,2,0,15308,15308,0
Networking|Service Providers|Transportation,106500000.0,USA,1,5,0,11253,11253,0
Enterprise Software,16630000.0,USA,2,11,904,12347,13251,1
Security,10000000.0,USA,1,2,0,12129,12129,0
Software,1850000.0,USA,1,1,0,13186,13186,0
Public Relations,10000000.0,IND,1,1,0,14518,14518,1
Analytics|Social Media,47200000.0,USA,5,8,2590,13824,16414,0
Curated Web|Small and Medium Businesses,300000.0,USA,1,1,0,14245,14245,0
Internet Service Providers|Professional Networking|Wireless,3500000.0,USA,1,3,0,11264,11264,0
Maps|Mobile|Navigation|SEO|Wireless,15000000.0,USA,2,10,546,12692,13238,1
Security,6000000.0,USA,1,2,0,12905,12905,0
E-Commerce,1783990.0,DEU,1,2,0,14684,14684,1
Commercial Real Estate|Creative Industries|Entrepreneur|Office Space,48000000.0,USA,3,4,822,15857,16679,0
Internet of Things|Wireless,18829964.0,GBR,3,6,497,15154,15651,1
Cloud Computing|Mobile|Mobile Infrastructure|Software,10900000.0,USA,2,18,141,16568,16709,0
Biotechnology|Health Diagnostics,21000000.0,USA,1,4,0,16161,16161,0
Curated Web|Internet of Things|M2M|Wireless,2020000.0,USA,4,10,693,15810,16503,0
Hardware + Software,11397600.0,AUT,1,1,0,15162,15162,0
Medical Devices,3268019.0,USA,2,1,812,15925,16737,0
Artificial Intelligence|Robotics|Software,750000.0,USA,2,4,653,15761,16414,0
Health Care,8623022.0,USA,4,1,1067,14620,15687,0
Mobile,18000000.0,CAN,3,9,851,14154,15005,1
Biotechnology,39226649.0,USA,4,8,1161,14329,15490,0
Collaboration|Health and Wellness|Innovation Management|Medical Devices,27772439.0,IRL,2,6,1071,15532,16603,0
Biotechnology,57417398.0,CAN,5,10,2835,12626,15461,0
All Students|Artificial Intelligence|Big Data|Big Data Analytics|Education|High School Students|K-12 Education|Language Learning|Neuroscience|Skill Assessment|Teachers|Test and Measurement|Testing|Tutoring|University Students,148230.0,USA,4,4,301,16343,16644,0
Cloud Computing|Image Recognition,4000000.0,GBR,1,1,0,16489,16489,0
Biotechnology,6000000.0,USA,1,2,0,12774,12774,0
Biotechnology,10000000.0,USA,1,1,0,14595,14595,1
Pharmaceuticals,18500000.0,ISR,2,2,2586,13717,16303,0
Biotechnology,14044878.0,USA,7,6,4762,11992,16754,0
Biotechnology,92043611.0,USA,6,14,3718,11710,15428,1
Biotechnology,7000000.0,USA,1,3,0,14949,14949,0
Computers|Interface Design,1150000.0,USA,1,3,0,16597,16597,0
Biotechnology,85300000.0,CAN,2,11,1384,12363,13747,1
Health and Wellness|Medical Devices|Technology,6167613.30185982,IRL,1,1,0,16707,16707,0
Biotechnology,8960000.0,EST,1,2,0,14099,14099,0
Biotechnology,31144339.0,USA,2,1,343,16427,16770,0
Biotechnology,1250000.0,USA,2,1,2611,13901,16512,0
Health and Wellness|Online Gaming,2544538.0,DEU,2,4,779,15279,16058,1
Biotechnology,94300000.0,USA,4,26,4996,11556,16552,0
Biotechnology,155000.0,USA,2,1,2136,13989,16125,0
Biotechnology,67000000.0,USA,3,6,4948,10947,15895,0
Biotechnology,54800000.0,USA,5,8,1415,15034,16449,0
Biotechnology,1746627.0,USA,2,2,873,15308,16181,0
Biotechnology,500000.0,USA,1,1,0,13592,13592,0
Health Care,12785029.0,USA,7,14,1857,14304,16161,0
Biotechnology,14330000.0,DNK,1,1,0,14473,14473,0
Biotechnology|Pharmaceuticals,4496910.0,ESP,1,2,0,15024,15024,0
Biotechnology,35000000.0,USA,1,12,0,13468,13468,0
Biotechnology,58200000.0,USA,3,5,1073,14250,15323,0
Biotechnology|Health and Wellness|Health Care Information Technology|Health Diagnostics,3090000.0,USA,3,3,586,15847,16433,0
Fitness|Health Care|Health Care Information Technology,1500000.0,USA,1,1,0,13877,13877,0
Biotechnology,22778607.0,USA,4,7,1147,15373,16520,0
Manufacturing|Medical|Medical Devices,8500000.0,USA,1,2,0,13857,13857,0
Health Care|Medical|Medical Devices,61300600.0,USA,4,9,1195,13644,14839,0
Bitcoin|Open Source,100000.0,USA,1,1,0,16100,16100,0
Software,40000000.0,CHN,1,1,0,13392,13392,0
Health Care,57433301.0,USA,6,5,2660,13917,16577,0
Health Care|Medical|Pharmaceuticals,7167534.47672193,DEU,2,3,520,16217,16737,0
Software,4750000.0,USA,3,5,550,12370,12920,1
Events|Information Technology|Social Media,3574739.0,ESP,2,2,366,15733,16099,0
Software,10000000.0,GBR,1,1,0,13168,13168,0
EdTech|Education|Hardware + Software|Startups|Technology,7576915.0,USA,2,9,513,15845,16358,0
Clean Technology,4100000.0,USA,1,2,0,14797,14797,0
Biotechnology,106000000.0,USA,2,16,597,15174,15771,1
Biotechnology,34296337.0,USA,4,2,357,14894,15251,0
Education,10000000.0,CHN,2,3,670,13879,14549,0
Clean Technology,12365936.0,GBR,2,2,665,13923,14588,0
Design,4000000.0,USA,1,1,0,15356,15356,0
Software|Web Development,2189440.0,IRL,1,4,0,14254,14254,0
Biotechnology,26086611.0,USA,4,5,1073,15642,16715,0
Information Technology|Services|Training,6000000.0,USA,1,1,0,12823,12823,0
Clean Technology,5000000.0,USA,1,1,0,14304,14304,0
3D Printing,6500000.0,USA,2,5,374,16102,16476,0
Education|Networking,1000000.0,GBR,1,1,0,16148,16148,0
Domains|Internet,1100000.0,USA,3,7,1227,11077,12304,1
Software,564000.0,GBR,2,2,459,14200,14659,0
Health Diagnostics|Software,996400.0,USA,2,1,1742,14453,16195,0
Analytics|Application Performance Monitoring|Cloud Computing|SaaS|Software,214500000.0,USA,6,26,2218,13970,16188,1
Games,1300000.0,FRA,1,1,0,12836,12836,0
Hospitality,17554604.0,USA,1,1,0,16035,16035,0
Information Technology,35000000.0,USA,1,1,0,16548,16548,0
Charity|Non Profit|Social Fundraising,100000.0,USA,1,1,0,16570,16570,0
Content|Startups,8155339.0,ITA,1,3,0,16330,16330,0
Construction|Real Estate|Rental Housing,50000.0,USA,1,1,0,15526,15526,0
Mobile,6500000.0,ISR,2,2,0,13514,13514,0
Games,53750000.0,CHN,2,6,402,14055,14457,0
Mobile|Web Development,13426775.0,IRL,2,3,1434,12430,13864,1
Health Care|Medical|Therapeutics,11000000.0,USA,1,6,0,11528,11528,0
Analytics|Enterprise Software|Social Media Monitoring,35032734.0,USA,3,4,901,15288,16189,1
Biotechnology,12000000.0,ARE,1,2,0,14872,14872,0
Hardware + Software,1617252.0,USA,4,3,1109,15281,16390,1
Events|Media,1700000.0,USA,1,2,0,16484,16484,0
Finance|Financial Services|FinTech|Venture Capital,16135004.0,USA,2,2,624,15173,15797,0
Web Hosting,8450000.0,USA,2,5,517,13062,13579,0
Manufacturing,662000.0,USA,1,3,0,15474,15474,0
Architecture|Building Owners|Construction|Engineering Firms|Software,21100000.0,USA,3,9,2786,13057,15843,0
Software,358457.0,GBR,1,1,0,16036,16036,0
Fashion,940000.0,IND,1,4,0,16587,16587,0
Software,25260000.0,IND,2,4,2219,13885,16104,0
Software,1200000.0,CHN,1,1,0,11231,11231,0
Semiconductors,28865598.0,USA,3,4,548,15671,16219,0
Biotechnology,24000000.0,USA,2,7,614,15714,16328,0
Biotechnology|Health Care,45214105.0,USA,3,5,537,13909,14446,1
Enterprise Software,12000000.0,USA,2,6,323,13192,13515,0
Education,20000000.0,CHN,1,1,0,13761,13761,0
Android|Apps|iOS|Mobile|Software,834287.0,CAN,2,2,120,15187,15307,0
Semiconductors,66000000.0,USA,3,14,608,12864,13472,1
Finance|FinTech,20580000.0,USA,1,4,0,13151,13151,1
Bio-Pharm|Medical|Pharmaceuticals,8353354.86642588,ITA,2,5,3494,13061,16555,1
Internet|Media|News,24000000.0,IND,3,6,360,16265,16625,0
Curated Web,1500000.0,USA,2,2,304,14791,15095,0
Public Relations,545000.0,USA,1,2,0,14549,14549,0
Advertising|Content Delivery|Marketplaces|Networking,15000.0,USA,1,2,0,15924,15924,0
Enterprise Software,42200000.0,USA,4,15,2453,11982,14435,1
Journalism|News|Social Media,342798.0,USA,2,1,483,15796,16279,0
Advertising|Charter Schools|Education|Email Newsletters|High Schools|Kids|Media|News|Publishing|Software,2350000.0,USA,2,1,335,15765,16100,0
EdTech|Education,22156174.0,USA,3,19,727,15987,16714,0
Media,331783.0,GBR,1,1,0,16148,16148,0
News|Social News,58000000.0,IND,2,7,137,16335,16472,0
Analytics,500000.0,USA,1,2,0,15407,15407,0
Curated Web|News|Social Network Media,4299997.0,USA,4,12,625,15392,16017,1
Consumer Electronics|Distribution|Manufacturing,25000000.0,HKG,2,2,2886,13549,16435,0
Advertising,57324.0,USA,1,4,0,15862,15862,0
Communities,62500000.0,USA,1,5,0,12117,12117,0
Apps|Mobile|News,7600000.0,SGP,1,3,0,11372,11372,1
Content|Curated Web|Facebook Applications|Social Media|Social Media Marketing|Twitter Applications,270000.0,USA,1,1,0,14822,14822,0
Digital Media|Media|News|PaaS,170000.0,SWE,4,6,579,16100,16679,0
News|Technology,7200000.0,USA,1,4,0,12592,12592,0
Software,31477853.0,CAN,3,10,1789,12118,13907,0
Technology,38000000.0,USA,1,2,0,16708,16708,0
News|Social Media,1250000.0,USA,1,1,0,12965,12965,1
Analytics|Big Data Analytics|Content|Content Discovery|Entertainment|Media|News|SaaS|SEO|Social Media|Social Media Monitoring,2700000.0,USA,4,26,1365,15218,16583,0
Digital Media|Media|News|Publishing|Software,25000.0,RUS,1,1,0,16040,16040,0
E-Commerce|Internet|Retail Technology,200000.0,USA,1,2,0,15936,15936,0
Clean Technology,75000000.0,USA,1,1,0,14876,14876,0
B2B|Gamification|Health and Wellness,4143587.0,CAN,4,5,1308,15099,16407,0
Transportation|Travel|Travel & Tourism,2500000.0,CAN,1,2,0,11631,11631,1
Software,1510000.0,DEU,1,2,0,12921,12921,0
Cloud Computing|Enterprise Software|Security,4000000.0,ISR,3,7,569,15257,15826,1
Enterprise Software,111300000.0,GBR,4,17,1503,14757,16260,0
Media|News|Publishing,250000000.0,USA,1,1,0,14264,14264,1
Big Data|Content|Curated Web,70000.0,USA,1,1,0,15925,15925,0
Mobile|Software,300000.0,MMR,1,1,0,16754,16754,0
Advertising|Mobile|Mobile Advertising,19500000.0,USA,3,6,1583,13914,15497,1
Analytics,574392.0,CAN,1,1,0,15247,15247,0
Software,82500000.0,USA,3,4,57,14816,14873,0
Social Network Media,4000000.0,USA,1,2,0,16583,16583,0
Software|Web Development,14603757.0,USA,3,6,3382,12191,15573,0
Health Care,4000000.0,USA,1,3,0,11992,11992,1
Security,8147000.0,USA,3,3,1067,15688,16755,0
Dental|Internet|Reviews and Recommendations,975000.0,USA,1,1,0,15740,15740,0
Linux|Software|Storage,49860000.0,USA,7,22,1280,15034,16314,0
Hardware + Software,65151602.0,GBR,2,3,597,15191,15788,0
Biotechnology,21500000.0,USA,1,3,0,16072,16072,0
Finance|Fitness|Games|Health and Wellness|Mobile,1328558.0,USA,4,5,1261,15300,16561,0
Security,1329600.0,FRA,1,2,0,14707,14707,0
Software,12000000.0,USA,2,5,328,14965,15293,1
Manufacturing,1617582.0,USA,1,1,0,16464,16464,0
Services,15000000.0,USA,1,2,0,11196,11196,0
B2B|Recruiting|SaaS|Social Media,47168.0,NLD,2,2,146,15279,15425,0
Enterprise Software,13750000.0,USA,1,4,0,13179,13179,0
Analytics,40268814.0,USA,5,14,2227,13368,15595,0
Biotechnology,5213000.0,USA,4,3,1347,15132,16479,0
Enterprise Software|Internet TV|IT Management|Video Streaming,2750000.0,CAN,1,1,0,14390,14390,0
Developer APIs|Messaging|Mobile|SMS|Wholesale,22830000.0,USA,6,8,751,15340,16091,0
Machine Learning|Manufacturing|Technology,760000.0,USA,3,1,126,16500,16626,0
Semiconductors,43000000.0,USA,5,11,1904,13978,15882,1
Enterprise Software|Hardware + Software,24500000.0,GBR,2,4,1965,12387,14352,1
Enterprise Software,36000000.0,USA,3,9,1007,15329,16336,0
Health Diagnostics|Messaging,32585933.886552803,FIN,4,11,2663,13762,16425,1
Advertising,484000.0,DEU,1,1,0,13167,13167,0
Analytics|Finance|Music,7949997.0,USA,4,11,880,14462,15342,1
Entertainment|Games|Graphics|Mobile Games,6000000.0,FIN,1,7,0,16098,16098,0
Finance,1200000.0,USA,1,1,0,16097,16097,0
Digital Media|News|Tablets,50000000.0,USA,1,4,0,16406,16406,0
Business Development|Corporate Wellness|Discounts|E-Commerce|Employer Benefits Programs|Health and Wellness|Human Resources|Incentives|Loyalty Programs|Shopping,45000000.0,USA,4,2,2922,10227,13149,0
Curated Web|Video|Video Streaming,27063781.0,USA,4,7,1458,13514,14972,1
Ad Targeting|Advertising|Real Time,23016000.0,FRA,1,1,0,15125,15125,0
Clean Technology,87780732.0,USA,15,10,2205,14347,16552,0
Consumer Electronics|Internet of Things,25000.0,USA,6,4,583,16085,16668,0
Content|Domains|Games|Publishing,1356210.0,ITA,1,1,0,10957,10957,0
Curated Web,7000000.0,USA,1,1,0,10917,10917,0
Enterprise Software,19100000.0,USA,2,6,1525,11746,13271,0
Enterprise Software,16100000.0,USA,3,6,1721,12784,14505,1
Software,19362343.0,USA,3,3,625,16084,16709,0
Advice|Finance|Retirement|Software,6300000.0,USA,1,5,0,16315,16315,0
Biotechnology|Health Diagnostics,15000000.0,USA,1,2,0,16001,16001,1
Advertising,390000.0,USA,1,6,0,15133,15133,0
Software,28800000.0,USA,3,6,751,15208,15959,0
Communities|Privacy|Social Media,210200000.0,USA,4,24,952,15545,16497,0
Clean Technology,34762711.8644068,CAN,5,4,1587,13538,15125,0
Semiconductors,20000000.0,USA,1,6,0,11674,11674,1
Electric Vehicles|Electronics|Manufacturing,500000000.0,CHN,1,4,0,16695,16695,0
Mobile|Wireless,49800000.0,USA,1,2,0,13906,13906,1
Angels|Venture Capital,1000000.0,USA,1,1,0,16559,16559,0
Travel,4000000.0,USA,2,2,399,15562,15961,0
Biotechnology,7675029.0,USA,5,4,2100,14610,16710,0
Health Care|Hospitals,1000000.0,USA,1,5,0,16665,16665,0
Software,33687880.0,CHE,5,9,2833,13579,16412,0
Software,8800000.0,USA,2,8,240,13482,13722,1
Health Care,12100000.0,USA,4,4,2142,14565,16707,0
Curated Web,441393.0,USA,1,6,0,16131,16131,0
Hardware + Software,5168000.0,USA,8,6,1172,15445,16617,0
Hardware + Software|Networking|Technology,64600000.0,USA,5,8,2683,12794,15477,0
Hardware + Software|Mobile|Networking|Network Security|Wireless,16500000.0,USA,3,3,1803,14518,16321,0
Real Estate|Search,40000.0,USA,2,1,14,15706,15720,0
Colleges|Education|Online Education,2900000.0,USA,1,10,0,16680,16680,0
E-Commerce,30000.0,ARE,1,1,0,16467,16467,0
Advertising,9500000.0,USA,2,5,538,12815,13353,0
Games|Music|Video Streaming,70000.0,UKR,2,1,289,15684,15973,0
Navigation|Utilities,99184501.0,USA,3,5,981,15294,16275,0
Cyber Security|Industrial Automation|Software,35000000.0,USA,3,15,2074,11344,13418,0
Content Delivery|Internet of Things|Location Based Services,70000.0,SVN,2,1,365,16130,16495,0
Ediscovery|Legal,22427174.0,USA,3,4,3802,11346,15148,0
Games|iOS|Mobile|Mobile Games|Social Games,2900000.0,ISR,1,2,0,15778,15778,1
Web Hosting,35000000.0,USA,2,6,403,13094,13497,1
Software,3174999.0,USA,4,13,582,15412,15994,1
Renewable Energies|Solar|Utilities,40515968.0,USA,3,1,183,16435,16618,1
Hardware + Software,42350485.0,USA,3,13,1585,12846,14431,0
Art|E-Commerce|Facebook Applications|Music|Retail|Shopping|Social Commerce|Social Media|Sports|Twitter Applications,32165.0,DEU,2,1,405,15461,15866,0
Enterprise Software|Networking|Professional Networking|Social Media,2400000.0,USA,3,4,315,16099,16414,0
Curated Web,1750000.0,USA,3,2,893,15042,15935,0
Fitness|Health and Wellness|Quantified Self,150000.0,USA,1,1,0,15857,15857,0
Brand Marketing|Crowdsourcing|Design|E-Commerce|Fashion|Shopping,1515118.0,ITA,2,2,518,15522,16040,0
Social Media,700000.0,USA,1,2,0,15875,15875,0
Analytics|CRM|Marketing Automation|SaaS,1650000.0,USA,1,2,0,16019,16019,0
Software,35500000.0,USA,2,8,428,16322,16750,0
Biotechnology,86819000.0,USA,3,10,2056,13558,15614,1
Mobile|Social Games|Training,81053.0,ITA,2,1,280,16179,16459,0
Energy Efficiency|Recycling|Renewable Energies|Water,3300000.0,AUS,2,4,246,16253,16499,0
Biotechnology,40000000.0,AUS,3,5,236,15940,16176,0
Internet|Marketplaces|Property Management|Real Estate,500000.0,USA,1,1,0,15838,15838,0
Software,12990000.0,FRA,2,11,762,12886,13648,0
E-Commerce|Email Marketing|Game|Outsourcing|Software|Video Games,25647702.0,FRA,3,10,2013,12784,14797,0
Apps|App Stores|Consumers|Games|iPad|iPhone|Mobile|Publishing,315000.0,MYS,2,1,716,15126,15842,0
Semiconductors,25397925.0,USA,4,4,1979,12613,14592,1
Finance,11160000.0,USA,2,4,1825,13887,15712,1
E-Commerce|Marketplaces|Online Travel|Tourism|Travel,1170000.0,CHE,2,6,299,15924,16223,0
Apps|Mobile|Software|Web Development,68502.0,LVA,1,1,0,16118,16118,0
Analytics|Big Data|Enterprise Software|Software,1500000.0,KOR,2,4,119,16307,16426,0
Design|Hardware + Software,7542266.0,USA,2,1,211,14865,15076,1
Consulting,5258400.0,DEU,4,7,1715,14088,15803,0
Clean Technology,6000000.0,USA,2,3,111,15777,15888,1
Software,20876578.0,USA,2,2,36,15873,15909,0
Analytics|Big Data,18456740.0,BEL,4,11,1120,15616,16736,0
Clean Technology,325319.0,GBR,1,1,0,15038,15038,0
Software,33000000.0,USA,3,13,1156,15257,16413,0
Biotechnology|Medical,333988996.0,USA,7,14,2599,13921,16520,0
Games|iPhone|Mobile|Mobile Games,44800000.0,USA,4,11,741,14091,14832,1
3D|Augmented Reality|Software,21970000.0,CAN,2,2,2249,13633,15882,0
Consumer Electronics|Consumer Goods|Games|Toys,18000.0,USA,1,1,0,16467,16467,0
Internet|Startups,20000000.0,USA,1,3,0,16723,16723,0
Security,29000000.0,USA,2,5,394,16140,16534,0
Web Hosting,119881.0,CHL,2,3,456,15431,15887,0
Analytics|Digital Rights Management|Predictive Analytics|Software|Video|Video Streaming,1333700.0,ESP,1,1,0,15427,15427,0
Web Hosting,41815432.0,USA,4,8,588,14420,15008,1
Biotechnology,16572736.0,USA,2,4,1090,14451,15541,0
Discounts|Local|Mobile|Sales and Marketing,1000000.0,IND,1,1,0,16498,16498,1
Curated Web,800000.0,USA,1,5,0,15904,15904,0
Fashion,2000000.0,USA,1,5,0,15576,15576,0
Apps|Education,25000.0,USA,1,2,0,16588,16588,0
Education|Mobile,1048175.78413394,GBR,6,9,730,15553,16283,0
Service Providers|Software|Telecommunications,11700000.0,USA,1,4,0,11740,11740,0
Hospitals,25000000.0,USA,1,1,0,12515,12515,1
Analytics|Health and Wellness|Health Care Information Technology|Software,780000.0,USA,3,8,609,15909,16518,0
Software,3500000.0,CAN,1,1,0,16307,16307,1
Event Management|Hospitality|Nightlife,120000.0,USA,2,5,41,15675,15716,0
Biotechnology,53183017.0,GBR,2,2,641,16105,16746,0
E-Commerce Platforms,500000.0,IND,1,3,0,16651,16651,0
Software,150000.0,USA,1,1,0,16040,16040,0
Consumer Electronics,940000.0,USA,3,3,0,16610,16610,0
Career Planning|Social Media|Travel,13000000.0,USA,3,4,1797,13149,14946,1
Enterprise Software,3000000.0,USA,1,1,0,13292,13292,0
Art|Digital Rights Management|Music|Social Commerce,5425636.0,USA,5,6,1775,13269,15044,0
Software,7605000.0,USA,3,1,1147,15582,16729,0
Big Data|Credit|Finance|Financial Services|FinTech|Risk Management,18300000.0,AUS,2,2,315,15931,16246,0
Cloud Computing|Content|Internet,1000000.0,USA,1,1,0,16567,16567,0
Collaboration|CRM|Sales and Marketing|Software,3000000.0,USA,3,9,1320,14610,15930,0
Electronics|Enterprise Software|Flash Storage|Software|Storage|Technology,98751230.0,USA,5,14,1359,14234,15593,1
Software,8150000.0,USA,3,11,323,15274,15597,1
Wireless,500000.0,IND,1,1,0,16477,16477,0
Advertising,12950000.0,USA,2,6,1686,12874,14560,1
Technology,300000.0,USA,1,1,0,16314,16314,0
Data Centers|Information Technology|Networking|Security|Services,12000000.0,USA,1,1,0,16239,16239,0
Cloud Computing|Enterprise Software|Infrastructure|Virtualization,20750000.0,USA,2,4,61,14783,14844,1
Enterprise Software|Software|Storage,2000000.0,USA,1,4,0,13514,13514,0
Biotechnology,72000000.0,USA,4,12,1785,14728,16513,0
Cloud Data Services|File Sharing|Software,275000.0,USA,1,2,0,15911,15911,0
Cloud Computing|Cloud Management|Data Centers|Enterprise Software|Networking|SaaS|Virtualization,22300000.0,GBR,2,5,642,13523,14165,1
Fashion,3700000.0,USA,1,3,0,12615,12615,0
Automated Kiosk|Event Management|Events|Video,300000.0,USA,2,2,97,13417,13514,0
Manufacturing|Robotics|Transportation,80000000.0,CHN,2,5,155,16540,16695,0
Health Care,82000000.0,USA,3,6,1579,14896,16475,0
Manufacturing|Photography|Solar,450310.0,IRL,1,3,0,15960,15960,0
Enterprise Software,6500000.0,USA,2,3,1085,14004,15089,0
Communities|Enterprise Software|Software,134000002.0,USA,5,7,934,13514,14448,1
Developer APIs|Home Automation|Internet of Things|Open Source,2402000.0,USA,3,10,491,15887,16378,0
Delivery|E-Commerce|Logistics,2500000.0,SGP,1,1,0,16496,16496,0
Analytics|Enterprise Software,5680152.0,USA,2,4,569,16020,16589,0
Health Diagnostics|Medical|Medical Devices,15000000.0,ISR,2,4,31,16523,16554,0
Software,2010000.0,FRA,1,1,0,13520,13520,0
Cloud Data Services|Information Technology|Software,135000000.0,USA,1,2,0,15791,15791,0
Ad Targeting|Brand Marketing|Direct Marketing|Location Based Services|Mobile|Mobile Advertising|Mobile Analytics|Mobile Video,49256256.0,USA,6,15,3073,13285,16358,0
Curated Web|Facebook Applications|News|Social Bookmarking,750000.0,USA,4,5,695,14991,15686,0
B2B|Banking|Enterprise Software|Health Care|Software|Telecommunications,12000000.0,USA,2,3,1242,14533,15775,0
Advertising|Collaborative Consumption|Real Estate|Web Development,21189.0,LVA,1,1,0,15222,15222,0
Biotechnology|Health Diagnostics,2000000.0,USA,1,1,0,16300,16300,0
Cloud Computing|Cloud Data Services|Cloud Management|Enterprise Software,70000000.0,USA,5,21,1689,13774,15463,0
Electronics|Intelligent Systems|Systems,70000000.0,USA,2,10,273,10945,11218,0
Transportation,8000000.0,USA,1,2,0,12107,12107,1
Web Hosting,28427670.0,USA,6,18,1714,13292,15006,0
B2B|Social Media,72000.0,USA,1,1,0,15279,15279,0
Biotechnology,18500000.0,ISR,1,6,0,14467,14467,0
Health Care,40000000.0,USA,2,2,2,15090,15092,0
Clean Technology,50000000.0,RUS,1,1,0,14091,14091,0
Biotechnology,18458739.0,USA,4,3,2121,13238,15359,0
Semiconductors,4705893.0,USA,2,4,504,15987,16491,0
Pharmaceuticals,31400000.0,USA,1,7,0,11486,11486,1
Semiconductors,78047934.0,USA,6,13,3843,11516,15359,1
Health Care Information Technology|Mobile|Mobile Health,205000.0,USA,2,1,909,15765,16674,0
Collaboration|SaaS|Software,24826900.0,USA,5,5,2843,13535,16378,0
Security,29000001.0,USA,6,10,2054,12839,14893,1
Software,2005950.0,IRL,1,1,0,13611,13611,0
Cloud Computing|Enterprise Software|iPad|PaaS|Software|Web Development|Web Tools,7650000.0,USA,2,16,336,15811,16147,0
Clean Technology,1700000.0,CHN,1,1,0,14953,14953,0
Location Based Services|Logistics|Transportation|Wireless,1000000.0,IND,1,2,0,16447,16447,0
Games,18000000.0,RUS,3,4,1478,14572,16050,0
Credit|Telecommunications|Utilities,40000.0,CRI,1,1,0,16222,16222,0
Biotechnology,4205538.0,USA,3,5,1064,15232,16296,0
App Stores|Cloud Computing|Cloud Data Services|Enterprise Software|SaaS|Software|Storage,21000000.0,IND,1,2,0,15379,15379,0
Agriculture|Clean Technology,200000.0,GBR,2,2,124,16078,16202,0
Games|Mobile Games,5615000.0,USA,2,2,879,15340,16219,0
Fashion,139000000.0,USA,1,1,0,15389,15389,0
Software,18000000.0,GBR,2,5,216,13123,13339,0
Hardware + Software|Health and Wellness,165000000.0,USA,3,6,690,15439,16129,0
E-Commerce|Fashion|Lifestyle,28960995.0,USA,1,2,0,16455,16455,0
Biotechnology,12000000.0,USA,2,2,527,14319,14846,0
Biotechnology|Ediscovery,9679942.0,ESP,3,5,946,15391,16337,0
Lasers,139304040.0,USA,9,19,4971,11687,16658,0
Biotechnology,5700000.0,ISR,1,2,0,15405,15405,0
Clean Technology|Data Centers|Software,12000000.0,USA,2,4,934,14000,14934,0
Finance,10000000.0,ZWE,1,1,0,16115,16115,0
B2B|E-Commerce|Lead Generation|Marketplaces,50000.0,USA,2,2,457,16099,16556,0
Biotechnology,108442730.0,USA,6,6,3475,13149,16624,0
Travel,10606760.0,GBR,1,1,0,16147,16147,0
Document Management|Mobile Commerce|Mobile Payments,227507.0,GBR,1,1,0,16464,16464,0
Finance,13923766.0,CHN,2,2,1074,13809,14883,0
Clean Technology,100000000.0,CHN,1,1,0,14904,14904,0
E-Commerce,11500000.0,IND,1,1,0,15772,15772,0
Mobile,123000.0,USA,1,1,0,14173,14173,0
Health and Wellness|Health Care|Professional Services|Software,870280.0,USA,3,5,710,15858,16568,0
Biotechnology,8000000.0,USA,2,4,507,15380,15887,0
Consumer Goods|Home Decor|Home Renovation|Lifestyle Products,6000000.0,USA,2,1,11,16374,16385,0
Biotechnology,335000.0,USA,2,1,749,14957,15706,0
Manufacturing|Startups,15000.0,USA,1,1,0,14761,14761,0
Advertising|Android|Consumer Electronics|iPhone|Mobile,1649028.0,JPN,3,3,371,14526,14897,1
Real Estate|Rental Housing,3000000.0,IND,1,2,0,16489,16489,0
Consulting|Technology,16000000.0,USA,2,9,684,15918,16602,0
Biotechnology|Health Diagnostics,27039999.0,USA,5,9,1817,13377,15194,0
Business Services|Information Technology|Web Development,130743.0,NLD,1,1,0,15765,15765,0
Analytics|Big Data|Cloud Computing,2000000.0,USA,1,1,0,15181,15181,1
Curated Web|Networking|SaaS|Software,800000.0,CAN,1,1,0,15651,15651,1
Networking|PaaS|Software|Web Hosting,2650000.0,USA,3,10,796,15065,15861,0
Analytics|Big Data|Cloud Computing|Cloud Management|Enterprise Software|Infrastructure|Machine Learning,8500000.0,USA,2,10,726,15982,16708,0
Software,3000000.0,USA,1,4,0,16475,16475,0
Clean Energy|Finance Technology|FinTech,25500001.0,USA,3,3,1238,15279,16517,0
Aerospace|Big Data|Maps,2600000.0,USA,1,8,0,16630,16630,0
Music|Social Network Media|Startups|Web Tools,10000.0,HUN,1,1,0,14883,14883,0
Software,1400000.0,USA,1,1,0,13705,13705,0
Music,1430000.0,USA,2,7,111,14986,15097,0
Electronics|Film|Sports|Video Games,25000000.0,CHN,2,3,472,16283,16755,0
Security,47750000.0,USA,3,13,924,15748,16672,0
Media|Software,31828793.0,USA,3,5,588,14099,14687,1
Advertising|Analytics|Android|Gamification|Incentives|iPhone|Loyalty Programs|Mobile|Social Media|Software,764652.0,MEX,4,3,407,15279,15686,0
Enterprises|Enterprise Software|Messaging|Mobile,200000.0,USA,1,1,0,15765,15765,0
Software,5000000.0,ISR,1,2,0,14227,14227,1
Consumer Goods|Manufacturing|Sustainability|Wine And Spirits,22000000.0,USA,2,2,2765,13685,16450,0
Networking,25000000.0,USA,2,10,214,11757,11971,0
Curated Web,1050000.0,ZAF,3,2,1389,15340,16729,0
Email|File Sharing|Software,100000.0,RUS,1,1,0,15380,15380,0
Advertising|Internet Marketing,383238.0,ITA,1,2,0,15054,15054,0
Analytics|Retail|Software,13000000.0,USA,2,15,247,15747,15994,1
Hardware + Software,145000.0,USA,7,5,1346,15391,16737,0
Analytics|Internet|Network Security|Sales and Marketing,41000000.0,USA,4,11,1776,11088,12864,0
Finance|FinTech,21000000.0,USA,3,8,3037,12935,15972,0
Business Analytics|Business Intelligence,218000.0,GBR,1,2,0,16622,16622,0
E-Commerce,52000000.0,USA,2,3,335,15674,16009,0
Developer APIs|Enterprise Software|Finance Technology|Service Providers|Software|Telecommunications,661500.0,IRL,1,2,0,15392,15392,0
Babies|E-Commerce|Online Shopping,1660243.0,ESP,3,7,487,15309,15796,0
Hospitality|Manufacturing|Service Providers|Technology,1390794.0,PRT,1,1,0,15279,15279,0
Software,2374240.0,GBR,1,1,0,15340,15340,1
Consumers|Games,2900000.0,SGP,1,2,0,15783,15783,1
Health Care,10097500.0,DEU,1,3,0,15154,15154,0
Food Processing,16000.0,IND,1,3,0,16647,16647,0
Mobile,389500000.0,USA,2,2,272,15431,15703,0
E-Commerce|Shopping|Web Development|Web Tools,1557400.0,IRL,1,2,0,14092,14092,0
Android|Apps|Exercise|Fitness|Health and Wellness|Mobile|Software|Startups|Technology,28359160.0,USA,7,20,1400,15126,16526,0
Software,1626000.0,FRA,3,4,723,14047,14770,0
Consumers|Mobile|Social Network Media,400000.0,THA,1,5,0,15973,15973,0
Software,54324900.0,USA,2,9,1969,10904,12873,0
Curated Web|Ediscovery|Social Media,426960.0,USA,1,4,0,13787,13787,0
Software,500000.0,IND,1,2,0,15156,15156,0
Enterprise Software|IT and Cybersecurity|SaaS,1000000.0,USA,1,3,0,15765,15765,0
Analytics|Software,29100000.0,USA,4,5,1204,14489,15693,0
Biotechnology,20932000.0,USA,2,5,1415,14762,16177,0
Biotechnology,13000000.0,USA,1,6,0,11723,11723,0
Neuroscience|Rehabilitation|Therapeutics,923148.0,DNK,1,2,0,15771,15771,0
Electrical Distribution,3500000.0,DNK,2,2,31,16703,16734,0
Cloud Computing|Communications Hardware|Customer Service|Hardware + Software,1300000.0,FIN,1,1,0,15675,15675,0
Clean Technology,54000000.0,USA,3,8,826,13788,14614,0
Education,8000000.0,USA,4,16,840,15644,16484,0
Hardware + Software|Mass Customization|Mobile Commerce,200000.0,USA,1,1,0,16163,16163,0
Biotechnology,25156708.0,USA,5,3,936,14363,15299,0
Cyber Security|Data Security|Defense|Enterprise Security|Finance Technology|Homeland Security|IT and Cybersecurity|Law Enforcement|Network Security|Retail Technology|Security,24950000.0,USA,4,3,1490,15218,16708,0
Semiconductors,41806500.0,SWE,2,6,1127,12829,13956,0
Clean Technology,303570000.0,NOR,5,10,855,13459,14314,0
Software,18990800.0,EST,2,2,1046,14810,15856,0
Finance,33000000.0,HKG,1,1,0,14860,14860,0
Finance,1000000.0,USA,1,3,0,16413,16413,0
Health and Wellness,175200.0,USA,1,1,0,16113,16113,0
Biotechnology,311500.0,USA,2,2,679,15202,15881,0
Financial Services,4942704.970949,CAN,1,1,0,15567,15567,0
Consumer Internet,5000000.0,USA,2,9,118,16332,16450,0
Software,6000000.0,CAN,1,1,0,14776,14776,1
Education,500000.0,USA,1,1,0,15903,15903,0
Clean Technology,37000000.0,USA,1,2,0,14147,14147,1
Software,29500000.0,USA,2,7,1260,12571,13831,1
Fitness,182554.0,DNK,1,1,0,16246,16246,0
Crowdsourcing|Software,400000.0,DNK,1,1,0,13818,13818,0
E-Commerce|Internet Marketing|Marketing Automation|Personalization|Reviews and Recommendations|SEO,8300000.0,FIN,2,6,454,15812,16266,0
Games,1000000.0,CZE,1,1,0,13500,13500,0
Collaboration|Mobile Software Tools|Web Tools,2000000.0,USA,1,3,0,16385,16385,0
Biotechnology|Health and Wellness|Health Care|Testing,120000.0,USA,2,3,274,16405,16679,0
Software,5000000.0,USA,1,1,0,14313,14313,0
Medical Devices,4000000.0,ISR,1,2,0,12079,12079,0
Identity|Real Estate|Security,585000.0,USA,1,1,0,16465,16465,0
Colleges|Education|Networking|Social Network Media|Universities,900000.0,USA,2,1,446,15918,16364,0
Collectibles|Internet|Mobile|Photo Editing|Social Media|Social Network Media,941764.0,ESP,2,2,556,15887,16443,0
Health and Wellness,170118.0,USA,2,1,954,15396,16350,0
Creative Industries|Mobile|Music Services,7500.0,MEX,1,1,0,16316,16316,0
Analytics|Curated Web|Digital Media|Social Media,1600000.0,HKG,1,4,0,16483,16483,0
Apps|Mobile|Software,710000.0,USA,7,7,624,15902,16526,0
Mobile|Public Relations,223478.0,NLD,2,2,125,16435,16560,0
Home Automation|Internet of Things|Sensors,2280000.0,USA,2,8,298,16283,16581,0
Mobile|Mobile Devices|News,25000.0,USA,1,1,0,15584,15584,0
E-Commerce,36186344.0,GBR,5,8,2489,14092,16581,0
Curated Web,3030000.0,FRA,1,1,0,14705,14705,0
Manufacturing,1000000.0,CHN,1,1,0,13902,13902,0
Food Processing,250000.0,AUS,1,2,0,16687,16687,0
Design|Social Commerce|Social Media,3600000.0,USA,1,3,0,16467,16467,0
File Sharing|Mobile,250000.0,USA,1,4,0,15503,15503,0
Software,1300000.0,DEU,1,2,0,12899,12899,0
Health Care,54000000.0,IND,1,2,0,15565,15565,0
Biotechnology,7569850.0,GBR,1,1,0,16454,16454,0
Healthcare Services|Medical|Pharmaceuticals,48000000.0,USA,1,6,0,13415,13415,1
Biotechnology,35000000.0,USA,1,6,0,12425,12425,0
Clean Technology,2393578.0,GBR,1,3,0,15001,15001,0
Health Care|Hospitals|Medical,30000000.0,USA,1,2,0,11750,11750,1
Biotechnology,28958656.422448102,GBR,3,5,715,13717,14432,0
Medical Devices,5993671.0,FRA,2,1,222,16414,16636,1
Biotechnology,34588274.0,USA,2,2,225,15756,15981,0
Biotechnology|Medical|Therapeutics,31390134.0,BEL,1,5,0,16688,16688,0
Diagnostics|Health Care|Medical Devices,10000000.0,USA,1,2,0,16393,16393,0
Software,12000000.0,USA,1,2,0,13745,13745,0
Biotechnology|Health Diagnostics|Life Sciences,40000.0,CHL,1,1,0,16222,16222,0
Biotechnology,31000999.0,USA,2,3,987,13819,14806,0
Clean Technology,32466630.0,DEU,3,19,2127,13118,15245,1
Lasers|Lighting|UV LEDs,21700000.0,USA,1,5,0,13343,13343,0
Software,2640000.0,FRA,1,1,0,13514,13514,0
Health Care,18800000.0,CHN,2,4,184,13695,13879,1
Dental,2500000.0,USA,1,2,0,13892,13892,1
Biotechnology|Pharmaceuticals,86825085.0,USA,7,1,2098,14426,16524,0
Enterprise Software,19499950.0,FRA,2,7,779,15426,16205,0
Health Care,7200000.0,USA,2,1,145,14549,14694,0
Health Care,16000000.0,USA,1,6,0,13425,13425,0
Gps|Industrial|Mechanical Solutions|Technology,60500000.0,USA,3,14,2054,12913,14967,0
Mobile,70000000.0,USA,2,8,2195,11530,13725,1
Hardware + Software|Wearables,13412177.0,USA,2,6,2238,14001,16239,0
Health Care,25000000.0,GBR,1,5,0,15042,15042,0
Biotechnology,46077411.0,USA,3,3,1232,14995,16227,0
Software,2000000.0,FRA,1,1,0,14776,14776,0
Health Care,95000000.0,CHN,3,5,1339,14153,15492,0
Biotechnology,20000000.0,CHN,1,1,0,15503,15503,0
Biotechnology,49500000.0,USA,1,10,0,14015,14015,0
Health Care,70447308.0,USA,3,7,2812,12538,15350,0
Health Care,17952285.0596268,IRL,2,5,1340,13775,15115,0
Manufacturing,37000000.0,USA,3,5,1224,14518,15742,0
Health Care,4370000.0,USA,6,11,1563,14923,16486,0
Business Intelligence|Market Research|Product Development Services,1570886.0,FRA,1,2,0,11323,11323,1
Biotechnology,5020000.0,SWE,1,1,0,14057,14057,0
Enterprise Software|Finance|MMO Games|Software|Video Games|Virtual Worlds,2267282.0,USA,3,2,595,14784,15379,0
Biotechnology,75000000.0,USA,1,1,0,15327,15327,0
Apps|Computers|Technology,12000000.0,NOR,1,3,0,16407,16407,0
E-Commerce|Facebook Applications|Services|Shopping,80000.0,PER,2,2,19,15126,15145,0
E-Commerce|Finance|FinTech|Virtual Currency,25000.0,USA,1,1,0,16161,16161,0
E-Commerce,32842.0,BGR,1,1,0,15826,15826,0
Web Hosting,90400000.0,USA,2,15,1805,11408,13213,0
Manufacturing,200000.0,USA,1,1,0,15271,15271,0
News,25000.0,USA,1,1,0,15906,15906,0
Internet of Things|Security,750000.0,USA,2,1,175,16245,16420,0
Health and Wellness,24700000.0,USA,3,2,712,15739,16451,0
E-Commerce|Handmade|Home Decor,3000000.0,USA,2,2,903,11303,12206,0
Finance|Financial Services|FinTech|Marketplaces,1700000.0,GBR,3,5,449,16252,16701,0
Data Centers|Networking|Network Security|Software|Telecommunications,9000000.0,CAN,3,2,784,15903,16687,0
Health and Wellness,20000.0,USA,1,1,0,15492,15492,0
Biotechnology,210996580.0,CHE,6,16,5040,11078,16118,0
Clean Technology,6000000.0,USA,1,2,0,15383,15383,0
Software,10680599.0,USA,3,1,2573,12539,15112,0
Health Care|Sustainability|Technology,16227.0,NLD,1,1,0,16525,16525,0
Biotechnology,39495233.0,USA,4,9,1247,15181,16428,1
Advertising|Internet Marketing|Video on Demand|Video Streaming,600000.0,USA,2,4,314,15908,16222,0
Games|Mobile Games|Social Games|Virtual Worlds,500000.0,KOR,1,1,0,16433,16433,0
EdTech|Education|Social Network Media,4800000.0,USA,2,8,517,15706,16223,0
Biotechnology,4530000.0,AUS,1,1,0,15889,15889,1
Clean Technology,5500000.0,USA,3,1,311,15034,15345,0
Clean Technology,46400000.0,USA,5,7,2225,13824,16049,0
Biotechnology|Health Diagnostics,14750000.0,USA,3,5,1263,15125,16388,0
Clean Technology,12914400.0,BEL,3,8,978,15008,15986,0
Health and Wellness|Health Care|Health Care Information Technology,20000000.0,USA,1,2,0,16532,16532,0
Security,6500000.0,USA,1,3,0,13165,13165,0
Biotechnology,7800000.0,CAN,1,3,0,14001,14001,0
B2B|Direct Marketing|E-Commerce|Marketing Automation|Printing|SaaS|Small and Medium Businesses,49342.0,CAN,1,1,0,15810,15810,0
Mobile,14105310.0,USA,7,11,1600,14610,16210,0
Software,4000000.0,ISR,1,2,0,15369,15369,0
Analytics,1000000.0,CHN,1,1,0,15675,15675,0
News,12000000.0,CAN,3,5,911,12784,13695,1
Apps|Mobile Security|Software|Technology,12500000.0,USA,2,4,104,16302,16406,0
Advertising,1360000.0,USA,2,3,689,14928,15617,0
Mobile,15600000.0,USA,3,8,594,15826,16420,0
Apps|Software|Software Compliance,1200000.0,USA,1,2,0,16623,16623,0
Hospitality,6446217.0,USA,4,1,1047,14904,15951,0
Hardware + Software,7800000.0,USA,3,7,1694,12989,14683,0
Analytics,5000000.0,USA,1,1,0,15100,15100,0
Mobile,17215.0,KOR,1,1,0,14610,14610,0
Software,10600000.0,USA,2,8,414,16112,16526,0
Mobile|Networking|Social Media|Social Search|Transportation,1700000.0,USA,1,7,0,15309,15309,0
Clean Technology,9700000.0,GBR,1,2,0,14015,14015,0
Web Hosting,2947189.0,USA,3,1,368,15635,16003,1
Android|Apps|Mobile|Mobile Security|Privacy|Software,10000000.0,USA,6,15,2047,13848,15895,1
Energy,315000.0,USA,1,1,0,16103,16103,0
Software,4000000.0,USA,2,2,81,12874,12955,0
Cloud Computing|Enterprise Software|Homeland Security|IaaS|Infrastructure,8500000.0,USA,2,3,371,15391,15762,1
E-Books|News|Publishing,850000.0,USA,3,4,618,15252,15870,1
Biotechnology,5685000.0,DNK,2,5,3129,12905,16034,0
Data Security|Market Research|Technology,15000000.0,USA,1,3,0,12066,12066,0
Business Productivity,6000000.0,USA,1,1,0,12430,12430,1
Cyber Security|Defense|Startups,1600000.0,ISR,1,2,0,14610,14610,0
Information Security|Network Security|Security|Testing,11000000.0,USA,2,3,496,16044,16540,0
Public Relations,20300000.0,USA,2,4,958,12784,13742,1
Health Care|Healthcare Services|Medical,2050000.0,USA,2,1,255,14103,14358,1
Analytics,1000000.0,USA,1,1,0,13964,13964,1
Software,282420.0,KOR,1,1,0,16087,16087,0
Enterprise Software,34000000.0,ESP,1,4,0,14031,14031,1
Manufacturing,276222.0,KOR,1,1,0,15959,15959,0
Mobile Social,200000.0,USA,1,1,0,16125,16125,0
Clean Technology|Consumer Electronics|Retail,16084744.0,IRL,2,2,1520,14727,16247,0
Consumer Internet|Financial Services|FinTech,46300000.0,BRA,3,9,697,15891,16588,0
Games|iPhone|Social Games,13000000.0,SGP,1,1,0,15259,15259,0
Enterprise Software,4673293.0,ESP,5,9,1164,15279,16443,0
Coupons|CRM|Online Scheduling|Payments,167258.0,ESP,1,2,0,15988,15988,0
Big Data|Business Intelligence|Predictive Analytics,494561.0,ARG,2,3,457,15918,16375,0
Cloud Computing,542000.0,ARG,2,3,365,16010,16375,0
Content|Media|News,640000.0,MEX,2,2,90,16071,16161,0
Biotechnology,67529448.0,GBR,2,5,863,15307,16170,0
Biotechnology|Health Care|Medical,49200000.0,USA,1,7,0,12571,12571,0
Consumer Electronics,3370000.0,USA,1,4,0,16721,16721,0
Apps,500000.0,IND,1,2,0,16434,16434,0
Advertising|Analytics,3300000.0,USA,2,4,306,13604,13910,1
Technology,20000000.0,USA,1,5,0,11477,11477,1
Hardware|Mobile|Semiconductors|Wireless,3500000.0,USA,1,4,0,16364,16364,0
Entertainment|Games|Music|Social Media,2000000.0,SWE,1,3,0,16040,16040,0
E-Commerce|FinTech|Mobile Commerce,135000.0,USA,1,1,0,15918,15918,0
Fitness|Health and Wellness|Personal Health|Training,152686.0,GBR,1,4,0,16594,16594,0
Health and Wellness,15000000.0,USA,2,2,465,16080,16545,0
Clean Technology|Gas|Oil|Transportation,65000000.0,USA,1,1,0,15077,15077,1
Biotechnology,28880900.0,DNK,2,7,3175,12335,15510,0
Analytics,2250000.0,USA,1,1,0,15467,15467,0
Games|Video on Demand|Video Streaming,70000.0,MEX,2,2,527,15262,15789,0
Biotechnology,18679995.0,USA,4,7,4055,12284,16339,0
Manufacturing,600000.0,USA,1,1,0,15765,15765,0
Real Estate|SaaS,187500.0,USA,2,1,77,15993,16070,0
Software,1600000.0,USA,1,9,0,15965,15965,0
EdTech|Education|K-12 Education|Software,920000.0,SWE,1,1,0,16520,16520,0
Curated Web|Shopping|Social Media,2000000.0,GBR,2,5,1285,14868,16153,0
Hardware + Software,67550000.0,GBR,5,24,3166,12996,16162,0
Enterprise Software,206800.0,USA,3,1,317,14921,15238,1
Biotechnology,5548097.0,USA,10,8,2099,14396,16495,0
Telecommunications|Wireless,120000.0,USA,1,1,0,16436,16436,0
B2B|Cloud Computing|Enterprises|Logistics|Manufacturing|SaaS|Software|Supply Chain Management,8207000.0,CAN,3,5,2080,14271,16351,0
Event Management|Innovation Management|Startups,4444089.01183259,FRA,2,1,161,16547,16708,0
Software,5653146.71998477,FRA,1,4,0,13203,13203,0
Analytics,27272300.0,DEU,4,7,1952,13431,15383,0
Fashion,40000.0,USA,1,1,0,16223,16223,0
Web Hosting,8340000.0,NOR,2,4,1055,14489,15544,0
Nanotechnology,6407071.0,USA,3,1,576,15868,16444,0
Big Data|Opinions|Sports,775000.0,USA,2,12,213,15131,15344,1
E-Commerce|Mobile Payments,10000000.0,IND,1,1,0,16440,16440,0
Data Visualization|Graphics|Software,65991.0,BGR,2,2,92,15826,15918,0
Biotechnology,2175000.0,USA,2,2,295,15181,15476,0
Enterprise Software,31100000.0,USA,3,2,1385,15371,16756,0
Games|Virtual Worlds,1000000.0,USA,1,1,0,13986,13986,0
Biotechnology,5500000.0,USA,2,7,782,15882,16664,0
Biotechnology,13740487.0,USA,2,4,1923,14304,16227,0
Analytics|Corporate IT|IT Management,60500000.0,USA,3,12,750,15980,16730,0
Apps|Social Media,700000.0,USA,1,6,0,16344,16344,0
Biotechnology,5782738.0,USA,3,4,2178,13593,15771,0
Information Technology,4760000.0,SGP,1,2,0,16654,16654,0
Hardware|Semiconductors,150000000.0,CHE,1,1,0,13969,13969,1
Mobile|Television,40000.0,USA,2,2,170,14832,15002,0
Databases|Enterprise Software,37677945.0,USA,5,14,1584,14927,16511,0
Health Care|Medical,17000000.0,CHN,1,1,0,13879,13879,0
Biotechnology,48050000.0,USA,4,9,1119,13714,14833,0
B2B|E-Commerce|Fashion|Internet|Marketplaces|SaaS|Wholesale,13900000.0,USA,3,17,853,15614,16467,0
Clean Technology,40000.0,CHL,1,1,0,15407,15407,0
Biotechnology|Healthcare Services,93062500.0,USA,5,9,2233,13403,15636,1
Developer APIs|Enterprise Software|Information Technology,10000000.0,USA,1,3,0,11416,11416,0
Computers|Enterprise Search|Software,5000000.0,USA,1,1,0,15805,15805,0
Biotechnology,9500000.0,USA,1,4,0,12684,12684,0
Health Care Information Technology|Hospitals|Medical Devices|Mobile|Mobile Health|Physicians,1524000.0,USA,1,5,0,16463,16463,0
Social Media|Virtual Worlds,25000000.0,KOR,2,8,267,13991,14258,0
Bioinformatics|Biotechnology|Data Mining,3328660.0,IRL,2,3,564,16171,16735,0
Biotechnology,28200000.0,USA,2,4,735,15477,16212,0
Computers|Messaging|Network Security,2000000.0,USA,1,2,0,16730,16730,0
Home & Garden|Real Estate|Search,4343800.0,ESP,3,2,851,13879,14730,0
Biotechnology,16236400.0,CHN,2,3,822,15218,16040,0
Health Care,149615.0,FIN,2,2,181,15762,15943,0
Business Analytics|Health Care|Hospitals|SaaS,1160000.0,USA,1,1,0,16608,16608,0
Consumers,248692.0,GBR,2,1,174,16267,16441,0
Consumer Goods|Hospitality,1516111.0,USA,3,3,1598,14963,16561,0
Charity|Non Profit|Underserved Children,600000.0,USA,9,8,2192,13910,16102,0
Software|Virtual Worlds,2000000.0,USA,1,1,0,16443,16443,0
Clean Technology,2649900.0,USA,1,1,0,13969,13969,0
Health Care,30479384.0,USA,7,17,1362,14505,15867,0
Biotechnology|Manufacturing|Medical,13983353.0,USA,5,10,1076,15492,16568,0
Consumer Electronics|Hardware + Software|Security,1725000.0,USA,3,1,340,16066,16406,0
Semiconductors,8100000.0,USA,2,3,555,14132,14687,1
Enterprise Software|Storage|Virtualization,312200000.0,USA,5,17,1226,15083,16309,0
Software,1630257.58069775,USA,1,1,0,13790,13790,1
Food Processing,21000000.0,USA,1,1,0,16557,16557,0
Finance|Investment Management|Personal Finance|Wealth Management,37322729.0,GBR,2,8,737,15509,16246,0
Curated Web,40000.0,USA,1,1,0,15859,15859,0
Software,4000000.0,USA,1,1,0,16001,16001,0
Biotechnology,12500000.0,USA,1,2,0,16075,16075,0
Hospitality,750000.0,USA,1,1,0,13574,13574,0
Health and Wellness|Mobile Health|Nutrition,109057.0,ITA,1,1,0,16653,16653,0
Pharmaceuticals,13000000.0,ISR,2,3,3456,12956,16412,0
Food Processing,12700000.0,USA,1,4,0,16296,16296,0
Health and Wellness,300000.0,USA,1,1,0,12041,12041,1
Fitness|Health and Wellness|Hospitality|Nutrition,19615.0,IRL,1,1,0,15762,15762,0
Email|Software,807260.0,USA,3,3,174,14236,14410,1
Health Care|Medical Devices,4082854.0,ESP,1,4,0,16220,16220,0
Cloud Computing|Internet of Things|Security,12944192.0,USA,5,8,633,15909,16542,0
Clean Energy|Clean Technology|Lighting,47400000.0,USA,6,22,3192,13032,16224,1
Human Resources|Software,7100000.0,USA,2,2,430,14340,14770,1
Biotechnology,590000.0,GBR,1,1,0,16647,16647,0
Information Technology,2000000.0,USA,1,2,0,16757,16757,0
Clean Technology,17459444.0,USA,2,1,574,14617,15191,1
Games,48700000.0,USA,2,3,1117,14463,15580,0
Public Relations,165500000.0,USA,2,16,326,11589,11915,1
Hardware + Software,4000000.0,CAN,1,1,0,16017,16017,0
Mobile Health|PaaS|SaaS,780058.0,GBR,3,2,182,16405,16587,0
Application Platforms|Document Management|Enterprises|Enterprise Software|Open Source|Software,9860740.0,USA,4,3,2203,13757,15960,0
News,5100000.0,USA,4,45,1099,15659,16758,0
3D Printing|3D Technology|Education,2000000.0,USA,1,2,0,16476,16476,0
Enterprise Software,41000000.0,CHN,2,3,731,13361,14092,0
Developer Tools|Software|Web Tools,75000.0,USA,2,5,0,16191,16191,0
Software|Storage,7650097.0,USA,2,2,215,14959,15174,1
Hardware + Software,25000000.0,USA,2,1,585,14245,14830,1
Biotechnology|Clinical Trials|Life Sciences|Nanotechnology,1116749.0,USA,2,2,28,16119,16147,0
Biotechnology,4279999.0,USA,2,1,443,15377,15820,0
Design|Event Management|Events,1000000.0,USA,2,11,176,16300,16476,0
Machine Learning|Navigation|Software,1121650.0,IRL,3,6,947,15340,16287,0
Human Resources|Internet|Marketplaces,1503703.0,AUS,2,1,183,16192,16375,0
Accounting|Finance Technology|Financial Services|FinTech,12091463.0,USA,7,3,1953,14711,16664,0
Hardware|Networking|Software,100000.0,GBR,1,1,0,16730,16730,0
FreetoPlay Gaming|Game|Games|Video Games,9000000.0,USA,2,13,435,15614,16049,0
Public Relations,792768.0,GBR,1,1,0,15439,15439,0
Energy|Services|Utilities,20000000.0,USA,2,4,686,11555,12241,0
Mobile,2319000.0,USA,4,1,830,15733,16563,0
Software,2980000.0,AUT,1,1,0,14533,14533,0
Software,22300000.0,IND,2,4,667,15950,16617,0
Health Care,86600000.0,USA,3,4,1521,15251,16772,0
Manufacturing,25000000.0,CAN,1,8,0,11477,11477,0
Photography,2299586.0,GBR,3,8,1277,13149,14426,0
Fashion,12900000.0,IND,2,2,459,16254,16713,0
Application Platforms|Communications Infrastructure|Financial Services,5000000.0,LUX,1,2,0,14909,14909,0
Biotechnology,550000.0,USA,1,1,0,14386,14386,0
Computers,10000000.0,ISR,1,1,0,16484,16484,0
Healthcare Services,9000000.0,USA,1,2,0,16488,16488,0
Hardware + Software|Wearables,1800000.0,USA,2,2,825,15205,16030,0
Gambling|Games|Online Gaming|Sports,7338551.8590998,SWE,1,1,0,14123,14123,0
Mobile,50390000.0,USA,2,1,21,15604,15625,0
Enterprise Software,1371634404.0,NLD,9,4,1784,14398,16182,0
Software,20250000.0,USA,2,1,629,14391,15020,1
Health Care|Hospitals,40000000.0,USA,1,2,0,16505,16505,0
Recycling|Renewable Energies|Waste Management,30000000.0,USA,1,1,0,12146,12146,1
Cyber Security|Data Security|Fraud Detection,28000000.0,USA,2,2,312,13130,13442,1
Finance|Technology|Trading,117000000.0,CAN,2,7,746,13027,13773,0
Finance|Financial Services|Publishing,125000.0,USA,2,1,108,16318,16426,0
Biotechnology,19198952.0,SWE,2,1,1919,14812,16731,0
Software,3928230.0,USA,3,2,294,15146,15440,0
Mobile,8000000.0,USA,1,2,0,13105,13105,0
Clean Technology,13500000.0,USA,3,2,1022,15218,16240,0
Software,12500000.0,USA,1,2,0,13262,13262,1
Delivery|Hospitality,58573491.0,USA,3,1,1525,14740,16265,1
Software,10100000.0,USA,1,3,0,13207,13207,0
Augmented Reality|Google Glass|Health Care|Mobile Health|Video Conferencing|Wearables,60000.0,USA,3,3,234,16437,16671,0
Health Care,68899998.0,USA,6,2,1024,15425,16449,0
E-Commerce|Fashion,1500000.0,USA,1,1,0,15156,15156,0
Energy|Fuels|Oil & Gas,205155.0,USA,1,1,0,14868,14868,0
Games,36000000.0,USA,2,2,765,14158,14923,1
Hardware|Software|Technology,119000.0,ESP,1,2,0,13514,13514,0
Commercial Real Estate|Finance,245000.0,USA,2,1,369,15675,16044,0
Finance,4700610.0,GBR,1,2,0,16391,16391,0
Finance|Technology,100000.0,USA,1,2,0,16013,16013,0
Software,496000.0,GBR,1,1,0,13635,13635,0
Software,9400008.0,USA,2,4,3116,11382,14498,1
Analytics|Big Data|Software,9000000.0,USA,4,11,972,14932,15904,1
Cloud Computing|Cloud Infrastructure|Databases|Software,8000000.0,USA,2,10,519,15095,15614,0
Software,46750000.0,USA,3,9,2223,12769,14992,0
Software,6500000.0,CAN,1,4,0,13192,13192,1
Software,9000000.0,USA,1,4,0,12502,12502,1
Hardware|Hardware + Software|Software,8800000.0,USA,2,5,1303,13853,15156,0
Health Care,2300000.0,USA,1,5,0,16280,16280,0
Mobile,144760181.0,USA,6,21,1965,13215,15180,0
Security,2450000.0,USA,1,2,0,16220,16220,0
Cloud Security|Data Security|IT and Cybersecurity,20000000.0,USA,1,1,0,16048,16048,0
Advertising|Analytics|Big Data|Enterprise Software|Information Technology|Mobile Analytics|Sales and Marketing,6500000.0,USA,1,3,0,16525,16525,0
Biotechnology,92936960.0,CHE,2,7,816,15946,16762,0
Information Technology|Investment Management|Portals,16249.0,CAN,1,1,0,16635,16635,0
Software,150000.0,USA,2,3,50,15095,15145,0
Curated Web,2000000.0,USA,1,2,0,15405,15405,0
Computer Vision|Consumer Goods|Machine Learning|Mobile|New Product Development,150000.0,GBR,2,2,18,16084,16102,0
Advertising,669602.0,BRA,4,3,1856,14488,16344,0
E-Commerce,14394888.0,GBR,1,2,0,15890,15890,0
Storage|Web Hosting,34300000.0,USA,3,5,992,13579,14571,1
Biotechnology,10000000.0,USA,1,1,0,16666,16666,1
E-Commerce|Online Reservations|Software,250000.0,USA,2,1,542,15796,16338,0
Photography|Software,21015000.0,USA,4,7,2645,14000,16645,0
Manufacturing,21649500.0,SWE,1,1,0,15210,15210,0
Bio-Pharm|Medical|Therapeutics,5223274.0,AUS,1,3,0,16573,16573,0
Music,10000000.0,SGP,2,3,396,13208,13604,0
Business Services|Internet|Marketplaces,93808.0,CAN,1,1,0,16252,16252,0
Advertising|Digital Signage,11597927.0,GBR,1,1,0,14012,14012,0
Clean Technology|Energy,65643735.0,USA,2,1,1699,14549,16248,1
Clean Technology,15000000.0,USA,2,1,1085,14862,15947,0
Nonprofits,3040000.0,USA,2,2,101,16121,16222,0
Education|Enterprise Software|Software,38924.0,NZL,1,1,0,16436,16436,0
Health and Wellness,17000000.0,USA,1,1,0,15734,15734,0
Social Media,1000000.0,JPN,1,5,0,15322,15322,0
Consumer Goods|Health Care,1700000.0,USA,1,6,0,16021,16021,0
Customer Service|E-Commerce|Retail,540000.0,USA,2,1,0,16071,16071,0
Health and Wellness,13115.0,DEU,1,2,0,14944,14944,0
Biotechnology,49500150.0,USA,3,10,1221,15429,16650,1
Mobile|Social Media|Social Network Media|Video,1650000.0,USA,1,3,0,16385,16385,0
Software,1178736.0,GBR,1,1,0,13543,13543,0
Biotechnology|Health Diagnostics,8000000.0,USA,1,2,0,14992,14992,0
Curated Web|Home & Garden|Hotels|Property Management|Real Estate,1600000.0,NOR,3,3,610,14669,15279,0
Analytics|Consulting|Enterprise Software|SaaS,10000000.0,USA,1,1,0,13543,13543,1
Analytics|CRM|E-Commerce|Local|SaaS|Small and Medium Businesses|Web Development,1210000.0,USA,2,2,579,15432,16011,0
Medical|Service Providers|Services,6368603.0,USA,5,4,1277,15310,16587,0
Outsourcing|Pharmaceuticals|Technology,3800000.0,USA,1,2,0,12090,12090,1
Financial Services|Software,3565000.0,USA,4,4,328,16080,16408,0
Automotive|Cars|Curated Web|Social Network Media,40000.0,USA,1,1,0,15180,15180,0
Semiconductor Manufacturing Equipment,11500000.0,CAN,1,1,0,11730,11730,0
Audio|Telecommunications|Video Conferencing,17000000.0,USA,1,4,0,11645,11645,1
Software,15000000.0,USA,2,5,861,12935,13796,0
E-Commerce,6169665.0,CHN,1,1,0,15126,15126,0
Analytics|Brand Marketing|Online Video Advertising,1200000.0,FRA,1,7,0,16722,16722,0
Cloud Management|Consumer Electronics|Curated Web|Mobile|PaaS|SaaS|Software,170000.0,USA,2,2,92,16344,16436,0
Search,374999.0,USA,2,9,434,13577,14011,0
Mobile|Mobile Devices|Mobile Payments,143079.0,FRA,1,1,0,15187,15187,0
Medical|Pharmaceuticals|Service Providers,23850000.0,NLD,1,3,0,12803,12803,0
Software,2500000.0,USA,1,1,0,16625,16625,0
Information Technology,559018.3637532489,ITA,1,4,0,16709,16709,0
Consulting,150000.0,USA,1,1,0,15527,15527,0
Hardware + Software,4840000.0,DNK,1,1,0,14771,14771,1
Health Care|Health Care Information Technology|Healthcare Services|mHealth,180000.0,USA,2,3,61,16191,16252,0
Online Gaming,15000000.0,IND,1,1,0,16225,16225,0
Intelligent Systems|Project Management|Systems,5000000.0,USA,1,1,0,12129,12129,0
Biotechnology,73300000.0,USA,6,9,1447,14419,15866,1
Biotechnology,32305473.0,USA,4,2,671,15474,16145,1
Automotive|Drones|Robotics|Sensors,3400000.0,USA,1,8,0,16443,16443,0
Cyber|Mobile Security|Security,1414665.0,USA,3,2,1327,13829,15156,0
Consumer Electronics|Hardware + Software|Video Games|Virtualization|Wearables,93400000.0,USA,3,9,498,15553,16051,1
Cloud Computing|Cloud Management|IT Management,2500000.0,USA,2,2,432,16261,16693,0
Advanced Materials|Material Science,848882.0,GBR,1,3,0,16238,16238,0
Advertising,4000000.0,USA,1,2,0,13312,13312,0
Games|Mobile Games|Social Games|Sports,983788.0,GBR,2,4,548,15309,15857,0
Information Technology,2800000.0,USA,1,1,0,16332,16332,0
Analytics|Social Media|Social Media Monitoring,159000.0,GBR,2,3,153,15218,15371,0
Health Care|Social Media|Software,3060000.0,USA,2,1,253,14995,15248,0
News|Television|Video Streaming,3562743.0,USA,2,2,79,16082,16161,0
Chemicals|Design|Manufacturing|Test and Measurement,4020000.0,CAN,1,3,0,13921,13921,0
Digital Signage|Sales and Marketing|Software,20000000.0,ISR,1,2,0,14037,14037,1
Aerospace|Travel,1759579.0,GBR,1,1,0,16314,16314,0
Logistics|Supply Chain Management|Technology,24300000.0,USA,1,4,0,12302,12302,0
Biotechnology,6300000.0,USA,2,3,1065,14685,15750,0
Software|Technology,56130000.0,ESP,1,7,0,14061,14061,0
E-Commerce|Local,180000.0,SVN,1,1,0,15492,15492,0
Travel,3250000.0,USA,2,2,171,14732,14903,1
Clean Technology,55000000.0,TAN,4,9,580,16150,16730,0
Manufacturing,98347.0,NLD,1,1,0,15377,15377,0
Digital Media|Mobile|Travel,700000.0,USA,2,7,885,15160,16045,0
Industrial|Real Estate|Retail|Storage,143140.0,FRA,1,1,0,14488,14488,0
Babies|E-Commerce|Gift Card|Internet|Kids|Toys,300000.0,ESP,1,1,0,16689,16689,0
Crowdfunding|Finance|Financial Services|FinTech|Security,1250000.0,USA,1,2,0,15873,15873,0
Software,40000.0,USA,1,2,0,15949,15949,0
Analytics|Artificial Intelligence|Big Data|E-Commerce|Hospitality|Hotels|Machine Learning|Online Reservations|Personalization|Travel,118956.0,GRC,1,2,0,15949,15949,0
Advertising|Discounts|Promotional|Public Relations,120000.0,USA,1,2,0,13879,13879,0
Credit Cards|Curated Web|Discounts,4500000.0,USA,2,6,98,14944,15042,0
Software,7000000.0,USA,1,1,0,13046,13046,1
Advertising,1000000.0,USA,1,1,0,15006,15006,1
Analytics|Contests|Curated Web|Enterprise Software|Internet Marketing|SaaS|Social Commerce|Social Media|Social Media Marketing,24548791.0,USA,4,13,1321,14902,16223,0
Advertising|Coupons|Curated Web|Discounts|E-Commerce|Mobile Commerce|Performance Marketing|Retail,7000000.0,USA,1,1,0,14904,14904,0
Advertising|Artificial Intelligence|Curated Web|Discounts|E-Commerce|Incentives|Loyalty Programs|Natural Language Processing|Social Commerce,1300000.0,USA,4,7,216,16001,16217,0
E-Commerce|Hotels|Restaurants,2000000.0,ESP,1,2,0,15071,15071,0
Classifieds|Mobile,88800000.0,USA,2,10,231,16512,16743,0
B2B|Gamification|Human Resources,1000000.0,CAN,1,1,0,16526,16526,0
Music,170604000.0,GBR,1,4,0,14445,14445,0
Local Advertising|Social + Mobile + Local|Software,547500.0,USA,4,1,962,15579,16541,0
Augmented Reality|Games|Software|Virtualization,32082.0,AUS,1,1,0,16573,16573,0
Food Processing,800000.0,MYS,1,1,0,16608,16608,0
B2B|E-Commerce,441276.0,COL,1,1,0,16297,16297,0
Web Hosting,3890000.0,AUS,1,1,0,14307,14307,0
Collaboration|Curated Web|Freelancers|Project Management|Small and Medium Businesses|Task Management,250000.0,USA,1,1,0,14276,14276,0
Advertising,2000000.0,USA,1,3,0,14840,14840,1
Clean Energy|Clean Technology|Manufacturing|Renewable Energies,89500000.0,USA,3,4,1430,14628,16058,0
E-Commerce|Payments,500000.0,BEL,2,2,3789,10957,14746,1
Interest Graph|Location Based Services|Social Media,1400000.0,RUS,2,2,919,14311,15230,0
Games,1500000.0,USA,2,7,626,13451,14077,0
Apps|Entertainment|Games,4000000.0,FRA,1,2,0,16254,16254,0
E-Commerce,13670000.0,JPN,3,5,961,15323,16284,0
Game|Games,6000000.0,USA,1,2,0,14245,14245,0
Cloud Computing|Data Security|Enterprise Software,1500000.0,USA,2,1,1159,14641,15800,0
Android|iPhone|Mobile|Sports,100000.0,USA,1,1,0,15218,15218,0
Governments|Politics|Public Relations|Social Media|Visualization,1664000.0,USA,10,7,1202,14745,15947,0
Education|Online Education|Project Management,227028.0,ITA,1,1,0,16478,16478,0
EdTech|Education,615000.0,USA,4,9,554,15539,16093,0
Biotechnology,20500000.0,CHE,1,2,0,14866,14866,1
E-Commerce,100068430.0,CHN,5,6,1155,13879,15034,0
Bitcoin|E-Commerce|Finance|FinTech|Virtual Currency,10000000.0,CHN,1,4,0,16145,16145,0
Curated Web|Online Dating,6000000.0,USA,1,2,0,13530,13530,1
Biotechnology|Medical|Non Profit,14500000.0,USA,1,1,0,16303,16303,0
Enterprise Software,230000000.0,USA,8,35,2197,14489,16686,0
Hardware + Software,880530.0,FRA,1,1,0,14796,14796,0
Hospitality,31000000.0,USA,5,16,1598,14914,16512,0
B2B|SaaS|Social Media|Social Media Marketing|Software,800000.0,ISR,1,2,0,16016,16016,0
Hospitality,8900000.0,BAH,1,1,0,16149,16149,0
Content|Crowdsourcing|Curated Web|E-Commerce|Photography|Photo Sharing|Retail|SaaS|Shopping|Video,21000000.0,USA,4,19,1376,15233,16609,0
Software,4000000.0,KOR,1,3,0,13522,13522,1
Software,5462100.0,FRA,1,1,0,15636,15636,1
Manufacturing,12660000.0,GBR,2,8,302,12996,13298,0
Hospitality|Hotels|Reputation|Social Media,1000000.0,NLD,2,1,362,15366,15728,0
Biotechnology,6500000.0,USA,4,4,1087,15453,16540,0
Consumer Electronics|Consumer Goods|Fashion|Lifestyle|Wearables,14100000.0,USA,3,10,429,16217,16646,0
Analytics|Software,24000000.0,ISR,2,4,916,13264,14180,0
Software,14000000.0,USA,2,3,549,13093,13642,0
Fashion,5639861.0,GBR,1,1,0,16503,16503,0
E-Commerce|Restaurants|Technology,23250000.0,USA,4,12,3583,12784,16367,0
Interest Graph|Social Media|Social Network Media,3175000.0,USA,2,6,1216,14610,15826,0
Big Data|Online Travel|Personalization|Software|Travel,1715000.0,USA,4,28,221,15985,16206,0
Curated Web|E-Commerce|Internet|Shopping,28500000.0,USA,4,14,1090,13757,14847,0
Food Processing,5984297.0,FRA,1,2,0,16440,16440,0
Advertising|Media|Technology,8000000.0,USA,6,3,603,16005,16608,0
Advertising,25000.0,ARG,1,1,0,15553,15553,0
Information Technology|IT Management|Services,24901173.0,DNK,2,8,1424,15143,16567,0
EdTech|Education|Health and Wellness,76520000.0,USA,6,30,1599,15095,16694,0
Software,700000.0,USA,1,1,0,16581,16581,0
Information Services|News|Sports,5500000.0,USA,1,1,0,15922,15922,0
Curated Web,10000000.0,USA,3,20,1087,15544,16631,0
Internet of Things|M2M|Mobile|Software|Telecommunications,501460.0,USA,3,1,760,15817,16577,0
Mobile,185000.0,USA,2,4,381,15414,15795,0
Diagnostics|Manufacturing|Medical,6061005.0,GBR,1,1,0,15849,15849,0
Fitness|Health and Wellness|Mobile|Mobile Health,3454037.0,FIN,2,2,436,15431,15867,0
Health Care|Medical|Therapeutics,6579017.0,DEU,2,5,878,15662,16540,0
Software,15800000.0,ISR,4,3,1478,13894,15372,1
Advertising|Consulting|Contact Management|CRM|Ticketing,43833.0,GBR,1,1,0,14245,14245,0
Biotechnology|Health Care,141800000.0,USA,4,11,2625,13524,16149,1
Analytics|E-Commerce|Marketing Automation|SaaS,4877166.59750827,GBR,4,23,969,15737,16706,0
Hardware + Software,1230400.0,USA,2,1,1588,12825,14413,0
Auctions|Games|Online Dating,16600000.0,USA,5,17,1618,13362,14980,1
Big Data|Health Care,6800000.0,USA,1,5,0,16076,16076,0
Media|News|Social Media|Video,450000.0,USA,2,1,682,15949,16631,0
Mobile Payments|Payments,2900000.0,THA,4,10,451,16300,16751,0
Health Diagnostics,1500000.0,GBR,1,3,0,16758,16758,0
Games,10500000.0,USA,1,8,0,12524,12524,1
Consumer Electronics|Robotics,19500000.0,USA,1,1,0,12053,12053,0
Public Transportation,53492000.0,PRT,1,1,0,15302,15302,0
Biotechnology,9800000.0,IND,1,1,0,15924,15924,0
Hardware + Software,23000000.0,USA,2,2,947,14284,15231,0
Big Data|Retail Technology|SaaS|Semantic Search,1727500.0,USA,2,1,192,16405,16597,0
Clean Technology,25450981.0,USA,7,2,1307,15126,16433,0
Analytics|Big Data Analytics|Cloud Data Services,6800000.0,USA,2,4,435,15706,16141,0
Social Media|Systems,750000.0,USA,2,1,227,15051,15278,0
File Sharing|Internet|Storage|Web Hosting,800000.0,USA,1,3,0,13483,13483,0
Games,2000000.0,ESP,1,3,0,16134,16134,0
Analytics|Geospatial|Location Based Services|SaaS,5000000.0,USA,3,2,441,16119,16560,0
Clean Technology,532987.0,PRT,1,1,0,16149,16149,0
Clean Technology,80587143.0,USA,6,10,1974,14000,15974,0
E-Commerce,100000.0,IND,1,2,0,16633,16633,0
Software,3960000.0,FRA,1,1,0,12860,12860,1
Hardware + Software,27500000.0,USA,1,1,0,16169,16169,0
Hardware + Software,12209831.0,USA,2,1,1894,13539,15433,1
Biotechnology,15403710.0,USA,3,1,428,15924,16352,0
Mobile|Productivity Software,109381.0,ROM,1,1,0,16252,16252,0
Energy|Solar,5000000.0,USA,1,5,0,14060,14060,0
Search,120000.0,USA,1,1,0,16405,16405,0
Clean Technology,5320000.0,GBR,1,1,0,14132,14132,0
Software,110000000.0,USA,2,5,133,10987,11120,0
Education|Fitness|Health Care|Medical,15000.0,USA,1,3,0,15492,15492,0
Medical,63000000.0,USA,2,9,1378,12335,13713,0
Brand Marketing|CRM|Lifestyle|Specialty Retail,28000.0,HKG,1,1,0,15737,15737,0
Advertising|Software,79350000.0,USA,4,6,1722,12551,14273,1
Services,4000000.0,USA,1,3,0,12230,12230,0
Payments|Startups,1500000.0,USA,1,1,0,16336,16336,0
Enterprise Software,14723272.8514564,GBR,3,5,3342,12937,16279,0
Biotechnology|Health and Wellness|Life Sciences|Medical,4840000.0,ISR,1,1,0,12873,12873,1
Hardware + Software,14500000.0,CAN,3,15,820,15861,16681,0
Biotechnology|Health and Wellness|Medical|Pharmaceuticals,60158333.0,USA,4,3,1189,14575,15764,1
Credit|Finance|FinTech,538000000.0,USA,11,37,2986,13149,16135,1
Employer Benefits Programs|Health and Wellness|Health Care|Mobile Health,50000.0,USA,1,1,0,16451,16451,0
Biotechnology,3754369.0,USA,3,1,673,14469,15142,0
Market Research|Mobile,467389.0,GBR,1,1,0,14944,14944,0
Biotechnology,31000000.0,USA,2,8,806,14592,15398,0
Communications Infrastructure|Internet of Things|Mobile|Smart Grid|Wireless,123584454.0,USA,7,5,2182,14462,16644,0
Security,40000.0,BRA,1,1,0,16052,16052,0
Biotechnology,15000000.0,USA,1,2,0,16140,16140,0
Education|Online Education,7515.51013403912,BRA,1,1,0,16709,16709,0
Mobile,750000.0,USA,1,3,0,15356,15356,0
Content|SaaS|Software|Video,5240000.0,USA,1,2,0,12793,12793,1
Business Services|Curated Web|Lead Generation|Video Streaming|Web Tools,11300000.0,USA,2,6,1455,12551,14006,0
Cloud Computing|Cloud Management|Content Delivery|IaaS|Infrastructure|Networking|Storage|Video Streaming|Web Hosting,20000000.0,GBR,1,1,0,15721,15721,0
Security,29600000.0,USA,3,16,2448,14245,16693,0
Art|Crowdfunding|Curated Web|Digital Media|Life Sciences|Publishing,10000.0,USA,1,1,0,16071,16071,0
Software|Storage,17750000.0,USA,2,4,1346,12535,13881,1
Enterprise Software,6000000.0,USA,1,1,0,15082,15082,0
Mobile,13000000.0,USA,2,5,268,15095,15363,1
Human Resources|Recruiting,3300000.0,USA,1,22,0,16573,16573,0
Apps,3500000.0,GBR,1,1,0,16625,16625,0
Agriculture|Productivity|Sustainability,6452000.0,USA,3,3,964,15035,15999,0
Bio-Pharm,31000000.0,USA,2,9,64,16643,16707,0
Biotechnology,19000000.0,CHE,1,4,0,15894,15894,1
Biotechnology,3100000.0,USA,2,6,763,15188,15951,0
Biotechnology,21500000.0,USA,2,4,2259,12354,14613,1
Biotechnology,3450000.0,USA,3,8,547,14975,15522,0
Pharmaceuticals,929681.119376054,DNK,1,1,0,16566,16566,0
Biotechnology,24000000.0,CAN,1,2,0,14910,14910,1
Biotechnology|Health Care,196249996.0,USA,3,9,1858,14187,16045,1
Biotechnology,14400000.0,USA,4,1,1231,15079,16310,0
Politics,6840000.0,CAN,1,1,0,13949,13949,0
Analytics|Collaboration|Data Integration|Data Visualization|Enterprise Software|Predictive Analytics,4623209.0,USA,3,5,633,16080,16713,0
Biotechnology,5500000.0,FIN,1,1,0,14729,14729,0
Health Care,67263000.0,USA,5,1,1439,15156,16595,1
Biotechnology|Health Care|Pharmaceuticals,64900000.0,USA,3,11,979,14876,15855,1
Health Care|Hospitals|Medical,12000000.0,USA,1,2,0,12240,12240,0
Clean Technology|Environmental Innovation|Nanotechnology|Oil and Gas|Water Purification,1000000.0,USA,1,1,0,15795,15795,0
Hardware + Software,8742387.0,USA,4,12,2163,12807,14970,0
Android|Apps|Contact Management|CRM|Direct Sales|Lead Management|Mobile|Networking|Sales Automation|Small and Medium Businesses,500000.0,USA,3,2,396,15706,16102,0
Big Data,1500000.0,USA,4,4,548,15623,16171,0
Advertising,30000000.0,ZAF,2,1,678,15876,16554,0
Online Gaming,7500000.0,SGP,1,1,0,16636,16636,0
Clean Technology,40000.0,CHL,1,1,0,15194,15194,0
Health Diagnostics|Search,120000.0,USA,1,2,0,16267,16267,0
Developer APIs,100000.0,GBR,2,2,458,15949,16407,0
E-Commerce Platforms,1000000.0,USA,2,2,1,15439,15440,0
Information Technology,16700000.0,USA,1,4,0,16316,16316,0
E-Commerce,4000000.0,USA,2,11,5,15554,15559,1
E-Commerce|Furniture|Home & Garden,225000000.0,USA,6,23,1699,14584,16283,0
Doctors|Health Care|Medical,116500000.0,USA,6,20,2663,13514,16177,0
EdTech|Education,2684000.0,USA,4,22,849,15826,16675,0
Sales and Marketing,750000.0,USA,1,2,0,16225,16225,0
Advertising|Mobile|Web Design,1200000.0,USA,2,3,510,15420,15930,0
All Markets|Sports,3750000.0,USA,2,2,751,13514,14265,0
Apps|Mobile Software Tools,2000000.0,USA,1,4,0,16545,16545,0
Collaboration|Curated Web|Video,14000000.0,USA,2,4,939,13311,14250,0
Enterprises|Humanitarian|Internet|Nonprofits|Payments|Technology|Transaction Processing,1375000.0,USA,2,2,570,15614,16184,0
Mobile,585000000.0,IND,4,7,2271,14175,16446,0
Public Relations,9263147.0,FRA,1,4,0,12607,12607,0
SaaS|Security,9251000.0,IND,3,6,1468,15191,16659,0
Career Planning|Chat|Local|Mobile|Social Media,20000.0,USA,1,1,0,15218,15218,0
Consulting,3000000.0,IND,2,2,47,16051,16098,0
Consulting,750000.0,USA,1,1,0,15206,15206,0
Finance,163934.0,CHN,1,1,0,16040,16040,0
Digital Media|Entertainment|Video on Demand,12000000.0,USA,1,2,0,10927,10927,0
Semiconductors,64344698.0,CAN,4,4,1281,14320,15601,0
Information Services,198082.0,GBR,1,1,0,16102,16102,0
All Students|Education|Social Network Media|Universities,2281697.0,CAN,3,3,810,15189,15999,0
Advertising Platforms|Entertainment|News,1597014.0,TUR,2,2,537,15980,16517,0
Apps|Health Care,8000000.0,USA,1,5,0,16590,16590,0
Enterprise Software,1614202.0,GBR,1,1,0,14613,14613,1
Enterprise Software,5000000.0,USA,1,2,0,16357,16357,0
E-Commerce|Hotels|Services|Travel,80900000.0,GBR,4,14,1574,15041,16615,0
Curated Web|Marketplaces|Professional Services|Startups,4352000.0,AUS,3,4,757,15873,16630,0
Analytics|Big Data|Big Data Analytics|Information Technology|SaaS|Software|Technology,1050000.0,USA,3,3,103,16106,16209,0
App Stores|Enterprise Software|Finance|Internet|Twitter Applications,2345000.0,USA,4,23,215,14405,14620,1
Application Platforms|Banking|Business Services|Data Security|Developer APIs|Health and Insurance|Identity|Identity Management|Insurance|Insurance Companies|Mobile|Mobile Security|Mobile Software Tools|Online Identity|Travel,1588517.48957756,NLD,1,1,0,16769,16769,0
Curated Web,900000.0,USA,1,5,0,15947,15947,0
Business Services|Direct Sales|E-Commerce|Wine And Spirits,20000000.0,USA,5,40,2647,13970,16617,0
Collaboration|Document Management|Enterprise Software|File Sharing|Synchronization,3000000.0,USA,4,1,1924,13910,15834,0
Online Identity|Software,7000000.0,USA,1,2,0,15441,15441,0
Enterprise Software|Identity|Identity Management,42700000.0,USA,3,6,1636,14784,16420,0
Collaboration|Games|Legal|Music|Video,21189.0,AUT,1,1,0,15222,15222,0
CRM|Sales and Marketing|Video,28000.0,USA,1,1,0,16120,16120,0
Databases|Human Resources|Recruiting,118000.0,USA,1,1,0,16517,16517,0
Apps|E-Commerce|Logistics|Technology,775000.0,USA,3,3,228,16010,16238,0
Bitcoin|Identity,1445000.0,USA,2,3,123,16267,16390,0
Consulting,12800000.0,USA,1,1,0,12948,12948,1
CRM|Enterprise Software|Task Management,749000.0,IRL,2,1,184,15804,15988,0
B2B|Business Services|Curated Web|Design|Small and Medium Businesses|Web Development,365000.0,USA,2,3,249,15260,15509,0
Software,14965000.0,USA,7,3,2433,13671,16104,0
Software,45685.0,KOR,1,1,0,15832,15832,0
Brand Marketing|Market Research|Mobile Advertising|Public Relations,1070000.0,GBR,1,2,0,16735,16735,0
Game Mechanics|Health and Wellness|Health Care|Social Network Media,16000000.0,USA,2,2,979,14818,15797,1
Advertising|Apps|Brand Marketing|Real Time|Social Network Media|Twitter Applications,27300000.0,USA,3,11,1334,13149,14483,1
Clean Technology,195249815.0,USA,10,7,1328,15239,16567,1
Colleges|Education|Mobile,750000.0,USA,1,2,0,15364,15364,0
Travel,40000.0,USA,1,1,0,15539,15539,0
Information Technology|Insurance|SaaS,2500000.0,USA,2,2,1392,10957,12349,0
Curated Web,4700000.0,AUS,1,1,0,15981,15981,0
Enterprise Software,165000000.0,USA,2,2,835,15770,16605,0
Analytics,18000000.0,DEU,2,2,2564,12927,15491,0
Advertising|Content|Media|Publishing,11682151.0,USA,5,13,2874,13149,16023,0
E-Commerce,22450000.0,USA,2,2,1141,14166,15307,0
Email|Enterprises|Services,500000.0,JPN,1,1,0,16570,16570,0
Curated Web,1200000.0,USA,1,7,0,14853,14853,1
Software|Sports,2500000.0,USA,5,7,1442,15271,16713,0
Travel,37000000.0,GBR,4,4,1168,15590,16758,0
E-Commerce,2000000.0,USA,1,3,0,14416,14416,1
B2B|Crowdfunding|Curated Web|Entrepreneur|Finance|Finance Technology|Investment Management|Marketplaces|Social Network Media|Startups,5300000.0,USA,2,7,377,16267,16644,0
Technology,500000000.0,GBR,1,8,0,16612,16612,0
Hardware + Software,630000.0,USA,2,1,178,16098,16276,0
Communications Hardware|Manufacturing,20000000.0,USA,1,5,0,11241,11241,1
E-Commerce|Guides|Restaurants|Search,537691.0,ESP,5,5,641,15826,16467,0
Analytics|Farming|SaaS,1100000.0,USA,4,3,1187,15492,16679,0
Internet|Security|Software,5300000.0,GBR,4,12,930,15553,16483,0
Enterprise Software|Location Based Services|Logistics|Mobile|Navigation,2300000.0,USA,3,13,575,15971,16546,0
Consulting|Enterprise Software|Health Care|Hospitals|Software,4332943.0,USA,5,19,1504,14713,16217,1
Enterprise Software|Information Technology|Marketplaces|Professional Services|Services|Technology,26750000.0,USA,3,3,2121,13160,15281,1
SaaS|Security,1702200.0,LUX,2,4,117,14549,14666,0
News,12000000.0,USA,1,3,0,14881,14881,0
Health and Wellness,24250000.0,USA,7,10,2180,12290,14470,1
Internet of Things|Software|Wearables,385851.0,USA,2,1,489,16071,16560,0
Software,8195999.0,USA,6,5,1781,14295,16076,0
Design,95000000.0,USA,1,8,0,11540,11540,0
Biotechnology,20000000.0,USA,1,1,0,16084,16084,0
Education|Tutoring,500000.0,CAN,1,1,0,15908,15908,0
Health Diagnostics|Medical Devices,1750000.0,USA,3,1,839,15706,16545,0
E-Commerce,25000.0,RUS,1,1,0,16040,16040,0
E-Commerce,1000000.0,TUR,2,2,263,15959,16222,0
Music,2157896.0,USA,2,1,2230,13682,15912,0
E-Commerce,9000000.0,RUS,2,5,919,15349,16268,0
E-Commerce Platforms|EdTech|Education,750000.0,IND,1,5,0,16687,16687,0
Cloud Computing|Games,56500000.0,USA,3,8,1226,13787,15013,1
Games|Video,16000000.0,USA,2,5,365,13453,13818,0
Big Data|Big Data Analytics|Mobile Advertising,2000000.0,KOR,2,2,39,16336,16375,0
E-Commerce|Events|Meeting Software,569518.0,KOR,2,2,460,15618,16078,0
Photo Editing|Photography|Software,19000000.0,USA,3,6,1743,13035,14778,0
Mobile,8500000.0,USA,3,11,2640,11667,14307,0
CAD|Mobile|Software,144000000.0,USA,4,8,996,15706,16702,0
Health Care|SaaS|Software,14133008.0,USA,4,10,1615,14489,16104,0
Communications Infrastructure,70000000.0,USA,1,3,0,11122,11122,1
Web Hosting,96250000.0,USA,5,18,2534,11765,14299,1
Content Delivery|Curated Web,900000.0,USA,1,1,0,14876,14876,1
Advertising|Mobile,6000000.0,USA,3,21,353,14987,15340,1
Mobile,4500000.0,USA,2,5,1132,13462,14594,1
Messaging,880000.0,USA,1,2,0,15397,15397,1
Augmented Reality|Google Glass|Human Computer Interaction|Internet of Things|Mobile|Software|Wearables,3090852.0,USA,4,17,790,15965,16755,1
Android|Facebook Applications|iPhone|Journalism|Photography|Travel,210000.0,USA,1,1,0,13848,13848,0
Software,502500.0,USA,2,1,1051,14236,15287,0
Software,18000000.0,USA,1,4,0,13165,13165,1
Application Platforms|Service Providers|Travel,50000000.0,USA,1,1,0,11960,11960,0
Pharmaceuticals,29606625.0,FRA,2,9,731,12173,12904,0
Apps|Consumer Electronics|Internet|Online Shopping|Price Comparison|Reviews and Recommendations|Search,107474.10769622099,ESP,1,1,0,16542,16542,0
Biotechnology,14906222.0,GBR,1,5,0,13276,13276,0
Web Hosting,66273600.0,GBR,1,1,0,15267,15267,0
Clean Technology,3970000.0,GBR,1,2,0,13969,13969,0
Social Media,24621060.0,USA,5,12,3241,13269,16510,1
Advertising,35000.0,USA,2,2,110,15869,15979,0
Software,10790359.0,FRA,2,2,1226,13846,15072,0
Consumers|E-Commerce|Mobile,9000000.0,THA,2,2,583,15584,16167,0
Hardware + Software|Mobile|Peer-to-Peer|Social Media|VoIP,98432819.0,USA,9,24,3779,12784,16563,0
Big Data|Development Platforms|Games|Mobile|Social Games|Sports|Video Game Tournaments|Video Streaming,3615400.0,USA,5,4,1315,14897,16212,0
Elder Care|Leisure,490228.0,GBR,1,1,0,16052,16052,0
Journalism|Mobile|Software|Video,3098400.0,ESP,2,6,987,14743,15730,0
Artificial Intelligence|Coupons|Curated Web|Discounts|Mobile|Software,175000.0,ARG,2,2,243,14975,15218,0
E-Commerce,231588.0,EST,1,1,0,15978,15978,0
Mobile|Mobile Payments,30653.0,USA,1,1,0,15603,15603,0
Clean Technology,21470000.0,USA,5,12,2820,13293,16113,0
Business Services|Curated Web|Photography,245376.0,FRA,2,1,669,15675,16344,0
Advertising|Digital Signage|SaaS|Software,16390.0,SVN,1,1,0,16529,16529,0
Apps|Entertainment|Semantic Web,325000.0,USA,1,3,0,16258,16258,0
Analytics|Video|Video Streaming,122000000.0,USA,7,15,2385,13665,16050,1
Developer APIs|Enterprise Software|Finance|Search,120000.0,GBR,1,1,0,15888,15888,0
Networking|Open Source|Software,2907982.0,SWE,1,1,0,13389,13389,0
Enterprise Software|Software,10100000.0,USA,2,7,219,16127,16346,0
Biotechnology,6000000.0,AUS,1,4,0,13087,13087,0
Software,8500000.0,CAN,1,3,0,13118,13118,1
Mobile,16671599.0,USA,8,3,2001,14739,16740,0
Analytics|Big Data|Business Intelligence|Mobile|SaaS,20118.0,BRA,1,1,0,15396,15396,0
Health and Wellness,40000.0,USA,1,1,0,16077,16077,0
Security,3360000.0,NOR,1,2,0,13966,13966,0
Software,2800000.0,USA,3,7,440,15461,15901,0
Apps|E-Books|Education|iPad|Publishing,970000.0,USA,2,13,223,15310,15533,0
3D Printing|Information Technology|Robotics,120000.0,GBR,1,1,0,16622,16622,0
Software,363000.0,FRA,1,1,0,13167,13167,0
Consulting,22124106.0,GBR,2,1,107,16378,16485,0
Business Development|Software,500000.0,MYS,1,1,0,14549,14549,0
Software,8356070.0,GBR,2,2,1296,14333,15629,0
EdTech|Education,120250000.0,USA,5,8,898,14923,15821,0
Mobile|Peer-to-Peer|Wireless,12800000.0,USA,2,5,827,15595,16422,0
Kids|Security|Services,16880.0,GBR,1,1,0,16192,16192,0
Marketing Automation|Real Time|Trading,10000000.0,USA,1,4,0,11645,11645,1
Enterprises|Software,14264323.0,USA,6,4,1758,13769,15527,1
EdTech|Education|Software,1746599.0,AUS,2,2,183,16287,16470,0
Real Estate,1000000.0,USA,1,9,0,16735,16735,0
Automotive|Enterprise Software|Shipping|Software|Transportation,9000000.0,USA,2,3,394,15006,15400,1
Curated Web|Entertainment|Hotels|Reviews and Recommendations|Travel|Vacation Rentals,1100000.0,USA,5,12,888,13879,14767,0
Android|iPhone|Mobile|Mobile Software Tools,15000000.0,FRA,1,6,0,13424,13424,0
Advertising,19000000.0,USA,2,7,819,15117,15936,0
Semiconductors,25050000.0,USA,2,8,534,13053,13587,0
Business Services|Document Management|Technology,15931.0,SGP,1,1,0,16536,16536,0
Clean Energy|Internet of Things|Marketplaces|Peer-to-Peer,822248.0,GBR,2,4,490,15887,16377,0
Collaboration|Software|Virtual Workforces,37800000.0,DEU,3,6,2755,13149,15904,0
Real Estate|Technology,6927000.0,AUS,2,1,321,16294,16615,0
Software,16000000.0,USA,1,3,0,10957,10957,1
Enterprise Software|Open Source|Point of Sale,18034000.0,ESP,2,4,817,13168,13985,0
Architecture|Curated Web,2000000.0,BGR,1,2,0,15065,15065,0
Health Care|Software,1500000.0,USA,1,3,0,15946,15946,0
Curated Web|Local Search|Vertical Search,700000.0,USA,1,1,0,15126,15126,0
EdTech|Education|Training,2952989.59118585,FRA,2,2,650,15425,16075,0
Web Hosting,35161723.7608793,GBR,4,10,2472,13521,15993,0
Software,11000000.0,USA,1,4,0,12942,12942,0
Education|Exercise|Internet|K-12 Education|Teachers,40000.0,USA,2,1,228,15843,16071,0
Data Visualization|Developer APIs|SaaS|Software,1663976.0,FRA,1,1,0,16618,16618,0
E-Commerce,1492760.0,GBR,2,3,61,16161,16222,0
Games,543000.0,FRA,1,1,0,13157,13157,0
Security,51260000.0,USA,5,17,3116,13088,16204,1
Real Estate,29950000.0,USA,2,43,234,16258,16492,0
Property Management|Real Estate|Rental Housing,13000.0,RUS,1,1,0,15650,15650,0
Brand Marketing|Marketplaces|Software|Sports,2050000.0,USA,2,1,646,15886,16532,0
Education|K-12 Education|Video,2000000.0,USA,1,1,0,16266,16266,0
Cloud Computing|Content|Email|Enterprise Software|SaaS|Sales and Marketing|Small and Medium Businesses|Startups,250000.0,CAN,1,3,0,15681,15681,1
Enterprise Software|Open Source|Software,14094700.0,BEL,2,4,1549,14656,16205,0
Software,21000000.0,IRL,2,6,3877,11627,15504,0
Enterprise Software,10350001.0,USA,3,1,671,15295,15966,0
Games,3000000.0,USA,1,1,0,14903,14903,1
Finance|FinTech|Web Development,10012879.0,USA,5,6,1706,14841,16547,0
Finance|Wealth Management,1885000.0,USA,2,1,549,15765,16314,0
Financial Services|FinTech|Open Source|Software,25400000.0,GBR,5,8,2060,14457,16517,0
Analytics|Data Visualization|Enterprise Software|Governments|SaaS,47000000.0,USA,4,25,1221,15502,16723,0
Brokers|Hardware|Home & Garden|Mobile|Real Estate|Software|Tablets|Technology,205000.0,USA,2,6,203,15856,16059,0
Crowdsourcing|Internet|Mobile|Mobile Commerce|Software,880000.0,USA,5,12,1070,15349,16419,0
Curated Web,10000000.0,USA,1,3,0,14244,14244,1
E-Commerce|Logistics|Shipping,500000.0,JPN,1,2,0,16498,16498,0
Enterprise Software,10400000.0,USA,5,15,2343,12859,15202,0
News,4000000.0,USA,1,1,0,15995,15995,0
Enterprise Software,50000000.0,USA,2,10,1170,11309,12479,1
Hardware + Software,216973367.0,USA,7,5,2625,13831,16456,0
Curated Web,100000.0,USA,2,2,250,15614,15864,0
Databases|Enterprise Software|Internet|Music Venues|Open Source|Search|Sports,34833.0,GBR,1,1,0,16167,16167,0
Software,1210000.0,FRA,1,1,0,12963,12963,0
Cloud Computing|Life Sciences|Pharmaceuticals|SaaS|Software,8000000.0,USA,3,3,1560,14499,16059,0
Networking,7000000.0,USA,1,2,0,12447,12447,0
News,4000000.0,USA,1,1,0,14762,14762,0
Drones|Hardware + Software|Robotics,1300000.0,USA,1,2,0,15959,15959,0
Enterprises|Enterprise Software|Search,300000.0,FRA,1,1,0,15156,15156,0
E-Commerce|EdTech|Education,10000000.0,USA,2,2,823,15261,16084,0
Consumer Internet|E-Commerce|Internet|Sales and Marketing,646774.0,ESP,1,1,0,16325,16325,0
Maps|Mobile|Wireless,5300000.0,USA,2,4,703,15584,16287,0
E-Commerce|Social Commerce,49350000.0,USA,5,9,883,14365,15248,0
Analytics|Software,31000000.0,USA,4,10,2222,12784,15006,0
Software,4000000.0,USA,1,3,0,13559,13559,1
Education,1270000.0,USA,1,1,0,13879,13879,0
Business Services|Hospitality,48000000.0,USA,3,12,519,10712,11231,1
Advertising|Distribution|SaaS|Sales and Marketing|Social Media|Software,1825000.0,USA,3,1,504,16112,16616,0
Enterprise Software,307167.0,KOR,1,1,0,15484,15484,0
Biotechnology,25000.0,USA,4,2,463,16265,16728,0
Software,3850000.0,FRA,1,3,0,12877,12877,1
Advertising Exchanges|Enterprise Software,75511200.0,USA,6,28,2910,13677,16587,0
Analytics|Enterprise Software|Predictive Analytics,122199999.0,USA,3,8,1135,15231,16366,0
Health Care|Hospitals|Predictive Analytics|SaaS|Software,50000.0,USA,1,2,0,15857,15857,0
Advertising|Internet|Media|Software,25500000.0,USA,3,3,3346,12788,16134,0
E-Commerce Platforms|Search,10000000.0,USA,1,2,0,16548,16548,0
Bio-Pharm|Industrial|Pharmaceuticals,750000.0,USA,1,2,0,16426,16426,0
Analytics|Biotechnology,86526744.0,USA,11,21,3820,12810,16630,1
Biotechnology|Consumers,92253803.0,USA,7,14,2836,12431,15267,0
Biotechnology|Health Care,282700000.0,USA,5,10,2356,13738,16094,1
Analytics|Big Data|Governments,1000000.0,MEX,1,1,0,16252,16252,0
Polling|Social Media,1000000.0,ARG,1,1,0,15340,15340,0
Logistics,8300000.0,IND,2,5,83,16645,16728,0
Advice|Law Enforcement|Mobile|Opinions|Polling|Surveys,7240578.0,USA,3,12,826,15035,15861,0
Analytics,15000000.0,USA,1,1,0,15775,15775,0
Advertising|Direct Marketing|Internet|Opinions|Sales and Marketing,15000.0,IND,1,1,0,14641,14641,0
Internet,5576396.0,DEU,1,4,0,12458,12458,0
Semiconductors,10000000.0,ISR,1,3,0,12265,12265,1
Telecommunications,321000000.0,USA,1,2,0,11537,11537,1
Curated Web|Discounts,527590.0,ESP,1,3,0,14579,14579,0
Clean Technology|Energy Efficiency|SaaS|Smart Grid|Software,65700000.0,USA,3,8,1216,13726,14942,1
E-Commerce|Furniture,15360000.0,BRA,2,4,355,15260,15615,0
Search,4110749.0,FIN,3,6,1409,15340,16749,0
Government Innovation|Real Estate|Technology,500000.0,USA,1,1,0,16448,16448,0
Curated Web|Information Technology|News,2250000.0,USA,2,6,1094,14032,15126,1
Advertising|Business Intelligence|CRM|Google Glass|Lead Generation|Location Based Services|Networking|Professional Networking|Social Media,100000.0,USA,1,1,0,15855,15855,0
Consulting|Information Services|Recruiting|Service Providers,25000.0,COL,1,1,0,15765,15765,0
Big Data|Cloud Infrastructure|Startups,22056276.0,USA,2,5,356,16416,16772,0
Software,3000000.0,USA,1,6,0,16735,16735,0
Enterprise Software,3000000.0,USA,1,9,0,15870,15870,1
Biotechnology|Health and Wellness|Health Care|Medical|Therapeutics,51732700.0,IRL,3,23,1569,14411,15980,0
Health Care|Medical|Therapeutics,8000000.0,USA,1,1,0,16716,16716,0
Cloud Computing|Cloud Security|IaaS|Networking|PaaS|SaaS|Web Hosting,49000000.0,USA,4,13,1074,13399,14473,0
Accounting|Enterprise Software|Real Estate|Software,4000000.0,USA,1,4,0,12626,12626,1
Software,186000000.0,USA,3,8,239,10896,11135,1
Sports,2950000.0,GBR,1,2,0,13934,13934,1
Internet Marketing|Mechanical Solutions|Mobile,10000000.0,CHN,1,1,0,16442,16442,0
Consulting|Open Source,38500000.0,USA,5,9,2576,12851,15427,0
Mobile,95000000.0,USA,3,13,688,12536,13224,0
Health Care|Internet|Technology,8300000.0,USA,2,5,417,11589,12006,1
Contact Management|Eyewear|Health Care,3000000.0,USA,3,12,273,16126,16399,0
Biotechnology,42000000.0,USA,2,7,708,13795,14503,0
Distributors|Lasers|Manufacturing,3616966.0,USA,7,9,549,15400,15949,0
Consumer Goods|Optimization,55000.0,USA,2,2,212,15645,15857,0
Entertainment|Media|Services,2700000.0,USA,1,1,0,13346,13346,0
Semiconductors,29000000.0,USA,2,8,965,12843,13808,0
Health Diagnostics|Medical Devices,450000.0,ISR,1,1,0,16322,16322,0
Analytics,118100000.0,USA,9,27,3619,12311,15930,1
B2B|Internet Marketing|Lead Generation|SEO|Software,10849999.0,USA,3,13,1375,14162,15537,0
Analytics|Computers|Software|Training,3347305.38922156,AUS,2,5,735,15945,16680,0
Advertising,750000.0,USA,1,1,0,15496,15496,0
Health Diagnostics|Software,477972.0,GBR,1,1,0,13238,13238,0
Advertising|SaaS,7600000.0,USA,3,16,1978,13879,15857,1
Enterprise Software,22400000.0,USA,3,2,92,15715,15807,0
Clean Technology,25000000.0,USA,1,1,0,13816,13816,0
Analytics,60000.0,USA,1,1,0,16010,16010,0
Software,72000000.0,ISR,3,8,3698,12990,16688,0
Biotechnology,1500000.0,ISR,1,1,0,13922,13922,0
Software,4500000.0,USA,1,1,0,16407,16407,0
Biotechnology,81235886.0,USA,4,8,2906,12929,15835,1
Consulting|Design|Software,428000.0,RUS,1,1,0,15798,15798,0
Biotechnology,34200000.0,USA,2,9,287,12844,13131,1
Software,16294290.0,USA,4,15,1465,14979,16444,0
Software,1801240.0,ESP,2,3,278,15757,16035,0
Ad Targeting|Internet Marketing|Personalization|Software,146200000.0,USA,6,47,2128,14593,16721,0
Fitness,42325.0,DNK,1,1,0,15525,15525,0
Enterprise Software,7500000.0,USA,1,1,0,13147,13147,0
Manufacturing|Optical Communications|Telecommunications,22400000.0,USA,1,8,0,12025,12025,1
Biotechnology,113500000.0,NOR,3,4,1947,14767,16714,0
Enterprise Software,6000000.0,USA,1,4,0,13622,13622,1
Software,10000000.0,USA,1,1,0,16135,16135,0
Software,4000000.0,USA,3,4,1241,13836,15077,1
E-Commerce|Travel,5560000.0,USA,6,4,913,15584,16497,0
Brokers|Finance|Financial Services|Software,90000000.0,USA,1,1,0,12432,12432,1
Environmental Innovation|Project Management|Services,1364700.0,FRA,1,1,0,14931,14931,0
Biotechnology,100756757.0,USA,4,13,2677,13066,15743,0
Clean Technology|Manufacturing|Solar,132000000.0,USA,1,2,0,13980,13980,1
Hardware + Software,196000.0,GBR,1,1,0,13888,13888,0
Manufacturing|Nanotechnology|Semiconductors,21000000.0,USA,1,6,0,12062,12062,0
Mobile,2420000.0,ISR,1,1,0,14371,14371,0
Networking|Software|Wireless,789986.0,IRL,4,4,660,15592,16252,0
Mobile,798000.0,POL,1,1,0,13173,13173,0
Renewable Energies,4800000.0,USA,1,1,0,15700,15700,0
Biotechnology|Diagnostics|Nanotechnology,75000.0,USA,1,1,0,16561,16561,0
Marketplaces|Market Research|Product Development Services,2500000.0,FIN,1,2,0,16414,16414,0
Enterprise Software,122900000.0,USA,5,14,1649,14995,16644,0
Security,20500000.0,CAN,2,9,417,13125,13542,0
Health Care,10500000.0,USA,1,5,0,13602,13602,0
3D Technology|Consumers|Creative Industries,100000.0,IRL,1,1,0,15949,15949,0
Travel,500000.0,USA,1,2,0,13783,13783,0
Bridging Online and Offline|Location Based Services|Mobile|Small and Medium Businesses,100000.0,USA,1,1,0,15522,15522,0
Advertising|Consumers|Email|Internet|Public Relations|Sales and Marketing|Trading,209250.0,USA,3,3,346,15856,16202,1
Cable|Networking|Software|Telecommunications,43000000.0,USA,2,6,319,13321,13640,0
Software,3839577.0,USA,2,4,822,15340,16162,0
Clean Technology,57600000.0,USA,4,13,1528,13634,15162,0
Games,1015000.0,USA,2,10,243,14610,14853,0
Computers|Mobile,39800000.0,USA,4,7,1811,11292,13103,0
Hospitals|Medical Devices|Robotics,2013725.0,GBR,1,2,0,15701,15701,0
Advertising,3500000.0,USA,3,3,272,14747,15019,1
Security,28765834.0,ISR,3,3,6575,9496,16071,1
3D|Broadcasting|Video Streaming,6600000.0,ISR,1,1,0,14678,14678,1
Biotechnology,54387500.0,ISR,4,1,1693,15077,16770,1
Dental|Fitness|Healthcare Services,55274169.0,USA,7,9,4701,11124,15825,0
E-Commerce|Finance|Finance Technology|FinTech,66503303.0,GBR,5,5,1239,15309,16548,0
Cloud Computing|Enterprise Software|PaaS,1000000.0,IND,1,1,0,15461,15461,0
All Students|Curated Web|Employment|Small and Medium Businesses,12000.0,USA,2,2,516,14245,14761,0
Advertising|Internet|Local|Maps|Mobile|Search|Semantic Search|SEO|Social Media,7500000.0,USA,3,1,1527,13149,14676,1
Public Transportation,40000.0,GBR,1,1,0,15753,15753,0
Curated Web,201267.0,USA,2,3,212,16071,16283,0
Health Care,5269376.0,USA,2,2,539,14390,14929,0
Event Management|Events|Marketplaces,50000.0,USA,1,1,0,16307,16307,0
Internet,1000000.0,USA,2,2,166,16071,16237,0
Enterprise Software|Mobile|Software,6000000.0,USA,1,2,0,12230,12230,1
Semiconductors,8000000.0,USA,1,2,0,12586,12586,0
Biotechnology,92347081.0,USA,6,7,2605,13682,16287,0
Cloud Data Services|mHealth|Personal Data,680000.0,USA,2,2,202,16310,16512,0
Health and Wellness,384879.0,GBR,1,1,0,15242,15242,0
EdTech|Education|Health Care|Professional Services|Services,37684819.0,USA,4,2,1237,14351,15588,0
Web Development,17500000.0,IRL,1,1,0,11589,11589,1
Audio|Databases|Email|Facebook Applications|iPhone|Mobile|SMS|Social Network Media|Software|Twitter Applications|Wireless,500000.0,USA,1,3,0,14610,14610,0
Analytics|Financial Services|Software|Startups,8700000.0,USA,2,8,388,16122,16510,0
Clean Technology,7500000.0,CAN,2,1,33,16450,16483,1
Analytics|Cloud Computing|E-Commerce|SaaS|Software,2000000.0,USA,1,2,0,16589,16589,0
Consumer Internet|Finance Technology|Financial Services|FinTech|P2P Money Transfer|Small and Medium Businesses,2000000.0,NZL,1,4,0,14253,14253,0
Software,4000000.0,USA,1,1,0,12692,12692,0
Android|Consumer Electronics|Game|Hardware + Software|Mobile Games|Toys,92232212.0,USA,9,15,1684,14903,16587,0
Location Based Services|Mobile,736050.0,IND,1,1,0,13879,13879,0
Bio-Pharm,32500000.0,USA,1,4,0,16666,16666,0
Healthcare Services|Medical Devices|Pharmaceuticals,2500000.0,GBR,2,3,41,16147,16188,0
Health and Wellness,15000000.0,ISR,1,1,0,16156,16156,0
Crowdfunding|Finance|Finance Technology|FinTech|Marketplaces|Peer-to-Peer,44700000.0,USA,3,28,633,16055,16688,0
Software,31000000.0,USA,3,12,1285,12443,13728,1
Software,2030000.0,FRA,1,5,0,13647,13647,0
Cloud Computing|Databases|Developer APIs|Enterprises|Enterprise Software|Software,4220000.0,USA,3,5,479,15846,16325,1
Software,9800000.0,USA,1,3,0,16426,16426,0
Marketplaces|Property Management|SEO,40000000.0,IDN,3,2,365,15706,16071,0
Consulting|Networking|Software|Telecommunications|Web Tools,909150.0,GBR,1,1,0,16142,16142,0
Mobile|Software,630000.0,USA,3,3,1485,14245,15730,0
Design|Local|Marketplaces|Mobile|Real Time,10500000.0,USA,3,20,1010,15034,16044,0
Software,48501.0,USA,1,4,0,15361,15361,0
Consumer Electronics|Coupons|E-Commerce|iPad|iPhone,100000.0,USA,1,1,0,15006,15006,0
B2B|E-Commerce|Enterprise Software|Subscription Businesses|Subscription Service,10000000.0,USA,2,10,56,15650,15706,0
Customer Service|Online Shopping|Retail,580127.0,USA,3,3,154,16175,16329,0
Software,12400000.0,USA,3,5,684,13397,14081,1
Software,1170000.0,USA,1,1,0,13922,13922,0
Delivery|E-Commerce|Restaurants|Technology,10025000.0,USA,3,6,1210,15092,16302,1
Finance Technology|Software,37000000.0,USA,7,17,1419,15316,16735,0
Computers|E-Commerce|Health Care|Open Source|Senior Citizens,2091000.0,FRA,1,1,0,14232,14232,0
Delivery|E-Commerce|Shipping|Software,4750000.0,USA,4,2,1862,14839,16701,0
E-Commerce|Finance|FinTech,1398000.0,USA,5,11,965,15162,16127,0
Clean Technology,24000000.0,GBR,1,4,0,13941,13941,0
Hardware + Software,463181.0,FRA,1,3,0,15614,15614,0
Clean Technology,7000000.0,ISR,1,2,0,13636,13636,0
Biotechnology,3710000.0,FRA,1,1,0,14853,14853,0
Universities,25000000.0,USA,1,1,0,16316,16316,0
Development Platforms|Innovation Engineering|Project Management,525000.0,USA,1,1,0,14862,14862,0
Biotechnology|Health Care,101000000.0,USA,3,6,4250,12439,16689,1
Biotechnology,72861405.0,SWE,2,5,4242,12069,16311,1
Health Diagnostics,70000.0,USA,1,1,0,13343,13343,1
Health and Wellness,9854461.0,USA,2,1,227,15491,15718,0
Religion|Social Media,30000.0,GBR,1,1,0,14246,14246,0
Life Sciences|Software,10384999.0,USA,3,1,1223,14539,15762,0
Biotechnology,40000.0,CZE,1,1,0,15314,15314,0
Clean Technology,9100000.0,USA,2,6,713,15924,16637,0
Health and Wellness|Health Care Information Technology|Search,8045000.0,USA,4,7,2585,14031,16616,0
Advertising|Mobile|Politics,3900000.0,USA,1,7,0,15228,15228,0
Biotechnology,66352435.0,USA,4,2,1325,15280,16605,1
Design|Fashion|Manufacturing,3528114.0,KOR,1,1,0,15573,15573,0
Pharmaceuticals,68000000.0,USA,2,6,396,16375,16771,0
Biotechnology,26500000.0,USA,1,1,0,13833,13833,0
Assisitive Technology|Assisted Living|Navigation,50000.0,RUS,2,1,299,15650,15949,0
Clean Technology|Environmental Innovation|Renewable Energies,55000000.0,IND,1,2,0,14209,14209,0
Education,1000000.0,CHN,1,2,0,14000,14000,0
Home Renovation,47298.0,GBR,1,1,0,15371,15371,0
Bio-Pharm,3100000.0,USA,1,4,0,16471,16471,0
Financial Services,1077479.0,CHE,1,2,0,16736,16736,0
Software,5809932.0,GBR,1,2,0,16314,16314,0
E-Commerce|Payments|Shopping,19177613.0,JPN,3,6,1034,15492,16526,0
Mobile,5163408.0,USA,2,19,335,15248,15583,1
Analytics,49300000.0,USA,3,8,1050,15657,16707,0
Biotechnology,5743342.0,USA,2,1,1044,13789,14833,0
Pre Seed,10300000.0,ISR,1,1,0,16734,16734,0
Biotechnology,69551983.0,USA,5,9,1903,14692,16595,0
Games|Video,5500000.0,USA,1,2,0,13654,13654,1
Hardware + Software,2650000.0,ISR,2,2,3355,13340,16695,0
MicroBlogging|Opinions|Public Relations|Reviews and Recommendations|Social Media,187369.0,ESP,3,3,477,15614,16091,0
Hardware + Software|Messaging|Mobile|Wearables,6750000.0,USA,2,18,371,15931,16302,0
Organic Food,13500000.0,USA,2,2,1001,13693,14694,0
Big Data|Cloud Computing|Collaboration|Content|Enterprise Search|Search,4000000.0,USA,4,7,1572,14610,16182,0
Business Intelligence|CRM|Location Based Services,866233.0,JPN,3,1,518,15793,16311,0
Health Care,55000000.0,ISR,3,6,1161,15573,16734,0
Cloud Computing|Service Providers,8035277.0,FRA,3,9,1389,11017,12406,1
Active Lifestyle|Fitness|Location Based Services,250000.0,IND,1,2,0,16506,16506,0
Social Media,60000.0,USA,2,1,236,15679,15915,0
Biotechnology,44000000.0,DNK,3,9,1425,15019,16444,0
Health Care|Health Care Information Technology|Healthcare Services,50000.0,USA,2,2,234,16495,16729,0
Biotechnology,43343787.0,USA,4,16,2703,11500,14203,0
Health Care,18000000.0,ISR,1,3,0,15096,15096,0
Design|Innovation Engineering|Services,117051.0,GBR,1,1,0,16161,16161,0
Software,3000000.0,USA,1,1,0,12996,12996,1
Information Security|Software,11800000.0,USA,1,2,0,12026,12026,0
Health Care,24170000.0,USA,3,4,1697,14683,16380,0
Biotechnology|Health Diagnostics,27418909.0,USA,8,10,2181,14358,16539,0
Manufacturing|Medical,30756532.0,USA,12,12,2764,13679,16443,0
Health Care,25000000.0,USA,1,3,0,14342,14342,0
Hardware + Software,122000.0,SWE,1,1,0,14659,14659,0
Health Care|Life Sciences,5575000.0,USA,2,1,272,16344,16616,0
Internet|Networking,7000000.0,GBR,1,2,0,12233,12233,0
Hardware + Software,30754692.0,USA,5,4,1559,13152,14711,1
Biotechnology,1327461.0,GBR,1,1,0,14826,14826,0
Biotechnology|Customer Service|Medical Devices,8325000.0,USA,2,3,519,14158,14677,1
Health Care,90988600.0,USA,9,11,2503,14014,16517,0
Biotechnology,8000000.0,ISR,1,3,0,16574,16574,0
Health Care|Medical|Medical Devices,32500000.0,USA,1,1,0,13724,13724,0
Health Care|Medical Devices|Technology,3933167.0,GBR,1,1,0,16612,16612,0
Mobile,41346439.0,USA,6,8,2436,12815,15251,1
Android|iPhone|Mobile|Mobile Payments|QR Codes,80000.0,ARG,1,1,0,14192,14192,0
Hardware + Software,1629549.0,CHN,2,2,249,16130,16379,0
Biotechnology|Medical,35760510.37890421,ESP,2,2,2787,13950,16737,0
Software,3300000.0,USA,1,3,0,16771,16771,0
Health and Wellness|Insurance,327500000.0,USA,5,26,788,15905,16693,0
Communities|Families|Health Care|Senior Citizens,30000.0,USA,1,1,0,16071,16071,0
Energy|Gas|Natural Resources|Oil|Technology,50000.0,USA,1,1,0,14903,14903,0
News,1352569.0,CHN,1,1,0,13848,13848,0
Analytics,3500000.0,RUS,2,2,968,13354,14322,0
Enterprise Software,139500000.0,USA,2,2,441,14538,14979,0
Software,5540000.0,FRA,2,4,754,13391,14145,0
Consumer Electronics|Entertainment|Games|Kids,14500000.0,USA,2,5,380,15979,16359,0
Games|Mobile,100000.0,RUS,1,1,0,14969,14969,0
Home & Garden|Landscaping|Local Businesses,1305000.0,USA,6,5,1143,15521,16664,0
Fashion,2000000.0,GBR,1,1,0,13620,13620,0
Apps|Banking|Financial Services|FinTech,11216427.0,GBR,2,6,393,15857,16250,0
Analytics|Enterprise Software|Oil|Oil & Gas,4430802.0,USA,2,2,427,15961,16388,0
Energy IT|Industrial Automation|Oil and Gas,2967224.0,CAN,2,1,134,16461,16595,0
Biotechnology|Medical,25892744.0,USA,4,11,839,13543,14382,0
Biotechnology,12623471.2385773,SWE,2,4,842,15901,16743,0
Mobile,13675000.0,USA,4,3,2309,14153,16462,0
Clean Technology,45681891.0,CAN,6,6,1925,14147,16072,0
Biotechnology|Healthcare Services,9200000.0,USA,1,3,0,12328,12328,0
Travel,50600000.0,RUS,3,21,1144,15095,16239,0
Online Travel|Travel & Tourism,2500000.0,TUR,3,16,776,15861,16637,0
Consumer Electronics|Hardware + Software|Manufacturing|Software,7154915.0,USA,4,1,569,15998,16567,0
Email|Messaging|Shopping|Spam Filtering,3800000.0,USA,4,20,993,13879,14872,1
Clean Technology,6413140.0,CHE,2,2,328,15758,16086,0
E-Commerce|Price Comparison|Video Games,450000.0,ESP,2,6,2,16015,16017,0
Biotechnology,4100000.0,USA,1,3,0,16163,16163,0
Bitcoin|Finance|FinTech,165931.0,SGP,2,2,421,16115,16536,0
Biotechnology,143400000.0,USA,4,25,1419,14771,16190,1
Health Care,40000.0,USA,1,1,0,15562,15562,0
Data Visualization|Software,122000.0,GBR,1,3,0,15461,15461,0
Automotive,3859800.0,FRA,1,2,0,16118,16118,1
Software,23500000.0,USA,3,8,1366,12772,14138,1
Messaging|Mobile|Photography,41250.0,HKG,1,1,0,16648,16648,0
Mobile,2000000.0,AUS,3,3,853,15096,15949,0
Internet,1600000.0,USA,1,1,0,16729,16729,0
Fitness|Health and Wellness|Health Care Information Technology|Personal Health|Social Media|Software,525000.0,SGP,5,9,726,15371,16097,0
Curated Web|Retail,85300000.0,USA,4,9,180,10803,10983,0
Biotechnology,1836667.0,USA,2,1,615,13712,14327,0
Games,4265969.0,CHN,3,2,2526,12418,14944,0
Music|Social Network Media|Video,29926738.0,USA,6,2,1708,13972,15680,0
Collaboration|Social Media,6300000.0,USA,1,3,0,13149,13149,0
Entertainment|Music|Video,15000.0,USA,1,2,0,15461,15461,0
Software,2070000.0,USA,4,10,617,16040,16657,0
Advertising|Email Marketing|Marketing Automation|Network Security|Social Media|Software|Startups,17800000.0,USA,2,12,831,15584,16415,0
Consulting|Information Services|Information Technology|SaaS,3449999.0,USA,4,8,403,16198,16601,0
Content|Curated Web|Reviews and Recommendations,149000000.0,ISR,7,28,3129,13514,16643,0
Curated Web|Leisure|Maps|Social Media,1750000.0,USA,2,2,32,16191,16223,0
Brand Marketing|E-Commerce|Fitness,8100000.0,USA,2,9,177,16545,16722,0
Software,29000000.0,USA,3,12,973,11890,12863,1
E-Commerce|Fashion,37810740.0,DEU,4,15,992,15504,16496,0
EdTech|Software,4000000.0,USA,2,1,315,16413,16728,0
E-Commerce|Lifestyle,1000000.0,IND,1,2,0,16479,16479,0
Analytics|Finance|Politics,892000.0,USA,6,1,951,15006,15957,0
CRM|Email|Enterprise Software|Productivity Software|Task Management,20118.0,IRL,1,1,0,15396,15396,0
Computers|Information Technology|Software,22500000.0,USA,1,3,0,12521,12521,0
Games|Mobile|Mobile Games|Social Games|Social Media,9000000.0,GBR,3,3,1252,14966,16218,0
Computers,6200000.0,USA,1,2,0,16639,16639,0
Graphics|Software,3500000.0,NOR,2,3,290,15943,16233,0
Application Platforms|SaaS|Sales and Marketing,11500000.0,USA,2,10,176,16559,16735,0
Advertising|Brand Marketing|Video,6533984.0,USA,3,3,1007,15441,16448,0
Accounting|Enterprise Software,7500000.0,USA,2,9,382,14184,14566,1
Construction|Home Owners|Home Renovation|Local Businesses,22000.0,USA,1,1,0,15198,15198,0
Apps|Restaurants|Search,320000.0,USA,2,3,516,16148,16664,0
Medical Devices,151000000.0,USA,3,9,20,16575,16595,0
Communities|Curated Web|Local|News,14400000.0,USA,5,29,1041,13545,14586,1
Curated Web,2000000.0,USA,1,3,0,11737,11737,1
Hardware + Software,10711500.0,USA,7,3,2149,14391,16540,0
Outsourcing,20000000.0,USA,1,1,0,12369,12369,0
Games,23300000.0,USA,3,7,825,13614,14439,1
Application Platforms|Enterprise Application|Enterprise Software|Mobile|Mobile Enterprise|Mobile Software Tools|PaaS|Web Development,6131310.88389163,USA,2,2,835,12850,13685,0
Online Travel|Travel,20000.0,AUS,1,1,0,15826,15826,0
Games,33600000.0,USA,3,8,903,15561,16464,1
Biotechnology,8454877.0,USA,3,3,1265,13526,14791,0
Biotechnology,81999920.0,USA,4,5,534,15258,15792,1
Fertility|Health and Wellness|Mobile Health|Women,120000.0,USA,1,1,0,16495,16495,0
Console Gaming|Social Games|Video Games,6278109.0,USA,7,12,1158,15475,16633,0
Games,138533.0,CAN,1,1,0,14396,14396,0
Apps|Design|Internet|Software,800000.0,USA,1,4,0,15949,15949,0
E-Commerce,8467397.21579609,CAN,2,6,350,13879,14229,0
Mobile Analytics|Mobile Video|Online Video Advertising|Video Streaming,243521.0,BRA,2,1,1461,14610,16071,0
Mobile|Social Network Media,12853500.0,USA,8,2,1041,15351,16392,0
Advertising|Lead Generation,210000000.0,USA,2,2,365,13514,13879,0
Hardware + Software,20800000.0,ISR,4,13,2168,12732,14900,1
Software,37150285.0,USA,6,13,4240,12362,16602,0
Software,6000000.0,USA,1,3,0,14231,14231,0
Web Hosting,113914304.0,USA,7,19,3897,11963,15860,0
Android|Apps|FreetoPlay Gaming|Hardware|iPhone|Mobile|Online Gaming|Software,270000.0,USA,3,2,73,15949,16022,0
FreetoPlay Gaming|Games|Social Games|Social Media,5500000.0,ISR,2,1,1446,14518,15964,0
Cloud Infrastructure|Digital Media|Media,7975241.0,USA,2,1,436,14293,14729,0
Entertainment|Sports|Travel,1223801.0,ESP,1,2,0,16266,16266,0
Health Care,80060000.0,USA,2,8,148,16510,16658,0
Advertising|Mobile|Mobile Commerce|Telecommunications,2180048.0,GBR,5,5,281,15789,16070,0
Biotechnology,8616975.44161999,BEL,1,5,0,16755,16755,0
Analytics|Fertility|Health Care Information Technology|mHealth|Mobile|Women,5719992.0,USA,5,8,1543,15034,16577,0
Fertility|Health and Wellness,2040246.8709481999,GBR,2,4,395,16222,16617,0
Manufacturing,10000000.0,USA,1,1,0,15568,15568,0
Business Information Systems|Market Research,19300000.0,USA,2,2,510,15126,15636,0
Big Data|Consumer Electronics|Hardware + Software|Medical|Mobile,8850000.0,USA,2,14,483,16182,16665,0
Browser Extensions|Games|Leisure|Virtual Goods,4748400.0,FRA,1,1,0,13984,13984,0
Education,40000.0,CHL,1,1,0,16051,16051,0
Advertising|Local Businesses|Location Based Services|Maps|Mobile Commerce|Search,1000000.0,TWN,2,1,26,16059,16085,0
Health and Wellness,5149000.0,USA,1,2,0,15431,15431,0
Enterprise Software,9620000.0,USA,3,5,808,15331,16139,0
Enterprise Software|Social Commerce,321347.0,GBR,3,1,1115,15218,16333,0
Clean Technology,28800000.0,USA,3,6,1432,14162,15594,1
Advertising|Internet Marketing,39300000.0,USA,6,16,2425,13816,16241,0
Mobile,1500000.0,USA,2,5,590,15248,15838,0
E-Commerce|Online Rental|Travel|Vacation Rentals,40000.0,GBR,1,1,0,15308,15308,0
Services,1227153.50347641,GBR,1,4,0,16426,16426,0
Advertising|Digital Media|News|SaaS|Small and Medium Businesses|Software,6847000.0,USA,5,21,1984,14788,16772,0
Customer Service|Internet|Network Security,40000.0,USA,1,1,0,16076,16076,0
E-Commerce|Social Commerce,1250000.0,USA,1,5,0,15056,15056,0
Application Platforms|Data Security|Enterprise Software|Virtualization,6000000.0,CHN,2,1,669,15553,16222,0
Biotechnology,26700000.0,GBR,1,9,0,14572,14572,0
Energy,1894455.0,FRA,1,2,0,12599,12599,0
Software,8030000.0,FRA,2,3,727,14048,14775,0
Software,3359105.0,GBR,1,1,0,16205,16205,0
Automotive|Manufacturing|Services,75000000.0,USA,1,1,0,12363,12363,0
Biotechnology|Health Diagnostics,21641253.0,GBR,9,21,3782,12864,16646,0
Biotechnology,4810827.0,GBR,2,1,672,15979,16651,0
Biotechnology,227287.0,GBR,1,1,0,15916,15916,0
Biotechnology|Health Care|Health Diagnostics,106550010.0,GBR,4,24,2504,13005,15509,1
Health Diagnostics|Nanotechnology,379865383.0,GBR,9,13,3710,12926,16636,0
Clean Technology,1200000.0,USA,1,1,0,15190,15190,0
Clean Technology,23010301.0403957,GBR,4,5,1540,15176,16716,0
Innovation Management|Startups|Universities,174443498.0,GBR,1,1,0,16608,16608,0
Semiconductors,10000000.0,USA,1,1,0,13371,13371,1
Content|Crowdsourcing|News,1220000.0,GBR,2,10,101,16055,16156,0
Biotechnology,36611963.0,GBR,6,10,3303,12942,16245,1
Medical Devices,3000000.0,ISR,1,1,0,16314,16314,0
Software,5000000.0,USA,1,3,0,12936,12936,0
Health Diagnostics|Nanotechnology,22455181.0,GBR,2,7,897,12969,13866,1
Hardware + Software,4520000.0,GBR,1,5,0,14679,14679,0
Health Care,1037802.0,GBR,3,2,1089,15225,16314,0
Biotechnology,53324213.0,SWE,3,8,3201,12975,16176,0
Health Care,1132930.0,GBR,1,2,0,13468,13468,0
Bio-Pharm,23566995.0,GBR,1,6,0,12156,12156,1
Curated Web|Events,1514366.0,BEL,3,5,442,13787,14229,0
Startups|Technology,1596003.0,GBR,2,3,830,15166,15996,0
Biotechnology,26500000.0,GBR,1,3,0,15295,15295,0
Apps,90000.0,USA,1,1,0,16450,16450,0
Biotechnology,5922024.0,USA,4,2,1460,14504,15964,0
Analytics|Big Data|Internet Marketing|Social Media,20000.0,USA,1,1,0,15952,15952,0
Hospitality|Online Reservations,125650000.0,IND,4,10,944,15706,16650,0
Consumer Goods,15600000.0,USA,3,4,644,15706,16350,0
Internet|Mobile,1110000.0,USA,2,1,549,15765,16314,0
Travel,20400000.0,USA,3,4,1150,13939,15089,1
E-Books|Entertainment|Media,17000000.0,USA,2,14,460,15624,16084,0
Software,34000000.0,CAN,2,4,848,12631,13479,1
Development Platforms|Energy|Medical,1053837.02059198,AUS,1,1,0,15080,15080,0
Hardware + Software,41289900.0,USA,6,11,2194,13237,15431,0
E-Commerce|Online Shopping,271000000.0,RUS,4,11,5232,10957,16189,0
Ad Targeting|Advertising|Advertising Platforms|Curated Web|E-Commerce|Internet Technology|Marketing Automation|Real Time|Retail Technology,7800000.0,IND,3,3,1614,13970,15584,0
Fashion,14500000.0,AUS,1,1,0,14827,14827,0
Finance|Mobile|Mobile Games|Mobile Social,53000000.0,HKG,5,1,2110,12784,14894,0
Cloud Management|Home Automation|Internet of Things|Security|Video,11512602.0,USA,3,2,560,14193,14753,0
Digital Media|Information Services|News,25399988.0,USA,2,6,281,16068,16349,0
E-Commerce,342500.0,ITA,1,1,0,16209,16209,0
Chemicals|Customer Service|Service Providers|Waste Management,475661.0,GBR,1,1,0,15439,15439,0
Software,250000000.0,USA,2,2,1938,14047,15985,0
Biotechnology|Chemicals|Specialty Chemicals,2000011.0,USA,4,5,865,15301,16166,0
Clean Technology,13623000.0,DEU,1,3,0,14377,14377,1
Crowdfunding|Finance|Finance Technology|FinTech,1400000.0,USA,2,2,363,15577,15940,0
Nanotechnology,8397762.8359805,GBR,2,2,2235,13970,16205,0
Hardware + Software,28289100.0,NLD,1,2,0,13910,13910,0
Mobile Payments,9054000.0,USA,1,1,0,16630,16630,0
Semiconductors,86000000.0,USA,3,7,1126,13239,14365,1
E-Commerce|Marketplaces,30000.0,IND,1,1,0,16467,16467,0
Nonprofits,40000.0,GBR,1,1,0,15659,15659,0
Public Transportation,5095026.0,USA,3,1,2209,14473,16682,0
Big Data Analytics|Developer APIs|Infrastructure,2120000.0,USA,2,13,191,16405,16596,0
Renewable Energies,7000000.0,USA,1,1,0,16622,16622,0
Curated Web,1194857.0,USA,1,1,0,14369,14369,0
Biotechnology,255220000.0,USA,5,32,2721,13026,15747,1
Enterprise Software|Governance|Software,12000000.0,USA,1,4,0,12613,12613,0
Business Productivity|Fuels,3000000.0,USA,1,1,0,16286,16286,1
Messaging,11996519.0,USA,3,3,1917,13077,14994,0
Consumer Goods,809179.0,GBR,1,1,0,16345,16345,0
Hardware + Software,350000.0,USA,1,1,0,14214,14214,0
Information Technology,1909535.0,USA,2,4,358,16329,16687,0
All Students|Big Data|Digital Media|Education,2500000.0,USA,3,15,616,15979,16595,0
Transportation,349841.0,SWE,1,1,0,16451,16451,0
Cloud Infrastructure|Web Hosting,1300000.0,USA,1,2,0,16375,16375,0
Software,16797295.0,USA,5,3,607,15176,15783,0
SaaS|Software|VoIP,2000000.0,USA,1,3,0,13300,13300,1
Cloud Computing|Real Time|Transaction Processing,15000000.0,GBR,2,3,1339,12723,14062,1
Internet|Software,59514142.97046079,SWE,2,6,1485,12577,14062,1
Automotive|Consumer Electronics|Mobile|Networking|Web Hosting,10000000.0,USA,1,4,0,13003,13003,0
Telecommunications,18000000.0,ISR,1,4,0,11275,11275,0
Enterprise Software,21170000.0,USA,4,10,1533,13412,14945,1
Big Data Analytics|Cyber Security|Enterprise Security|Visualization,3000000.0,USA,1,1,0,15857,15857,0
Apps|Health Diagnostics|IT Management|Networking|Software,5500000.0,USA,1,1,0,13768,13768,1
Software,105500000.0,USA,2,1,1624,14431,16055,1
E-Commerce,685000.0,USA,1,4,0,14616,14616,0
E-Commerce|E-Commerce Platforms|Logistics|Postal and Courier Services|Price Comparison|Shipping,23522700.0,ESP,3,6,893,15799,16692,0
Apps|Exercise|Finance|FinTech|Fitness|Health and Wellness|Incentives|iPhone|Mobile,2440000.0,USA,4,15,876,15180,16056,0
Manufacturing,2200000.0,USA,2,1,1736,14425,16161,0
Coffee|E-Commerce,3355282.0,GBR,2,8,502,15791,16293,0
Legal|Software,2220000.0,USA,3,3,126,16637,16763,0
Mobile,10000000.0,USA,1,1,0,12830,12830,1
E-Commerce,51000000.0,USA,4,21,1358,15378,16736,0
Biotechnology|Health and Wellness|Healthcare Services,360000.0,USA,2,1,337,15719,16056,0
Curated Web,2320000.0,USA,6,11,1256,15440,16696,0
Therapeutics,37647727.0,USA,2,2,255,16167,16422,0
Advertising|Apps|Gamification|Incentives|Mobile|Mobile Games|Social Games|Social Media|User Experience Design,13455000.0,USA,4,3,1093,15400,16493,0
Financial Services|FinTech|Mobile|Mobile Payments,13000000.0,NGA,3,9,1374,15340,16714,0
Software,29999972.0,BRA,2,2,687,15901,16588,0
Curated Web|Payments|Property Management|Real Estate,40000.0,ARG,1,1,0,15175,15175,0
Legal,1325000.0,USA,1,5,0,16476,16476,0
Developer APIs|Software,50000.0,USA,1,1,0,15918,15918,0
Search|Social Commerce|Social CRM|Software,529000.0,THA,2,3,274,16138,16412,0
Publishing|Software|User Experience Design|Web Design|Web Development,2200000.0,CAN,2,13,168,16343,16511,0
Advertising|Digital Media|Software,1238693.89389762,IRL,2,5,401,16155,16556,0
Curated Web|Web Design|Web Development,4100000.0,USA,2,2,713,13269,13982,1
Information Technology,300000.0,USA,1,1,0,11619,11619,0
Mobile|Personal Finance,47000000.0,USA,4,9,2073,13879,15952,1
Health Care|Mobile|Technology,24400000.0,USA,3,13,438,16191,16629,0
Cloud Computing|IT Management|SaaS,39800000.0,USA,3,14,1401,14881,16282,0
Ad Targeting|Advertising Platforms|Content,2100000.0,USA,3,3,982,15409,16391,0
Facebook Applications|Social Media|Software|Web CMS,370000.0,USA,2,2,196,15875,16071,0
Financial Services|SaaS|Software,172801.0,DEU,2,4,37,16154,16191,0
E-Commerce|Mobile Payments|Payments,1000000.0,MEX,1,1,0,15710,15710,0
Advertising|Lead Generation|Payments|Trading,800000.0,BRA,1,1,0,14977,14977,0
Services,2000000.0,USA,1,1,0,16658,16658,0
E-Commerce,1200000.0,USA,1,3,0,15400,15400,0
Biotechnology,1700000.0,USA,1,1,0,16699,16699,1
Banking|Financial Services,25000.0,USA,1,1,0,16750,16750,0
Art|Entertainment,13000000.0,USA,1,2,0,16486,16486,0
Curated Web|Marketplaces,9225000.0,USA,4,20,734,15972,16706,0
E-Commerce,970000.0,JPN,1,4,0,16056,16056,0
Software,10000000.0,USA,1,1,0,12564,12564,1
E-Commerce,30000000.0,CHN,1,2,0,15400,15400,0
Design|Manufacturing|Mass Customization|Service Providers,120000.0,USA,1,2,0,16405,16405,0
Transportation,120000000.0,PAK,1,1,0,16765,16765,0
Logistics|Supply Chain Management|Technology,4160000.0,USA,1,1,0,13705,13705,0
Curated Web,12500000.0,SGP,3,5,483,16147,16630,0
Communities,3500000.0,PAK,1,1,0,16374,16374,0
Enterprise Software|Information Security|Risk Management,10000000.0,IND,1,1,0,16239,16239,0
Security,18500000.0,USA,3,9,1197,12829,14026,0
Analytics,1671557162.0,USA,16,15,3702,13027,16729,0
Cooking|Hardware + Software,120000.0,USA,2,2,334,16071,16405,0
Biotechnology|Health Care,87700000.0,USA,4,2,3981,12447,16428,1
Design|Manufacturing|Software,1575000.0,USA,3,3,119,15978,16097,0
Biotechnology,198608.0,GBR,1,1,0,13637,13637,0
Enterprise Software,8175324.0,USA,4,6,2199,12884,15083,1
Mobile,100000000.0,USA,1,1,0,14236,14236,1
E-Commerce,15000000.0,CHN,2,7,365,13208,13573,0
Health Care,29128000.0,USA,5,1,1967,14379,16346,0
Curated Web,6061005.0,DEU,1,1,0,16062,16062,0
Health and Wellness,8240280.0,USA,4,2,700,15980,16680,0
Communications Hardware|Computers|Network Security|Security,329000000.0,USA,5,12,2381,13149,15530,1
Mobile,1500000.0,AUS,1,1,0,15506,15506,0
Android|Apps|Audio|FreetoPlay Gaming|iOS|iPhone|Media|Messaging|Mobile|Mobile Devices,10278514.0,GBR,3,12,1461,13361,14822,0
Chat|Messaging|Networking|Video,6000000.0,USA,1,1,0,12509,12509,0
Health Care|Life Sciences,24000000.0,USA,1,5,0,14466,14466,0
Biotechnology,11.0,NLD,1,4,0,12240,12240,0
Bio-Pharm,2200000.0,USA,1,2,0,16554,16554,0
Mobile Commerce|Online Travel|Travel & Tourism,1350000.0,USA,1,5,0,16672,16672,0
Biotechnology,38300000.0,USA,2,9,206,12556,12762,1
Enterprises,50223.0,ESP,1,1,0,15584,15584,0
Advertising|Analytics|Business Intelligence|Sales and Marketing,1000000.0,USA,1,1,0,16752,16752,0
Storage,90630481.0,USA,4,10,4259,11596,15855,0
Information Services|Information Technology|Security,2250000.0,GBR,2,5,346,16405,16751,0
Software,69000000.0,USA,6,13,3187,13256,16443,1
Enterprise Software|Flash Storage|Optimization|Storage|Virtualization,5000000.0,USA,1,2,0,14591,14591,1
Crowdsourcing|Game,1370702.0,JPN,1,2,0,16258,16258,0
Information Technology|IT and Cybersecurity|Security|Web Development,13820000.0,ESP,1,4,0,13718,13718,0
E-Commerce|Travel,211435.0,SGP,2,4,265,16261,16526,0
Contact Management|Digital Signage|Document Management|Estimation and Quoting|SaaS|Sales Automation|Software,6055000.0,USA,3,3,859,15765,16624,0
Content Delivery|Games|Peer-to-Peer|Video|Video Streaming,19119999.0,USA,3,3,666,13284,13950,1
Blogging Platforms|News|Startups,4200000.0,USA,2,27,264,15854,16118,0
Advertising|Media|Software|Technology,2174140.0,USA,7,1,2127,14468,16595,0
Broadcasting|Music|Video Streaming,56300000.0,USA,6,15,4122,11018,15140,1
Games,16000000.0,KOR,2,6,426,13180,13606,0
E-Commerce,100000000.0,USA,1,1,0,16237,16237,1
Finance|Software,8770048.0,USA,3,10,671,15826,16497,0
Game,500000.0,USA,1,1,0,16579,16579,0
Outsourcing,7000000.0,USA,1,1,0,13708,13708,0
Mobile|Mobile Payments|Payments,6500000.0,ISR,1,1,0,16131,16131,0
Enterprise Software,10000000.0,USA,1,3,0,13073,13073,1
Analytics|Data Mining|Logistics|Manufacturing|Search,5600000.0,USA,3,4,2329,13149,15478,0
Automotive|E-Commerce|Marketplaces|Mobile|Mobile Commerce|Payments,6472500.0,USA,5,14,1715,15036,16751,0
Cooking|Hospitality,1384396.0,USA,3,19,324,15507,15831,0
Software,38000000.0,USA,3,9,757,13908,14665,0
Colleges|EdTech|Education|Open Source,6697315.0,USA,5,15,795,15823,16618,0
Biotechnology,75000000.0,USA,2,5,1197,14978,16175,0
FreetoPlay Gaming|Online Gaming|PC Gaming|Security,120000.0,USA,2,1,155,15952,16107,0
Enterprise Software|Video,8063806.0,USA,3,6,1165,14711,15876,0
Big Data Analytics|Education|Teachers,16000000.0,USA,4,30,886,15765,16651,0
Clean Technology,26500000.0,ISR,5,10,1328,15078,16406,1
Software,8168723.0,DEU,4,8,2582,13040,15622,0
Travel,5566456.0,USA,4,3,1402,13443,14845,0
Analytics,10000000.0,USA,1,3,0,12114,12114,0
Advertising|Apps|Software|Web Hosting,220000000.0,CHN,2,4,1585,14975,16560,0
Finance|Legal,118000.0,USA,1,1,0,15927,15927,0
Enterprise Software,9500000.0,USA,1,2,0,12904,12904,0
Advertising,1004550.0,ITA,1,1,0,15314,15314,0
Bio-Pharm|Biotechnology|Medical,5591715.97633136,LIE,1,1,0,13854,13854,0
Mobile|Telecommunications,76300000.0,KOR,1,1,0,14475,14475,0
Software,4000000.0,USA,1,3,0,12230,12230,0
Cloud Computing|Cloud Data Services|File Sharing|Flash Storage|SaaS|Software|Storage|Unifed Communications,10019869.0,USA,2,1,1048,13621,14669,0
Content|Enterprise Software|Web CMS|Web Development,32800000.0,USA,4,14,1352,14853,16205,0
Audio|Games|Video,21750000.0,USA,2,4,582,13354,13936,1
Hardware + Software|Retail Technology|Specialty Foods,2300000.0,USA,2,11,428,16286,16714,0
Cloud Computing|Games|Video,2700000.0,USA,1,2,0,14687,14687,1
Software,4000000.0,AUS,2,2,608,15806,16414,0
Software|Storage,58000000.0,USA,4,12,1712,14150,15862,0
Mobile,40000.0,CHL,1,1,0,15750,15750,0
Food Processing,1024999.0,USA,1,2,0,12496,12496,0
Android|Enterprise Software|Mobile|Social Games,26000000.0,CHN,3,4,481,14610,15091,0
Banking|Hardware + Software|Personal Finance,12697233.0,DEU,3,8,715,15826,16541,0
Manufacturing,3972414.0,USA,2,2,101,16125,16226,0
News,162841.0,CHE,1,1,0,15944,15944,0
Android|Consumer Electronics|Curated Web|Design|Email|iOS|iPad|Mobile|Social Media|User Experience Design,260835.0,GBR,3,5,428,15675,16103,0
Advertising|Advertising Platforms|Displays,9474999.0,USA,3,8,2097,14610,16707,0
Business Services|Hardware + Software,40000.0,CAN,1,1,0,15324,15324,0
Apps|Email|Mobile,8000000.0,USA,2,4,465,15419,15884,1
Messaging,32350000.0,USA,3,10,1586,14589,16175,0
Advertising,600000.0,USA,1,1,0,14690,14690,0
Business Services|Consumers|Enterprise Software|Small and Medium Businesses,4650000.0,USA,4,6,104,16441,16545,0
Fitness|Health and Wellness|Health Care,13500000.0,USA,4,8,1221,15495,16716,0
Health and Wellness|Health Diagnostics,2970000.0,USA,2,2,837,15541,16378,0
Babies|E-Commerce|Kids|Medical,261560.0,ESP,1,1,0,14868,14868,0
Analytics,84491709.0,USA,6,16,1598,13857,15455,1
E-Commerce|Home Decor|Interior Design|Retail,10000184.0,USA,3,11,439,16150,16589,0
Health Care,44000000.0,USA,1,8,0,13693,13693,0
3D Technology|Software,4550000.0,USA,3,7,395,15982,16377,0
Semiconductors,14500000.0,USA,1,3,0,13734,13734,1
Enterprise Software,3490000.0,NOR,1,1,0,13353,13353,0
Software,65000000.0,CYM,1,1,0,14614,14614,0
Health Care,136552310.0,USA,6,4,2575,13549,16124,0
Biotechnology,15000000.0,USA,2,2,294,16371,16665,0
Internet|Networking,12500000.0,USA,1,7,0,11661,11661,1
Mobile,7000000.0,USA,1,2,0,13117,13117,0
Curated Web,2000000.0,USA,1,3,0,15874,15874,0
Cloud Computing|SaaS|Software|Virtualization,12400000.0,USA,3,5,3227,12949,16176,0
Big Data|Mobile|Mobile Payments|Sports Stadiums,390000.0,USA,2,1,366,15674,16040,0
Enterprise Software,11370000.0,USA,1,2,0,14053,14053,1
Biotechnology|Health Diagnostics,6450000.0,USA,2,3,204,14374,14578,0
Big Data|Big Data Analytics|Data Visualization|Enterprise Software,2500000.0,USA,1,4,0,15765,15765,1
Accounting|Billing|Cloud Computing|Enterprise Software|Financial Services|SaaS,1900000.0,TUR,3,5,527,16013,16540,0
Mobile,50000000.0,USA,3,15,1785,12430,14215,1
Biotechnology,133000000.0,USA,2,4,2457,13812,16269,0
Customer Service|Customer Support Tools|Software,30234350.0,USA,3,6,1477,13334,14811,1
Hardware + Software,1010000.0,GBR,1,4,0,14221,14221,0
E-Commerce|Logistics|Shipping,1000000.0,USA,1,5,0,16342,16342,0
Business Services|Developer APIs|Postal and Courier Services,1000000.0,GBR,1,1,0,16415,16415,0
Gift Card|Messaging|Mobile,5000000.0,GBR,1,4,0,15706,15706,0
Logistics,5000000.0,IND,2,4,103,16631,16734,0
E-Commerce,1700000.0,ZAF,1,1,0,16468,16468,0
E-Commerce,7000000.0,AUS,2,2,1036,15460,16496,0
Big Data Analytics|Colleges|EdTech|Education,51549988.0,USA,5,11,1517,14995,16512,0
E-Commerce|Parking|Travel & Tourism,855007.780570803,ESP,2,1,499,16225,16724,0
Cloud Infrastructure|Databases|Enterprise Software|Open Source,12700000.0,USA,4,11,1475,15135,16610,0
Advertising,2900369.0,USA,2,3,128,15371,15499,0
Health Care Information Technology|Medical,1005000.0,USA,4,6,365,15584,15949,0
Apps|Parenting,1320000.0,USA,1,11,0,16380,16380,0
Consulting|Project Management|Services,5350000.0,CHE,1,1,0,13056,13056,0
Internet|Software,2220000.0,USA,2,9,127,16588,16715,0
Health and Wellness|Health Care|Health Care Information Technology,65952.0,DEU,1,1,0,16308,16308,0
Biotechnology|Medical|Startups,3000000.0,USA,1,1,0,16329,16329,0
Android|Curated Web|iPhone|Mobile|Public Transportation|Windows Phone 7,301152.0,GBR,5,9,706,15279,15985,0
Collaborative Consumption|Databases|Internet|Online Rental|Peer-to-Peer,5710140.0,GBR,3,3,1334,15156,16490,0
Apps,63276.0,ITA,1,1,0,16367,16367,0
Parking,5375706.0,USA,3,11,214,16514,16728,0
Android|Big Data Analytics|iPhone|Mobile|Mobile Payments,8297000.0,USA,2,5,404,15240,15644,1
Navigation|Public Transportation|Transportation,4725000.0,USA,2,3,638,15131,15769,0
Analytics|Business Intelligence|Enterprise Software|SaaS,1500000.0,USA,1,3,0,16475,16475,1
Mobile,6300000.0,USA,2,4,580,15742,16322,0
Crowdsourcing|Navigation|Parking,1000000.0,ISR,2,3,249,16246,16495,0
Mobility|Parking,27137.0,DEU,1,1,0,16272,16272,0
Automotive|Curated Web|Internet of Things|Parking,679638.0,DEU,1,8,0,16258,16258,0
E-Commerce|Geospatial|Parking|Software,12000000.0,USA,2,14,578,15694,16272,0
Mobile|Mobile Payments|Parking,250000.0,USA,1,1,0,16462,16462,0
Enterprise Software,4500000.0,USA,1,2,0,12698,12698,1
B2B|Enterprise Software|Finance|Hardware|SaaS|Software,5906514.0,USA,7,8,1139,15623,16762,0
Apps|Mobile Social|Music Services,2000000.0,ISR,1,3,0,16709,16709,0
Big Data|Marketplaces|Parking,40000.0,CHL,1,1,0,16222,16222,0
Advertising|Identity|Mobile,2500000.0,USA,2,11,457,15614,16071,0
Cars|Consumer Electronics|Games|Manufacturing|Mobile|Product Design|Wireless,35213146.2412634,FRA,1,1,0,16759,16759,0
Android|Cloud Computing|Enterprise Software|iOS|Mobile|PaaS,7000000.0,USA,2,17,97,15190,15287,1
Analytics|B2B|Big Data|Digital Media|Optimization|Predictive Analytics|Publishing,6052753.0,USA,6,17,2131,14365,16496,0
Software,200794.0,ARG,3,3,279,15673,15952,0
Clean Technology,65000000.0,USA,1,1,0,15929,15929,0
Analytics|Big Data|Business Intelligence|Databases|Real Time,13600000.0,USA,2,6,429,15566,15995,1
Accounting|Finance|Hospitality|Mobile|Nightclubs|Nightlife|Restaurants|SaaS,50000.0,USA,3,23,230,15961,16191,0
Consumer Electronics|Hardware|Hardware + Software|Internet of Things|Technology,5370000.0,USA,5,7,759,15736,16495,0
Software,3000000.0,USA,1,1,0,14790,14790,1
Computers|Software|Wireless,645088.0,DEU,1,1,0,13098,13098,0
Android|Apps|Auto|Automotive|Cars|E-Commerce|iOS|Startups,7000.0,USA,2,1,196,15884,16080,0
Software|Web Development,100000.0,TUR,1,1,0,13149,13149,0
Advertising|Brand Marketing|Marketplaces|Startups,1098400.0,USA,3,9,577,15675,16252,0
Enterprise Software|Industrial Automation|Mobile|Mobile Enterprise|Search|Visual Search,1500000.0,USA,2,7,286,16318,16604,0
Manufacturing,1800000.0,USA,1,1,0,15649,15649,0
Games,67893.0,BGR,2,2,105,15966,16071,0
Analytics,774895.0,DEU,1,2,0,14897,14897,0
Health and Wellness,10880089.0,USA,3,1,285,16127,16412,0
Curated Web,13200000.0,GBR,1,2,0,13496,13496,0
Events|Mobile Payments|Ticketing,70000.0,USA,1,1,0,16472,16472,0
Android|Internet Marketing|iOS|Mobile|Mobile Coupons|Network Security,580000.0,USA,1,1,0,15918,15918,0
Consumer Electronics|Developer APIs|Internet of Things|iOS|Marketing Automation|Mobile|Mobile Payments|Proximity Internet|Technology,2100000.0,HKG,2,2,721,15684,16405,0
Enterprise Software|Identity Management,11500000.0,USA,1,1,0,11737,11737,1
Software,30488.0,FRA,1,2,0,14711,14711,0
Travel,192990.0,ESP,1,1,0,15979,15979,0
Data Security|E-Commerce|Identity Management|Personalization|Privacy,1430000.0,USA,2,2,455,16314,16769,0
Curated Web|Identity|Privacy|Security,646740.0,ITA,2,3,411,14015,14426,1
Manufacturing|Supply Chain Management,56049556.0,USA,5,5,2590,13290,15880,0
Enterprise Software|Mobile Payments|SaaS,7537500.0,USA,4,3,1355,14700,16055,0
Security,3500000.0,FRA,2,2,487,13939,14426,1
File Sharing|Internet|Security,8200000.0,USA,2,5,490,15532,16022,1
Internet|Mobile|Software,1000000.0,PRT,1,2,0,16203,16203,0
Curated Web|Facebook Applications|Flash Storage|Gift Card|Photography|Photo Sharing,357399.0,NLD,5,2,845,15168,16013,0
Finance|FinTech,8350000.0,USA,3,8,1668,12787,14455,1
Clean Energy|Clean Technology,6000000.0,USA,2,2,452,15340,15792,0
E-Commerce,225790.0,SWE,2,2,206,15439,15645,0
Hospitality,40000.0,CHL,1,1,0,15407,15407,0
E-Commerce|Fashion|Kids|Retail|Shopping,1390000.0,FRA,2,10,581,16022,16603,0
Crowdfunding|Investment Management|Portals|Real Estate,24925000.0,USA,3,7,584,15949,16533,0
Software,2000000.0,USA,1,1,0,16651,16651,0
Mobile|Social Network Media,74800000.0,USA,5,53,1166,14914,16080,1
Analytics,8550000.0,USA,5,5,581,12809,13390,0
Curated Web|Social Network Media,1500000.0,USA,1,1,0,15454,15454,0
Career Management|Curated Web,550000.0,USA,2,21,353,13918,14271,0
Event Management|Events|Mobile Social|Networking|Social Network Media|Web Hosting,314169.0,USA,1,1,0,15128,15128,0
Software,8650000.0,USA,5,3,519,16036,16555,0
EdTech|Education|Web Development,11700000.0,USA,4,6,914,15309,16223,1
Enterprise Software,14907283.0,USA,3,3,756,14915,15671,1
Biotechnology,7476374.0,USA,7,11,1960,14168,16128,0
Games,2000000.0,USA,1,5,0,13516,13516,0
Analytics|Business Intelligence,140496.0,ITA,2,3,236,15706,15942,0
Content|Internet Marketing|Mobile Software Tools|Predictive Analytics,400000.0,CAN,2,4,369,15853,16222,0
Corporate Training|Education|Training,1500000.0,USA,1,4,0,16399,16399,0
Biotechnology|Health Diagnostics,19500000.0,USA,1,1,0,14621,14621,0
Analytics|Mobile|Retail|Tracking,1000000.0,GBR,2,2,1917,13514,15431,0
Biotechnology|Health Diagnostics,24010453.0,USA,5,10,1380,14628,16008,0
Biotechnology,4960000.0,FRA,1,3,0,15897,15897,0
Computers|Software|Technology,15000000.0,USA,1,5,0,12557,12557,1
Biotechnology|Environmental Innovation|Life Sciences|Manufacturing,2423894.0,USA,4,3,1481,14953,16434,0
Health Care|Medical|Medical Devices,52433800.0,USA,2,5,564,14304,14868,1
Biotechnology,24400000.0,USA,5,9,1721,14048,15769,0
Advertising|Career Management|Digital Media|Internet|Recruiting,4500000.0,USA,2,4,677,14379,15056,0
Biotechnology|Health Diagnostics,63500000.0,USA,4,13,1831,13057,14888,0
Biotechnology,8333219.0,USA,3,1,451,16294,16745,1
Software,7000000.0,USA,1,2,0,16520,16520,0
Finance Technology|FinTech|Health and Wellness|Health Care|Medical|SaaS,3750000.0,USA,1,2,0,15570,15570,0
Physicians|Software,93708653.0,USA,10,30,4517,11170,15687,1
Payments|Software,6483800.0,USA,3,1,1397,14820,16217,0
Health Care,9600000.0,USA,1,5,0,16755,16755,0
Internet,13300000.0,USA,2,2,206,16556,16762,0
Health and Wellness|Health Care Information Technology|Startups,6506633.1532467,GBR,5,6,2417,14354,16771,0
Mobile,71857804.0,USA,6,15,1652,14489,16141,0
Health and Wellness|Medical|Social Media,27000000.0,USA,4,2,2326,13549,15875,0
Artists Globally|Curated Web|Music|Video,17100000.0,USA,2,23,326,15918,16244,0
Software,42607.0,TUR,1,1,0,16071,16071,0
Analytics|Information Services|Information Technology,3600000.0,SGP,1,2,0,16310,16310,0
Biotechnology,150000.0,USA,1,1,0,15785,15785,0
Content Discovery|E-Commerce|SaaS|Social Media,80000.0,GBR,1,1,0,16721,16721,0
Clean Technology,4123210.0,GBR,3,2,1390,15243,16633,0
Messaging,3008197.0,GBR,2,3,1134,13483,14617,0
Consumer Electronics|Human Computer Interaction|Productivity Software,200000.0,USA,2,6,582,15949,16531,0
Data Security|Security,409299.0,USA,1,1,0,14396,14396,1
Finance,2300000.0,USA,2,2,184,15132,15316,0
Business Services|Software,500000.0,USA,1,2,0,16526,16526,0
E-Commerce,2500000.0,AUS,3,1,458,15584,16042,0
Marketplaces,1500000.0,USA,1,2,0,16419,16419,0
Pets|SaaS,35000.0,USA,1,1,0,16085,16085,0
Point of Sale,20000000.0,CHN,1,1,0,14304,14304,0
Consumer Electronics,46700000.0,USA,1,4,0,16596,16596,0
Clean Technology,6000000.0,USA,1,1,0,13942,13942,0
Software,5400000.0,USA,2,1,29,16132,16161,0
Data Integration|Software,27492752.0,USA,3,7,1029,15658,16687,0
E-Commerce,40000.0,CHL,1,1,0,15672,15672,0
Web Hosting,5400000.0,USA,1,3,0,13055,13055,0
Software,2200000.0,USA,3,3,872,12053,12925,0
Biotechnology,129606472.0,USA,7,7,1722,14557,16279,0
Biometrics|Marketing Automation|Payments,25000000.0,USA,1,2,0,12573,12573,0
E-Commerce,7000000.0,USA,2,28,428,15833,16261,1
FinTech|Freelancers|Marketplaces|Payments|SaaS|Small and Medium Businesses|Software,2100000.0,USA,1,10,0,16652,16652,0
Application Platforms|Payments|Services,4349998.0,USA,1,1,0,16233,16233,0
E-Commerce|Payments,40000.0,HKG,1,1,0,15777,15777,0
Coupons|Discounts|Fitness|Health Care|Search,5735450.0,GBR,5,7,1508,14914,16422,0
Business Services|Finance|Finance Technology|FinTech|SaaS|Software|Tracking,1350000.0,USA,4,1,1069,15570,16639,0
E-Commerce|Mobile Payments|Payments|Web Development,1080450.0,IRL,1,1,0,14609,14609,0
FinTech|Mobile|Mobile Commerce|Mobile Payments|Payments,9705062.0,USA,5,8,663,15765,16428,0
Enterprise Software,8500000.0,USA,1,5,0,12900,12900,1
Mobile Commerce|Mobile Payments,34600000.0,USA,3,11,930,15027,15957,1
Social Media,1310000.0,USA,3,1,1198,14259,15457,1
E-Commerce,1350000.0,USA,1,4,0,15548,15548,0
E-Commerce,14500000.0,USA,1,5,0,13458,13458,1
E-Commerce|Finance|Financial Services|FinTech,811022.6539485359,DEU,4,2,639,15979,16618,0
E-Commerce|Finance|FinTech|Mobile Payments|Payments|Point of Sale|SaaS|Transaction Processing,23491958.0,CAN,8,6,1607,14975,16582,0
Mobile,45500000.0,USA,5,12,2724,14000,16724,0
Finance|FinTech,10000000.0,ISR,2,1,769,15805,16574,0
Internet|Mobile Payments,100000.0,USA,1,1,0,16375,16375,0
Software,10000000.0,USA,1,1,0,14015,14015,1
Curated Web|Payments,9000000.0,NOR,1,3,0,14000,14000,0
E-Commerce|FinTech,14000000.0,IND,2,5,701,13330,14031,0
Finance,3600000.0,USA,2,3,1497,13735,15232,0
Payments|Security,30500000.0,USA,6,6,3137,12809,15946,0
E-Commerce|Games|Payments|Subscription Businesses,18000000.0,DEU,3,4,198,15553,15751,0
Finance|Mobile,185000.0,IRL,2,3,335,15614,15949,0
Finance,1124560.01589378,FRA,1,5,0,16680,16680,0
E-Commerce|Government Innovation|Payments|Property Management|Utilities,71199988.0,USA,7,25,2166,14365,16531,0
Finance Technology|Financial Services|FinTech|Personal Finance,34800000.0,USA,5,29,1682,14706,16388,0
E-Commerce|Finance|Internet|Mobile|Payments,90000000.0,USA,12,22,3875,12784,16659,0
E-Commerce|Finance|FinTech|Mobile Payments|P2P Money Transfer|Payments,197000000.0,USA,5,23,777,10592,11369,1
Advertising|Direct Marketing|Games|Social Media|Social Network Media,200000.0,USA,2,4,102,14214,14316,0
Crowdsourcing|Customer Service|Subscription Businesses,40000.0,CHL,1,1,0,15324,15324,0
Financial Services|Payments|Transaction Processing,900000.0,USA,1,8,0,16495,16495,0
Mobile|Mobile Payments,22356.0,CAN,1,1,0,15461,15461,0
Mobile Payments|Payments|Vending and Concessions,15155067.0,USA,3,8,378,16232,16610,0
Enterprise Software,1000000.0,USA,1,8,0,15755,15755,0
Databases|Human Resources|Software,33386478.0,USA,8,18,2468,12692,15160,1
Accounting|Credit Cards|Payments|Software,16000000.0,USA,1,1,0,15245,15245,0
Bitcoin|E-Commerce|Payments|SaaS,2660000.0,USA,5,11,441,16066,16507,0
Banking|E-Commerce|Financial Services|FinTech|Mobile Commerce|P2P Money Transfer|Social Entrepreneurship|Social Fundraising,275000.0,MEX,2,1,448,16252,16700,0
Biometrics|Mobile Payments|Software,700000.0,USA,1,2,0,15706,15706,0
Financial Services,25000000.0,USA,1,1,0,16248,16248,0
E-Commerce|Online Shopping,700000000.0,IND,3,4,200,16507,16707,0
E-Commerce|Payments,15000.0,USA,1,2,0,15423,15423,0
Biometrics|Loyalty Programs|Payments|Software|Startups|Technology,2688237.0,ESP,9,2,1568,14488,16056,0
Online Shopping|Payments|Transaction Processing,1029280.0,FIN,1,1,0,16093,16093,0
Finance,6650000.0,USA,2,1,683,15205,15888,0
Developer APIs|E-Commerce|Facebook Applications|Services,7750000.0,USA,3,4,698,14245,14943,1
Bitcoin|Cryptocurrency|Financial Exchanges|Financial Services,6500000.0,USA,2,13,998,15156,16154,0
E-Commerce,482786.0,SGP,1,1,0,15645,15645,1
Business Development|Business Intelligence|Business Services,2999989.0,USA,1,1,0,16211,16211,0
Lasers|Project Management|Television,1500000.0,ISR,2,2,308,12961,13269,0
Cloud Computing|Collaboration|Enterprises|Enterprise Software|Productivity Software|Social Media|Web Tools,13343716.0,USA,8,9,3270,13402,16672,0
Software,5500000.0,USA,1,2,0,16233,16233,0
Hardware + Software,77000000.0,IRL,3,14,1009,14123,15132,0
Web Hosting,5250000.0,USA,1,4,0,15608,15608,0
Web Hosting,25000000.0,USA,1,2,0,15531,15531,0
Biotechnology,5500000.0,AUT,1,2,0,14641,14641,0
Consulting,458000.0,GBR,1,1,0,13262,13262,0
Advertising,6220000.0,GBR,2,2,672,11079,11751,0
Databases|Enterprise Software|SaaS|Sustainability,13131976.0,DEU,2,3,173,16141,16314,0
Fashion,1561865.0,USA,1,1,0,16076,16076,0
Apps|Fashion|Online Auctions,500000.0,USA,1,1,0,16366,16366,0
Delivery|Location Based Services|Restaurants,10700000.0,USA,2,2,404,16261,16665,0
Real Estate,179520.0,GBR,1,1,0,16252,16252,0
E-Commerce|Emerging Markets|Mobile Payments|Payments,67983.0,ZAF,1,1,0,15737,15737,0
Financial Services|Insurance|Software,550000.0,USA,3,3,897,15771,16668,0
Business Services|Data Centers|Homeland Security|Infrastructure|SaaS|Services|Virtualization|Web Hosting,12700000.0,USA,2,4,1637,11782,13419,1
Health Care,29000000.0,USA,2,5,504,13409,13913,1
Software,5000000.0,USA,1,1,0,13931,13931,0
Cloud Infrastructure|Digital Media|E-Commerce|Internet|Marketplaces|SaaS,225000.0,ISR,1,3,0,15737,15737,0
Life Sciences|Medical|Pharmaceuticals,1967780.86792255,GBR,1,1,0,13887,13887,0
Software,22000000.0,USA,2,5,505,12904,13409,1
Social Media,4200000.0,USA,2,3,748,13180,13928,1
Education|Presentations,555000.0,USA,3,1,474,16121,16595,0
Health and Wellness,6988095.0,USA,3,3,428,16154,16582,0
Accounting|Business Services|CRM|Curated Web|Small and Medium Businesses|Startups,24500000.0,USA,4,8,1404,14784,16188,0
Biotechnology|Health and Wellness|Medical|Pharmaceuticals,247500100.0,USA,7,25,2033,13763,15796,1
Software,2240000.0,BEL,1,1,0,14572,14572,0
Green|Home & Garden|Home Renovation,50000.0,USA,1,1,0,14903,14903,0
E-Commerce,9615000.0,USA,4,26,1201,15309,16510,0
Data Integration|Enterprise Software|High Tech,32000000.0,USA,2,1,775,15933,16708,0
Hardware + Software|Wearables,46013986.0,USA,4,7,1408,15082,16490,0
Direct Advertising|Direct Marketing,3000000.0,USA,2,21,368,16346,16714,0
Hardware + Software|Mobile,11450000.0,ISR,2,10,781,15137,15918,1
Medical Devices|Product Development Services|Technology,1293671.0,USA,2,1,679,15882,16561,0
Biotechnology,1587246.0,GBR,1,3,0,15401,15401,0
Marketplaces|Mobile Commerce,18405.9016683109,MMR,2,1,119,16534,16653,0
Marketplaces,55000000.0,USA,2,4,205,10917,11122,0
Internet|Services|Telecommunications,20000000.0,USA,1,3,0,12437,12437,1
Software,5280000.0,USA,1,1,0,12097,12097,0
E-Commerce|Hospitality|Marketplaces,7500000.0,URY,4,3,786,15218,16004,1
Mobile|Social Business|Telecommunications,532707.0,ITA,2,4,520,15902,16422,0
3D|Cloud Computing|E-Commerce|Enterprise Software|Finance|Mass Customization|Photography|Printing,1511971.0,NLD,2,3,1164,15358,16522,0
Apps|Chat|Cloud Computing|Electronics|Email|Messaging|Mobile,5576096.0,USA,3,1,1319,13879,15198,0
Curated Web|E-Commerce|Internet|Marketplaces|Mobile|Network Security|SaaS|Tourism|Travel,6900000.0,USA,3,21,673,15340,16013,0
Analytics,2350000.0,USA,2,3,415,16054,16469,0
E-Books|E-Commerce|Education|Teachers,150000.0,USA,1,2,0,16279,16279,0
Apps|Media|News|Printing,79480.0,GBR,1,1,0,15824,15824,0
Databases|Search|Social CRM|Social Media,1825000.0,USA,5,7,1826,13361,15187,0
Digital Entertainment|Mobile|Software,86700000.0,USA,4,6,2107,14245,16352,0
Human Resources,2000000.0,IND,1,2,0,16279,16279,0
Digital Media|Media|Mobile,4875000.0,USA,2,2,153,16133,16286,0
Consumer Electronics|Gadget|Home Automation|Internet of Things|Security,50000.0,USA,1,1,0,16071,16071,0
Hospitality|Leisure|Media|Mobile|Social Media|Travel|Video,260000.0,USA,1,1,0,15979,15979,0
Mobile|Professional Services|Social Media|Video|Video Chat,40000.0,USA,1,1,0,15638,15638,0
Messaging,28000.0,USA,1,1,0,15896,15896,0
Advertising,29915001.0,USA,7,11,2155,13208,15363,1
Analytics|B2B|Market Research|SaaS|Surveys,750000.0,USA,1,1,0,16034,16034,0
Internet Service Providers|Mobile|Peer-to-Peer|Software,22500000.0,USA,4,12,2438,12799,15237,0
Curated Web|Finance,2464160.0,NLD,6,6,1125,15248,16373,0
Advertising|Entertainment,10000000.0,USA,2,5,214,12843,13057,1
Finance|FinTech|Personal Finance,2900000.0,USA,3,1,1193,14975,16168,0
Analytics|Business Services|Finance|FinTech|Reviews and Recommendations|SEO|Social Media,3799671.0,GBR,3,16,1923,14426,16349,1
Big Data Analytics|Credit|Financial Services|FinTech|Peer-to-Peer|Risk Management,8500000.0,USA,2,9,158,16534,16692,0
Reviews and Recommendations,2012004.0,GBR,2,2,1900,14304,16204,0
Big Data|Education|Publishing,950000.0,USA,1,1,0,15502,15502,0
Web Hosting,25065701.0,USA,2,1,1340,14376,15716,0
B2B|Networking|Reviews and Recommendations|Social Media|Social Network Media,3000000.0,USA,2,4,137,16136,16273,0
Games|VoIP,5000000.0,USA,1,3,0,12784,12784,0
Big Data|Data Privacy|Data Security|Financial Services,19588164.0,USA,3,7,281,16421,16702,0
Curated Web|Natural Language Processing|Neuroscience|Semantic Search|Social Search,2800000.0,USA,1,4,0,14649,14649,0
Analytics,310000.0,NLD,1,3,0,15667,15667,0
Education,4000.0,USA,1,1,0,15767,15767,0
Business Services|Collaborative Consumption|Coworking|Peer-to-Peer|Small and Medium Businesses|Startups,7800000.0,USA,3,7,419,16330,16749,0
Crowdfunding|Marketplaces|Real Estate,6100000.0,USA,1,9,0,16664,16664,0
Finance|Payments,43200000.0,USA,5,25,1538,14910,16448,0
Curated Web|Human Resources|Psychology|Skill Assessment,144860.0,NLD,2,3,595,14623,15218,0
Chemicals|Specialty Chemicals|Water,64569.0,FRA,1,1,0,15849,15849,0
Biotechnology,21047369.0,USA,2,4,758,13643,14401,0
Hardware + Software,9800000.0,ISR,2,6,425,12840,13265,1
Mobile,20000000.0,USA,1,2,0,13301,13301,0
Human Resources|Recruiting|Service Providers|Software,16780346.0,USA,2,2,15,16433,16448,0
News|Publishing|Social Media|Social Network Media,150000.0,USA,1,1,0,14975,14975,0
Gps|Maps|Mobile|Reviews and Recommendations|Social Network Media|Software,22400000.0,USA,3,10,573,13453,14026,1
Clean Technology,7889170.0,GBR,1,4,0,14190,14190,0
Software|Video,37000000.0,USA,5,17,1476,14467,15943,0
Commercial Solar|Energy Efficiency|Renewable Energies,1500000.0,USA,1,1,0,16207,16207,0
Biotechnology,94000000.0,USA,2,3,392,13853,14245,0
Consumer Electronics|Electronics|Retail|Technology,14150000.0,GBR,2,5,811,12221,13032,0
Android|Fitness|Hardware + Software|Video Streaming,119707000.0,USA,6,6,1400,15371,16771,0
Automotive|Heavy Industry|Technology|Transportation,16900000.0,USA,3,15,843,15796,16639,0
Biotechnology,18000000.0,USA,1,2,0,15182,15182,0
3D Printing|Biotechnology|GreenTech,50000.0,USA,1,1,0,16451,16451,0
Clean Technology,963841.0,CHE,1,2,0,16073,16073,0
Security,150000.0,USA,2,1,1044,14412,15456,0
Health and Wellness,1115155.0,USA,1,1,0,16069,16069,0
Analytics|Data Integration|SaaS,13250000.0,USA,4,11,665,16071,16736,0
Cloud Data Services|Financial Services|FinTech|Software,1020000.0,USA,1,1,0,14228,14228,0
Software,19392757.0,USA,6,15,1898,13186,15084,1
Bio-Pharm|Medical|Pharmaceuticals,80000000.0,USA,2,12,445,11988,12433,1
Home Renovation|Manufacturing,50000.0,USA,1,1,0,14568,14568,0
E-Commerce,10000000.0,USA,1,1,0,14868,14868,0
Apps|Education|FinTech|Internet|K-12 Education|Mobile|Payments|Software,1300000.0,USA,1,3,0,16582,16582,0
Advertising|Analytics|Curated Web|Publishing,50000.0,USA,1,1,0,16071,16071,0
Senior Health,250000.0,USA,2,1,75,16556,16631,0
Investment Management,460000.0,SWE,1,1,0,16686,16686,0
Hardware + Software,6000000.0,CHN,1,1,0,14153,14153,0
Technology,62046.0,LVA,1,1,0,16415,16415,0
Clean Energy|Electronics|Manufacturing,14000000.0,USA,1,1,0,13774,13774,0
Manufacturing,3260675.0,GBR,1,1,0,14589,14589,0
Analytics|Big Data|Business Intelligence|Data Integration|Data Visualization|Open Source|Predictive Analytics,71995394.0,USA,5,8,2518,13125,15643,1
Clean Technology,15000000.0,ISR,5,8,1080,14815,15895,0
Mobile,11499293.0,USA,7,5,3080,13154,16234,0
Consumer Electronics|iPad|iPhone|Mobile|Presentations,508295.0,USA,2,1,65,15675,15740,0
Analytics|Health and Wellness|Health Care|Optimization,1175000.0,USA,2,2,205,16181,16386,0
Credit Cards|Education|Finance|Financial Services|Networking|Peer-to-Peer,2500000.0,USA,1,2,0,14414,14414,0
Curated Web,8000000.0,IND,1,1,0,13217,13217,0
Analytics,4500000.0,USA,1,2,0,16069,16069,0
Curated Web|Employment|Freelancers|Human Resources|Outsourcing,10518674.0,GBR,4,4,1386,14245,15631,0
Cloud Computing|Curated Web|Energy Management|Internet of Things|Mobile,5564000.0,USA,3,5,1368,15340,16708,0
E-Commerce|SaaS|Web CMS,25000.0,USA,1,1,0,14700,14700,0
Software,17000000.0,USA,1,2,0,13776,13776,1
Human Resources|Innovation Engineering|SaaS,47479335.0,USA,3,9,1289,15419,16708,0
Software,4500000.0,USA,1,2,0,13161,13161,1
FinTech,1300000.0,KOR,1,3,0,16647,16647,0
Sales and Marketing|Software,8160983.0,USA,3,3,884,15783,16667,0
Cloud Computing|Enterprise Software|Finance|Search,118000.0,USA,2,1,72,15853,15925,0
Enterprise Software,63400000.0,USA,5,20,1358,14648,16006,0
Software,1000000.0,USA,1,1,0,16770,16770,0
Databases|Enterprise Software|Software,6000000.0,GBR,1,3,0,16491,16491,0
Biotechnology|Medical|Therapeutics,1413319.0,FRA,1,2,0,16552,16552,0
Broadcasting,50326957.0,DEU,1,2,0,12006,12006,1
Bio-Pharm|Clinical Trials|Medical,7500000.0,USA,1,4,0,12634,12634,0
Software,10000000.0,USA,1,2,0,13091,13091,1
Real Time|Software|Technology,20000000.0,USA,3,14,896,15645,16541,0
E-Commerce,128000000.0,IND,4,5,1323,15320,16643,0
Apps|Mobile Payments|Software,1701223.85012733,GBR,1,1,0,16728,16728,0
Biotechnology,676000.0,DEU,1,1,0,14699,14699,0
Apps|Groceries|Online Shopping,47200000.0,IND,3,9,203,16504,16707,0
Event Management|Events|Promotional,20106.0,EST,1,1,0,16283,16283,0
Biotechnology,14809800.0,NLD,2,8,438,12972,13410,0
Biotechnology|Medical|Services,68760000.0,USA,3,15,1954,12123,14077,1
Semiconductors,37230769.0,CAN,3,12,1850,14522,16372,0
Software,3800000.0,USA,2,3,1346,14873,16219,0
Medical Devices,12900000.0,USA,1,6,0,12363,12363,0
Software,2150000.0,USA,2,1,385,15979,16364,0
Semiconductors,12000000.0,ISR,1,3,0,14131,14131,1
E-Commerce|Fashion|File Sharing|Kids|Shopping|Social Commerce,5989049.0,ESP,4,11,932,15763,16695,0
Cyber Security|Information Security|Network Security,2000000.0,ISR,1,2,0,16744,16744,0
BPO Services|Consulting|Contact Centers|Customer Service|Information Services|Outsourcing,7500000.0,USA,2,1,1021,14861,15882,1
Film|Film Production|Media|Robotics,120000.0,CAN,2,2,244,16161,16405,0
Medical|Medical Devices,950000.0,USA,3,2,33,16641,16674,0
Hardware|Mechanical Solutions|Software,1000000.0,ISR,2,2,352,16306,16658,0
Software,1000000.0,USA,1,5,0,15601,15601,0
Consumer Goods|Design,750000.0,USA,1,1,0,16495,16495,0
Retail Technology,1123503.0,USA,1,2,0,16553,16553,0
Local Commerce|Retail Technology|Specialty Retail,5000000.0,USA,2,11,529,15918,16447,0
Brand Marketing|Content|Enterprise Software|Information Technology|Infrastructure|Sales and Marketing|Social Media,74500000.0,USA,4,29,1246,15323,16569,0
Health Care Information Technology|Healthcare Services|Medical Devices,19500000.0,USA,2,6,730,11323,12053,1
Semiconductors,40600000.0,USA,2,18,631,12093,12724,1
Advertising,1100000.0,USA,1,11,0,15618,15618,1
Auctions|Marketplaces|Software|Trading,3427846.0,GBR,1,1,0,16261,16261,0
Procurement|Public Relations|SaaS|Software,30000000.0,DEU,1,11,0,13104,13104,0
Travel,2500000.0,USA,1,3,0,13604,13604,0
Fitness|Software,30000.0,POL,1,1,0,16428,16428,0
Advertising|Analytics|Journalism|Publishing|Sales and Marketing|SEO|Social Media|Software,30600000.0,USA,3,8,923,14069,14992,1
Education,600000.0,FRA,1,1,0,15951,15951,0
Consumer Goods|Services,95000.0,GBR,1,1,0,16538,16538,0
E-Commerce|Events|Local|Services,40000.0,USA,1,1,0,15380,15380,0
Application Performance Monitoring|Mobile|Testing,92800000.0,USA,5,17,3176,13574,16750,0
Health and Wellness|Health Care|Physicians,32900000.0,USA,3,12,5480,11228,16708,0
Biotechnology,456438.0,GBR,2,3,678,15875,16553,0
Consulting|Information Technology|Internet,28305854.0,USA,3,1,4475,11694,16169,1
Biotechnology,32700000.0,IND,4,10,1858,13848,15706,0
iPad|Sports,460000.0,GBR,3,5,651,15238,15889,0
Advertising|Analytics|Marketing Automation|Optimization|Sales and Marketing|Software|Web Design,3000000.0,USA,1,1,0,14624,14624,1
Enterprise Software,13100000.0,GBR,4,8,1392,14944,16336,0
Brand Marketing|Online Shopping|Shopping,48500000.0,USA,1,4,0,15431,15431,0
Agriculture|Biofuels|Biotechnology,13000000.0,CAN,1,2,0,14082,14082,0
Software,1060000.0,USA,1,1,0,13057,13057,1
Business Services|Retail|Technology,25000000.0,USA,1,3,0,11738,11738,0
Software,13000000.0,USA,1,2,0,12227,12227,1
Computers|Software|Technology,20700000.0,USA,2,5,805,11722,12527,0
Networking|Software|Stock Exchanges,30540000.0,USA,2,7,587,11758,12345,0
Medical Devices,5000000.0,CAN,1,4,0,16638,16638,0
Social Media,14000.0,USA,1,1,0,14761,14761,0
Analytics|B2B|Big Data|SaaS,9500000.0,USA,3,11,1085,15645,16730,0
Software,1300000.0,USA,1,1,0,15455,15455,0
Banking|Finance|Personal Finance,16000000.0,USA,3,3,860,14245,15105,0
Bio-Pharm|Medical|Pharmaceuticals,52500000.0,IND,1,3,0,13056,13056,0
Biotechnology,104000000.0,USA,2,24,762,12080,12842,0
Biotechnology|Medical|Pharmaceuticals,4700000.0,USA,2,2,92,16282,16374,0
Software,12000000.0,USA,1,1,0,13025,13025,0
Information Services|Security|Software,12000000.0,USA,2,3,244,11961,12205,1
Finance,5421200.0,ITA,1,5,0,15012,15012,0
Entertainment|Games|Publishing|Television|Video|Video on Demand,9000000.0,USA,3,20,942,12723,13665,0
Software,1409067.0,GBR,2,2,537,16040,16577,0
Enterprise Software,62000000.0,USA,3,18,962,15340,16302,0
Biotechnology,4657479.0,USA,3,1,1407,15324,16731,0
Social Media,55500.0,HKG,1,1,0,15553,15553,0
Mobile,117266.0,ESP,3,1,168,16112,16280,0
Wireless,12192650.576916,GBR,3,6,2799,13798,16597,0
Advertising|Analytics|Market Research|Sales and Marketing,36000000.0,USA,2,5,708,15749,16457,0
Security,4700000.0,USA,2,3,808,13392,14200,1
Cloud Data Services|Content Delivery|Financial Services|IT Management|Telecommunications|Wireless,20500000.0,USA,1,1,0,16546,16546,0
Hardware + Software,25541542.0,USA,5,3,910,15674,16584,0
Sales Automation,1820000.0,USA,2,5,379,16267,16646,0
Apps|Payments,3829.0,AUS,1,1,0,16618,16618,0
Mobile|Security,26275434.0,USA,6,6,1820,14679,16499,0
Finance|FinTech|Wealth Management,102300000.0,USA,6,19,1946,14426,16372,0
Software,38745.0,GBR,1,1,0,15255,15255,0
Manufacturing,4532040.0,ITA,2,4,1334,14582,15916,0
Biotechnology|Health Diagnostics,24300000.0,USA,3,3,1853,14883,16736,0
Health Care,3251500.0,DEU,1,2,0,15819,15819,0
Customer Service|Lifestyle|Wine And Spirits,439280.0,USA,2,2,458,13634,14092,0
E-Commerce|Fashion|Retail,386386.0,ECU,2,2,151,15979,16130,0
Biotechnology,75000000.0,USA,3,4,1247,15201,16448,0
Beauty|Cosmetics|E-Commerce|Flash Sales|Social Commerce|Subscription Businesses,103235793.0,USA,3,4,1372,15320,16692,0
EdTech|Education|Events|Facebook Applications|Lifestyle|News|Personalization|Printing|Private Social Networking|Publishing|Social Media|Startups|Technology,1534000.0,ZAF,3,4,1140,13879,15019,0
Messaging,21000000.0,USA,2,5,361,12761,13122,0
Finance|FinTech,18000000.0,USA,2,5,755,15119,15874,0
Software,17000.0,USA,1,1,0,15584,15584,0
Computers|Kinect|Presentations|Software|Technology|Video,7237193.0,USA,7,5,1628,14914,16542,0
Cloud Security|CRM|Enterprise Software|IaaS|PaaS|SaaS,20000000.0,CAN,3,6,1196,14638,15834,1
Big Data Analytics|IT Management|Machine Learning|SaaS,4000000.0,USA,1,1,0,16602,16602,0
Software,25892230.0,USA,5,12,2587,12265,14852,1
Cloud Infrastructure|Cloud Security|Enterprise Software|Mobile Infrastructure|Mobile Security|Networking|Network Security,28850000.0,USA,2,13,338,15433,15771,0
Biotechnology,40030000.0,USA,4,12,1994,12493,14487,0
Analytics|Big Data Analytics|Health and Insurance|Health Care|Health Care Information Technology|Hospitals|Pharmaceuticals,20993787.0,USA,3,4,757,15685,16442,0
Collaboration|Public Relations,5500000.0,USA,2,2,268,15927,16195,1
Clean Technology,8000000.0,USA,1,1,0,13838,13838,0
E-Commerce|E-Commerce Platforms|Fashion|Real Time,20000.0,USA,1,1,0,16679,16679,0
News|Publishing|SaaS|Social Media,71739591.0,USA,6,17,2958,13514,16472,0
Hospitality,5000000.0,USA,1,1,0,11985,11985,0
Pets,18000000.0,USA,1,2,0,15153,15153,1
E-Commerce|Pets,2165001.0,USA,2,2,332,16105,16437,0
Health and Wellness|Pets|Veterinary,300000.0,USA,1,1,0,16295,16295,0
Consumer Electronics|Hardware|Hardware + Software|Internet of Things|Mobile|Pets|Robotics,1441000.0,USA,6,11,613,15898,16511,0
Pets,15000000.0,USA,2,3,239,14922,15161,0
QR Codes|Software,3556071.0,USA,4,1,799,15504,16303,0
Consumers|Insurance|Pets,200000.0,USA,2,1,1188,15156,16344,0
Pets,20000.0,USA,1,1,0,14396,14396,0
Clean Technology,53999987.0,USA,2,6,992,13656,14648,0
Software,6000000.0,USA,2,3,722,14265,14987,0
Clean Technology,2000000.0,USA,1,1,0,16105,16105,0
Robotics,25000.0,USA,1,2,0,16251,16251,0
E-Commerce,15000000.0,USA,1,3,0,10935,10935,0
E-Commerce|Internet|Pets,4797852.0,BRA,2,3,1411,15187,16598,0
E-Commerce,1700000.0,MEX,1,5,0,16047,16047,0
Electronics|Technology,1259105.0,PRT,1,1,0,16050,16050,0
Advertising,162364.0,CHN,1,1,0,16040,16040,0
Biotechnology,2050880.0,ESP,1,3,0,15799,15799,0
Mobile|Software,5704626.0,USA,4,8,1301,14335,15636,0
Software,2500000.0,USA,1,1,0,16028,16028,0
Games,20395.0,DEU,1,1,0,15737,15737,0
Biotechnology,24000000.0,USA,1,2,0,14587,14587,1
Analytics|Data Integration|Enterprise Software|FinTech|Government Innovation|SaaS,611000.0,USA,6,9,805,15826,16631,0
Software,65277712.0,USA,5,9,2750,11900,14650,1
Security,8500000.0,USA,1,3,0,13662,13662,1
Public Relations,785366.0,GBR,1,1,0,15743,15743,0
Games,1100000.0,CAN,1,1,0,14288,14288,0
Enterprise Software,40000.0,CHL,1,1,0,15538,15538,0
Biotechnology,29307140.0,GBR,3,2,994,14853,15847,0
Medical Devices,2400000.0,USA,1,2,0,16706,16706,0
Curated Web|Photo Sharing,5000000.0,USA,4,3,730,13088,13818,0
Manufacturing,1500000.0,CHN,1,1,0,16010,16010,0
Cyber Security|Enterprise Security|Information Security|Network Security,9200000.0,USA,2,10,167,16539,16706,0
Information Security|Mobile,440324.24316753,BGR,4,3,426,16222,16648,0
Health and Wellness|Health Care|Medical|Pharmaceuticals,14561807.0,FRA,5,9,1979,12539,14518,0
Biotechnology,8000000.0,ISR,1,2,0,15636,15636,0
Biotechnology,6000000.0,KOR,1,4,0,14503,14503,0
Biotechnology,40193778.0,USA,4,3,1553,12916,14469,0
Investment Management,32900000.0,CAN,2,1,58,16288,16346,0
Eyewear|Manufacturing|Medical Devices,2642473.35506034,NLD,1,2,0,13572,13572,0
Biotechnology,7630000.0,USA,1,10,0,12991,12991,1
Biotechnology|Health Diagnostics,3700000.0,BEL,1,1,0,14630,14630,0
Biotechnology,10000000.0,USA,1,1,0,15985,15985,0
Biotechnology,19521926.0,SWE,2,2,638,15343,15981,0
Biotechnology,40000000.0,USA,1,3,0,15029,15029,0
Health Care Information Technology,7885002.0,USA,4,4,1359,14509,15868,0
Biotechnology,19300000.0,USA,1,4,0,14452,14452,1
Biotechnology,11829936.0,USA,5,1,2839,13920,16759,0
Pharmaceuticals,40000000.0,USA,1,6,0,11976,11976,1
E-Commerce|Health Care|Medical|Pharmaceuticals,20000.0,USA,1,1,0,15867,15867,0
Health and Wellness,8800000.0,USA,1,3,0,14589,14589,0
Bio-Pharm|Pharmaceuticals|Therapeutics,8000000.0,USA,1,1,0,12206,12206,0
Medical|Medication Adherence|Services,3100000.0,USA,4,3,604,16119,16723,0
Biotechnology,19941400.0,FRA,3,5,605,14774,15379,0
Apps|Internet|Software,15000.0,USA,1,1,0,16165,16165,0
Health Care,6751000.0,GBR,3,7,1601,13923,15524,0
Clinical Trials|Software,25000000.0,USA,1,8,0,11193,11193,1
Biotechnology,870000.0,SWE,1,1,0,14327,14327,0
Software,100000000.0,CAN,1,1,0,14614,14614,0
Hardware + Software,2369248.0,GBR,2,2,984,14393,15377,0
Biotechnology,144124067.0,USA,6,13,2696,13810,16506,0
Biotechnology,27019304.0,USA,5,3,2043,13937,15980,0
Hardware + Software,3208103.0,GBR,2,3,952,13389,14341,0
Automotive|Consumer Electronics|Digital Media,4530000.0,USA,3,5,346,12040,12386,0
Enterprise Software,4000000.0,USA,3,5,491,15280,15771,1
iOS|Mobile Commerce|Photo Sharing|Social Media,3500000.0,USA,2,1,539,15410,15949,1
Advertising,6600000.0,USA,2,2,457,12843,13300,0
Biotechnology,15000000.0,CAN,2,6,505,16153,16658,0
Biotechnology,12921240.0,DEU,2,7,1806,13067,14873,1
Information Technology,6000000.0,USA,1,3,0,16728,16728,0
Biotechnology,72955935.0,USA,3,18,2921,11757,14678,0
Pharmaceuticals,2366952.0,FRA,1,1,0,16405,16405,0
Internet,1725000.0,USA,2,4,461,16297,16758,0
Hardware + Software|Health Diagnostics,250000.0,USA,1,3,0,16015,16015,0
Apps|Facebook Applications|Games|iPhone|Social Media,85523.0,NOR,2,2,1155,14610,15765,0
Nonprofits,5000000.0,USA,1,1,0,15966,15966,0
Design|Energy|Industrial,5000000.0,USA,1,1,0,12006,12006,1
Curated Web|Television,18833000.0,USA,3,13,705,15896,16601,0
Coffee|E-Commerce,30000000.0,USA,2,35,657,15827,16484,0
Security|Software,8200000.0,USA,2,2,1024,15740,16764,0
Cyber Security|Enterprise Security|Enterprise Software|Information Security,15500000.0,USA,2,4,973,15547,16520,0
Sports,7900000.0,USA,2,1,833,15181,16014,0
Software,5000000.0,USA,1,1,0,15460,15460,0
Consulting,397307.0,GBR,1,1,0,15249,15249,0
Innovation Engineering|Mechanical Solutions|Semiconductors,3248067.0,USA,1,1,0,16500,16500,0
Software,20300000.0,USA,1,1,0,14777,14777,1
Messaging|Mobile|VoIP,2400000.0,USA,9,11,2187,14197,16384,0
Android|Gps|Insurance|Internet of Things|iPhone|Mobile|Mobile Software Tools,11948000.0,USA,5,2,1138,15576,16714,0
Mobile,550000.0,IND,1,1,0,16048,16048,0
CRM|Mobile|Politics|SMS,624000.0,USA,2,3,444,15584,16028,0
E-Commerce,15919005.602175102,FRA,1,2,0,14636,14636,0
Android|Apps|iPhone|Mobile,100000.0,USA,1,1,0,14978,14978,0
Apps|Local Search|Mobile|Search,1000000.0,USA,1,4,0,14753,14753,0
Software,6204822.0,CHN,2,2,1124,13910,15034,0
Curated Web|Databases|Mobile,2060000.0,USA,2,1,245,13300,13545,0
Audio|Social Media,750.0,USA,1,3,0,16244,16244,0
Advertising,534000.0,FRA,1,2,0,15722,15722,0
Hardware + Software,77500000.0,USA,4,9,2176,14245,16421,0
Events,600000.0,USA,1,1,0,16319,16319,0
Biotechnology,3800000.0,GBR,1,5,0,16505,16505,0
Collaborative Consumption|E-Commerce|Peer-to-Peer|Social Commerce,475500.0,USA,5,5,465,15464,15929,0
Enterprise Software|SaaS|Social CRM|Software,1867970.0,IRL,1,4,0,15204,15204,0
Ad Targeting|Privacy|Security|Web Hosting,97949012.0,GBR,3,4,2590,13957,16547,1
Semiconductors,7700000.0,USA,2,8,535,12863,13398,0
Biotechnology,13881000.0,GBR,1,1,0,15404,15404,0
E-Commerce|Photography,5000000.0,GBR,2,5,730,12965,13695,1
Curated Web|Image Recognition|Mobile|Photography|Software|Wireless,38986432.0,USA,11,15,3891,12843,16734,1
File Sharing|Flash Storage|Photography|Video,100000.0,SWE,1,1,0,15006,15006,0
Android|Brand Marketing|iOS|Photography,1750000.0,USA,2,2,150,16223,16373,0
Health and Wellness,2630000.0,USA,2,1,1481,15016,16497,0
Art|Facebook Applications|File Sharing|Photography,3000000.0,ISR,2,4,821,15309,16130,0
Electronics|Mobile|Optical Communications,25795004.0,GBR,4,12,925,11508,12433,0
Hardware + Software,13500000.0,CHN,1,1,0,13633,13633,1
E-Commerce|Photography,4200000.0,USA,1,1,0,13619,13619,0
Clean Technology,27000000.0,DNK,2,2,718,14214,14932,0
Health and Wellness|Health Care|Medical Devices,510000.0,USA,2,1,400,16302,16702,0
Communities|Leisure|Photography|Sales and Marketing|Social Media|Travel,164762.0,GBR,3,1,831,15823,16654,0
Internet|Photography|Reviews and Recommendations,25000.0,USA,2,2,379,14396,14775,0
Technology,3758095.0,USA,1,3,0,16687,16687,0
Biotechnology,80500000.0,USA,2,11,1127,13259,14386,0
Photography,21560790.0,FRA,3,6,2665,11048,13713,0
Curated Web|Photography|Photo Sharing,6500000.0,USA,1,3,0,12774,12774,1
Health Care,4140000.0,USA,2,1,931,15701,16632,0
Apps|Cloud Computing|Enterprise Software|Web Hosting,9900000.0,USA,3,9,302,14894,15196,1
Electronic Health Records|Health and Wellness|Software,72650000.0,USA,6,20,2883,13483,16366,0
Biotechnology,100000.0,USA,2,1,2276,13711,15987,0
Health and Wellness,75000.0,USA,3,2,1093,15273,16366,0
Biotechnology|Health Diagnostics|Medical,1170000.0,USA,3,12,435,15085,15520,0
Android|Apps|iPhone|Mobile|Mobile Advertising,38380000.0,USA,5,8,1751,14396,16147,0
Software,10000000.0,USA,2,4,294,13767,14061,1
Hardware|Telecommunications|VoIP,500000.0,TUR,1,1,0,14305,14305,0
Web Hosting,20190000.0,USA,2,8,638,12429,13067,1
Biotechnology,12000000.0,USA,1,5,0,12487,12487,0
Biotechnology,25000000.0,USA,1,3,0,11323,11323,0
Software,3100000.0,USA,2,3,811,15890,16701,0
Health and Wellness,3200085.0,USA,3,3,1107,15336,16443,0
Biotechnology,1250000.0,USA,3,2,3492,12459,15951,0
Biotechnology,350000.0,USA,2,2,277,15547,15824,0
Advertising,17000000.0,USA,1,1,0,15344,15344,0
Health Care,7848830.0,USA,4,1,1134,14419,15553,0
Health and Wellness|Health Care,4600000.0,USA,1,1,0,16275,16275,0
Health and Wellness|Rehabilitation,3450000.0,GBR,3,2,255,16346,16601,0
Enterprise Software,11544000.0,USA,4,7,1418,13922,15340,1
Analytics,3000000.0,ISR,2,2,760,15430,16190,0
Software,22498160.0,USA,3,1,1319,14618,15937,0
Biotechnology|Manufacturing|Technology,16500000.0,USA,2,4,1238,12437,13675,0
Software,2675997.0,JPN,1,3,0,14956,14956,0
Enterprise Software|Storage,9400000.0,USA,1,1,0,13356,13356,1
Technology,38924.0,GBR,1,1,0,16436,16436,0
Media|SaaS|Software,3015647.0,USA,4,6,875,15447,16322,0
Automotive,250000.0,USA,1,1,0,15218,15218,0
Education,15500000.0,USA,3,9,964,15161,16125,0
Software,19100000.0,USA,2,3,660,15684,16344,0
Photography,7807981.0,USA,6,8,2764,12509,15273,0
Advertising|Publishing,3915000.0,USA,2,3,345,14628,14973,1
Content|High Schools|Internet,40000.0,DEU,1,1,0,16222,16222,0
Blogging Platforms|Celebrity|Content|Creative|Curated Web|News|Photography|Postal and Courier Services|Sports,3200000.0,USA,1,1,0,14139,14139,1
Clean Technology,7000000.0,USA,1,3,0,15546,15546,0
Curated Web|Education|Photography,12100000.0,USA,2,3,967,13149,14116,0
Developer APIs|Event Management|Software|Ticketing,730519.0,CAN,2,7,279,15584,15863,0
Curated Web|Photography,40000.0,CAN,1,1,0,14942,14942,0
Image Recognition|Licensing|Marketplaces|Photography,520000.0,GBR,1,4,0,16229,16229,0
Photography|Photo Sharing|Social Media,3000000.0,SWE,1,1,0,16703,16703,0
Apps|Meeting Software|Online Scheduling,30000.0,USA,1,1,0,16436,16436,0
Delivery|Internet|Restaurants,87145.0,ARG,2,2,153,16222,16375,0
Big Data|Market Research|Social Media Marketing,1040000.0,USA,3,7,450,15407,15857,0
E-Commerce,40000.0,USA,1,1,0,15180,15180,0
Real Estate|Search|Technology,130000.0,USA,1,1,0,15065,15065,0
E-Commerce|Fashion|Finance|Social Media,1000000.0,USA,2,13,242,15400,15642,1
B2B|Delivery|Services,1300000.0,IND,1,2,0,16651,16651,1
Content Creators|Mobile Games|Photo Sharing|Social Games,135000.0,USA,3,2,321,16165,16486,0
Consumer Goods,100000.0,IND,1,1,0,16671,16671,0
Games|Sports,15000000.0,USA,4,5,852,12935,13787,1
E-Commerce,4000000.0,USA,3,11,276,15522,15798,0
Cloud Computing|Enterprise Software,1400000.0,USA,1,4,0,14921,14921,1
Blogging Platforms|Curated Web|Photography|Social Media,41000.0,PHL,3,2,335,14579,14914,0
Consumer Internet|EdTech|Education|Technology,4950000.0,USA,3,6,1259,15454,16713,0
Curated Web,41000000.0,USA,1,1,0,16646,16646,0
Medical,2120000.0,USA,2,19,260,16267,16527,0
Consumers|Digital Media|Promotional,78000.0,USA,1,3,0,16071,16071,0
Software,120500000.0,GBR,7,31,3609,11323,14932,1
Web Hosting,49500000.0,USA,3,10,912,12438,13350,1
Business Intelligence|Curated Web|Mobile,25000000.0,CHN,3,5,531,15584,16115,0
Manufacturing,6947640.0,FIN,1,2,0,15969,15969,0
Presentations|Software,40000.0,USA,1,1,0,15671,15671,0
Communities|Identity|Networking|Social Media,10700.0,NGA,3,4,273,14883,15156,0
Enterprise Software,35000000.0,USA,1,1,0,15721,15721,0
Mobile|Photo Editing|Photography|Social Network Media,25000000.0,USA,2,3,119,16471,16590,0
Software,46500000.0,GBR,1,6,0,13556,13556,0
E-Commerce|File Sharing|Image Recognition|Photography,1400000.0,USA,2,10,421,15400,15821,1
Collaboration|Curated Web|Music|Photography|Photo Sharing|Social Network Media|Startups,75000.0,FRA,1,2,0,15492,15492,0
Advertising,3499997.0,USA,4,3,672,14250,14922,1
Mobile|Networking|Photography|Photo Sharing|Social Games|Social Media,25000.0,USA,1,1,0,15351,15351,0
Charity|Humanitarian|Mobile|Nonprofits,75000.0,USA,2,2,0,15669,15669,0
Software,16000000.0,USA,1,5,0,10988,10988,0
Software,4600000.0,USA,2,11,458,15188,15646,0
Photography,5000.0,USA,3,2,213,15076,15289,0
Internet|Photography|Photo Sharing,37303.0,IRL,2,2,643,14853,15496,0
Internet,4018436.0,USA,1,1,0,16617,16617,0
E-Commerce|Marketplaces|Photography,15000.0,ESP,1,1,0,16371,16371,0
Social Media|Social Network Media|Teenagers,11000000.0,USA,1,2,0,13514,13514,1
Beauty|Health Care|Pharmaceuticals,973877.0,COL,5,5,850,15706,16556,0
Apps|Chat|Cloud Computing|Collaboration|Enterprises|Enterprise Software|Messaging|Productivity Software|SaaS|Social Media,2000000.0,SGP,2,5,359,16231,16590,0
Manufacturing,460000.0,USA,2,2,119,16427,16546,0
Cloud Computing|SaaS|Technology,5200000.0,USA,2,2,386,16166,16552,0
Biotechnology,13500000.0,USA,2,2,514,13829,14343,0
E-Commerce,40000.0,IRL,1,1,0,14957,14957,0
Network Security,1000000.0,USA,2,6,412,16083,16495,0
Bio-Pharm|Biotechnology|Pharmaceuticals,11827049.0,DEU,1,6,0,11991,11991,0
Curated Web,3007999.0,USA,5,6,929,15631,16560,0
Apps|Financial Services|FinTech,70000.0,THA,1,2,0,16190,16190,0
Crowdfunding|Crowdsourcing|Education|K-12 Education|Nonprofits|Payments|Peer-to-Peer|Social Fundraising|Sports,325000.0,USA,1,3,0,15812,15812,0
E-Commerce,48000.0,ESP,1,1,0,16069,16069,0
Crowdsourcing|Finance|Mobile|Social Media|Social Network Media,1730000.0,USA,3,10,305,15156,15461,1
Advertising|Publishing,1325000.0,USA,3,1,484,15495,15979,0
Events|Photography|Photo Sharing|Social Media,30000.0,MEX,1,1,0,15262,15262,0
Content Creators|Curated Web|Data Visualization|Graphics|Internet Marketing|Productivity Software|SaaS,150000.0,MYS,2,2,459,15155,15614,0
Curated Web,7350000.0,JPN,1,3,0,14799,14799,0
Gambling|Games|Sports|Web Development,5920000.0,GBR,2,3,368,13573,13941,0
Industrial|Innovation Engineering|Semiconductors,625286.0,ITA,1,2,0,16379,16379,0
Hospitality|Marketplaces|Property Management|Real Estate,2650000.0,USA,2,11,309,16146,16455,0
Finance|FinTech|Health Care,62800000.0,USA,4,32,793,15796,16589,0
Internet Infrastructure|Internet Service Providers,1555000.0,USA,2,8,242,16467,16709,0
Accounting|Developer APIs|Payments|Software,3100000.0,AUS,1,1,0,16730,16730,0
Machine Learning|Predictive Analytics|SaaS,9786.0,POL,1,2,0,16270,16270,0
Public Transportation,22757292.0,USA,3,2,3060,13619,16679,0
Advertising|Analytics|iPhone|Software,560001.0,USA,3,7,615,14000,14615,1
Audio|Customer Service|Fraud Detection|Mobile|Risk Management|Security,47000000.0,USA,3,19,1023,15461,16484,0
Event Management|Events|Social Media|Technology,200000.0,GBR,1,1,0,16587,16587,0
Messaging,3560000.0,NOR,1,3,0,14854,14854,0
Identity|Identity Management|Security,128346520.0,USA,9,34,3810,12521,16331,0
Collaboration|Enterprise Software|Human Resources|SaaS,2500000.0,USA,1,12,0,16391,16391,0
Software,1000000.0,CHN,1,1,0,13187,13187,0
Messaging,18500000.0,USA,3,4,2275,13118,15393,0
Curated Web|Event Management|Events,4050000.0,USA,3,6,672,13514,14186,0
Social Media,40000.0,USA,1,1,0,14957,14957,0
Health and Wellness,3312300.0,USA,3,3,1135,14767,15902,0
Internet|Professional Networking|Startups,1000000.0,USA,2,6,384,16316,16700,0
Android|Cloud Security|Developer APIs|Internet of Things|iPhone|Messaging|Mobile|Mobile Security|Unifed Communications,185000.0,SWE,3,1,978,15701,16679,0
Big Data Analytics|Energy|Energy IT|Energy Management|Internet of Things|Machine Learning|Predictive Analytics|Sensors|Smart Grid|Utilities,3775000.0,USA,3,7,367,16181,16548,0
Photography,18000000.0,CHN,3,6,1065,14853,15918,0
Curated Web|Mobile|Real Time|Social Media,4000000.0,USA,1,1,0,15664,15664,0
Big Data|Mobile Commerce|Retail Technology|Social Media Marketing,2520000.0,LUX,2,1,125,16367,16492,0
Apps|Messaging|Security,118000.0,USA,1,1,0,16622,16622,0
Gps|Location Based Services|Mobile|Software|Tracking,35000.0,USA,1,1,0,16072,16072,0
Android|Apps|Big Data|Comparison Shopping|Crowdsourcing|iOS|Market Research|Mobile,1000000.0,BRA,3,2,440,15614,16054,0
Mechanical Solutions,35000.0,USA,1,1,0,16130,16130,0
Food Processing|Services|Specialty Foods,27500000.0,USA,1,1,0,13802,13802,0
Curated Web,1400000.0,USA,1,6,0,15259,15259,0
Design|E-Commerce|Marketplaces,9000000.0,TWN,1,2,0,16708,16708,0
Bridging Online and Offline|Enterprise Software|Location Based Services,220000.0,SWE,2,4,413,16111,16524,0
Consulting,41250.0,HKG,1,1,0,16405,16405,0
Clean Technology,13500000.0,USA,2,7,1134,15064,16198,0
Health Care,1500000.0,USA,2,2,1,15583,15584,0
Energy|Oil and Gas,20000000.0,USA,1,1,0,16443,16443,0
Entertainment|Messaging|Mobile|Social Media,3850000.0,USA,6,17,1236,15187,16423,0
Bitcoin|Hardware + Software|Industrial|Internet of Things,6155232.0,USA,4,14,916,15749,16665,0
Travel,40000.0,USA,1,1,0,15954,15954,0
Travel,25000.0,PHL,1,1,0,15801,15801,0
Billing|Gift Card|Payments,1100000.0,LBN,1,1,0,14853,14853,0
Health and Wellness,4727988.0,USA,3,1,507,14915,15422,0
Fashion|Women,3900000.0,USA,3,9,829,15940,16769,0
Design|E-Commerce,100000.0,TUR,1,3,0,16100,16100,0
Online Travel|Reviews and Recommendations|Social Travel,400000.0,KOR,2,2,92,16283,16375,0
Consulting,3000000.0,USA,2,3,2423,13131,15554,0
Android|Craft Beer|iOS|Mobile,454673.0,FIN,1,1,0,16295,16295,0
Biotechnology|Health Care|Therapeutics,32111759.0,USA,5,2,288,15795,16083,0
Software,10000000.0,USA,2,8,570,12850,13420,0
Curated Web|Social Bookmarking|Social Media,1315500000.0,USA,10,60,1977,14610,16587,0
Pharmaceuticals,7250000.0,USA,1,4,0,12045,12045,1
Manufacturing,2313624.0,CHN,2,3,639,15126,15765,0
Mobile,8656775.0,USA,5,1,2822,13825,16647,0
EdTech|Entrepreneur|Events|Information Services|Information Technology|Startups|Technology,400000.0,AUT,2,1,759,15371,16130,0
Clean Technology,6400000.0,USA,1,3,0,12824,12824,0
Food Processing,196226.0,GBR,1,1,0,16336,16336,0
E-Commerce|Fashion|Jewelry|Retail,650000.0,IND,1,4,0,16644,16644,0
Curated Web|E-Commerce|Personalization|Reviews and Recommendations|Social Media,400000.0,USA,2,1,14,15522,15536,0
Computers|SaaS|Software,200000.0,USA,1,3,0,16639,16639,0
E-Commerce,1400000.0,USA,1,1,0,16247,16247,0
Manufacturing,7450450.0,USA,2,2,359,14256,14615,0
Enterprise Software|Gamification|Productivity Software|Sales and Marketing|Sales Automation,1582347.0,GBR,4,3,485,15798,16283,0
Android|Cloud Computing|CRM|Productivity Software|Sales and Marketing|Software,1000000.0,USA,1,2,0,16435,16435,0
Biotechnology,14615000.0,USA,3,4,1838,14785,16623,0
Educational Games|Electronics,330000.0,USA,2,1,181,16314,16495,0
Lead Generation|Sales and Marketing|Software,450000.0,DNK,2,2,365,16314,16679,0
Mobile|Publishing|SaaS|Technology,2250000.0,USA,1,13,0,16521,16521,0
Services,5500000.0,CHE,1,3,0,16577,16577,0
Collaborative Consumption|Communities|Mobile|Social Network Media,614500.0,HUN,2,1,550,15866,16416,0
Content Discovery|E-Commerce|Mobile Advertising|Social Media Marketing,11200000.0,USA,3,10,631,15552,16183,0
Recruiting|Software,500000.0,IND,1,1,0,16554,16554,0
Real Estate,434000000.0,IND,2,2,26,16638,16664,0
Biotechnology,13200000.0,GBR,1,2,0,12242,12242,1
3D Printing|3D Technology|Consumer Electronics,3921546.0,SGP,3,1,766,15706,16472,0
Big Data|Consumer Internet|Retail Technology,250000.0,USA,1,1,0,15706,15706,0
Mobile,3200000.0,USA,2,3,260,15327,15587,0
E-Commerce,211600.0,USA,2,1,1050,15701,16751,0
Accounting|Software,1200000.0,GHA,1,4,0,15707,15707,0
Cloud Computing|Cloud Management|IaaS|Open Source|Software,28830989.0,USA,7,16,1486,15061,16547,1
Consumer Goods|Organic Food|Recipes,40000.0,BRA,1,1,0,15749,15749,0
Analytics|Finance|SaaS|Venture Capital,3800000.0,USA,1,1,0,14512,14512,0
Finance,2726672.0,CAN,1,1,0,16112,16112,0
Consumer Internet|FinTech|Mobile,18458821.0,BRA,3,3,974,15565,16539,0
Information Technology|Services|Software,20100000.0,USA,2,6,853,11584,12437,0
Health Care,42725003.0,USA,4,4,809,14477,15286,1
Hardware + Software,192437500.0,USA,13,52,3673,12817,16490,0
Big Data|Business Intelligence|Enterprise Software|PaaS|Product Design|Product Development Services|Software,105000000.0,USA,1,1,0,15819,15819,0
Health Diagnostics|Semiconductors,40421473.0,USA,7,5,3339,13165,16504,0
Internet|Marketplaces|Real Estate|Startups,6625000.0,USA,3,10,693,15477,16170,0
Analytics|Retail|SaaS|Sales and Marketing|Software|Web Development,45585068.0,USA,6,9,2206,13559,15765,1
Curated Web|Monetization|Video on Demand|Video Streaming,1000000.0,USA,1,1,0,15560,15560,0
Computer Vision|Drones|Geospatial|Image Recognition|Maps|Software,2400000.0,CHE,1,1,0,15539,15539,0
Advertising|Internet Marketing|Video Streaming,27460157.0,USA,5,15,1945,14588,16533,0
Digital Media|Publishing|Social Media,6100000.0,USA,2,2,163,14923,15086,1
Advertising|Analytics|Big Data|Business Intelligence|Enterprise Software|Fraud Detection|SaaS|Security,4750000.0,USA,2,12,321,15728,16049,0
Interface Design|Mobile|User Experience Design,3800000.0,USA,1,1,0,15888,15888,0
Technology,30500000.0,USA,2,6,1215,11386,12601,0
Computer Vision|Games|Mobile|Technology,932150.0,USA,4,6,718,15869,16587,0
Hardware + Software|Sensors,10541750.0,USA,4,2,2893,13598,16491,0
Diagnostics|Health Diagnostics|Medical|Medical Devices,875000.0,USA,2,1,2025,14074,16099,0
Advertising,9432455.0,USA,5,7,535,14641,15176,0
Nanotechnology,34533837.0,USA,10,2,2209,14392,16601,0
Broadcasting|Television|Video Streaming,4900000.0,ISR,2,3,554,15857,16411,0
Health Care|Medical Devices,92505372.0,USA,4,9,1548,14175,15723,0
Mobile Security|Security,1564587.90424482,GBR,5,6,1165,15510,16675,0
Blogging Platforms|Cloud Data Services|Mobile|Networking|Photography|Video,2300000.0,USA,2,2,1575,13514,15089,0
Education,40000.0,TUR,1,1,0,15380,15380,0
Semiconductors,8700000.0,ISR,1,1,0,13171,13171,0
Internet of Things|Software,6000000.0,USA,2,2,81,16049,16130,0
Photography,20000.0,USA,1,1,0,16269,16269,0
Document Management|Enterprise Software,1000000.0,USA,1,1,0,15065,15065,0
Hardware + Software|Video,90832109.0,USA,8,23,3605,11625,15230,1
Software,19299000.0,FRA,1,5,0,16034,16034,1
Advertising|B2B|Brand Marketing|Digital Media|Digital Rights Management|E-Commerce|Mobile Commerce|Sales and Marketing|Social Commerce|Social Media,5500000.0,USA,2,9,647,16007,16654,0
Computer Vision|Deep Information Technology|Marketing Automation|Real Time|Software,120753.0,ISR,2,2,89,16481,16570,0
Games|Mobile Games|Social Games,10000000.0,RUS,2,6,148,15125,15273,0
Games,1375000.0,USA,5,11,1065,15065,16130,0
Mobile,7400000.0,USA,2,3,202,13483,13685,0
Search,5835986.0,GBR,2,2,530,13514,14044,0
App Stores|Mobile|Video,8470000.0,CAN,1,1,0,10925,10925,1
E-Commerce,700000.0,JPN,1,1,0,16010,16010,0
Photography,20203.0,USA,3,3,777,15732,16509,0
Displays|Hardware + Software,53700000.0,USA,6,10,2206,12942,15148,1
Photography,1576400.0,FRA,1,1,0,14060,14060,0
Specialty Foods,704236.0,GBR,1,1,0,16010,16010,0
Real Estate,350000.0,IND,1,2,0,16695,16695,0
B2B|Big Data|Business Services|Consumer Goods|Consumers|Curated Web|Data Mining|Data Visualization|Demographies|Information Technology|Travel & Tourism|Web Development,278336.0,LTU,2,2,366,15340,15706,0
Apps|Location Based Services|Maps,605000.0,USA,3,1,137,16440,16577,0
Advertising,5000000.0,USA,1,1,0,15565,15565,0
Mobile,8000000.0,USA,2,6,103,14566,14669,0
Mobile,13400000.0,USA,3,5,1141,15090,16231,0
E-Commerce|Events,3068164.0,USA,1,1,0,16602,16602,0
Advertising|Big Data|Information Technology|Mobile,26950000.0,USA,4,20,1042,15069,16111,0
Analytics|Big Data|Finance|Internet of Things|Local|Mobile,7843000.0,USA,4,12,809,15522,16331,0
Curated Web,1900000.0,USA,2,4,115,14705,14820,0
Business Services|Development Platforms|Internet|Web CMS|Web Design|Web Hosting,600000.0,DEU,1,2,0,15340,15340,0
Government Innovation|Information Technology|Social Media,1299084.16325771,CAN,4,2,1616,15136,16752,0
Sports|Ticketing,247626.0,USA,1,2,0,15557,15557,0
Advertising|Digital Media|Lead Generation|Lead Management|Marketing Automation|Real Estate|Sales Automation,50926212.0,USA,6,19,2331,14432,16763,0
Advertising|Film|Television|Video,500000.0,USA,1,1,0,14300,14300,1
Active Lifestyle|E-Commerce|Fashion|Kids,10800000.0,USA,2,21,335,16205,16540,0
Computers|Finance Technology|Financial Services|Software,15300000.0,USA,2,6,470,15967,16437,0
Software,5500000.0,JPN,2,3,407,16253,16660,0
Android|Game|Games|iPhone|Mobile,32567827.0,USA,5,33,1080,15522,16602,0
Legal|SaaS|Small and Medium Businesses,40000.0,USA,1,1,0,16223,16223,0
Hardware + Software,5791106.0,USA,3,3,658,15218,15876,0
Games,18410.0,HUN,1,1,0,15553,15553,0
Digital Media|Displays|Outdoors,454575.0,THA,1,1,0,16163,16163,0
Curated Web,129930.0,FRA,1,2,0,15638,15638,0
Analytics|B2B|E-Commerce,15000000.0,USA,1,4,0,11386,11386,0
Education,177897.0,GBR,1,1,0,16191,16191,0
Education|Video|Video on Demand,2000000.0,IND,1,2,0,16567,16567,0
Biotechnology,15300000.0,USA,1,1,0,16111,16111,0
Apps|Human Resource Automation|Online Scheduling|Software,3750000.0,DNK,1,2,0,16196,16196,0
Career Planning|Collaboration|Social Media|Travel,62000.0,USA,2,1,122,15572,15694,0
Social Media|Tourism|Travel & Tourism,95000.0,ESP,2,1,120,16080,16200,0
Content|Internet|Journalism|News|Publishing,227262.397163765,GBR,1,1,0,15798,15798,0
Aerospace|Geospatial,183100000.0,USA,5,37,658,15881,16539,0
Clean Technology|Software,2300000.0,USA,1,2,0,14195,14195,0
Electronics|Financial Services|Payments,7998800.0,USA,2,1,1477,13088,14565,1
Collaboration|Curated Web|Enterprises|Entrepreneur|Freelancers|SaaS|Small and Medium Businesses,11000000.0,USA,4,7,923,14426,15349,0
E-Commerce,539691.0,IND,1,3,0,16769,16769,0
Machine Learning,10000000.0,USA,1,1,0,16687,16687,0
Solar,2041033.0,USA,4,3,2447,14245,16692,0
Mining Technologies|Natural Resources,13733209.0,USA,3,10,1281,15448,16729,0
Travel,20738700.0,FRA,2,3,771,15103,15874,0
Construction|iPad|Mobile,59100000.0,USA,3,21,1268,15489,16757,0
Finance,17500000.0,USA,3,9,1150,12205,13355,1
Outdoors|Travel,25000.0,USA,1,1,0,16107,16107,0
Digital Media|Social Media,196615.0,BLZ,1,1,0,16379,16379,0
Hospitality,932785.0,BRA,1,1,0,16106,16106,0
Advertising|Digital Media|Internet Marketing|Mobile|Publishing|Semantic Search|SEO,47788.0,CAN,1,1,0,14844,14844,0
Software,94000000.0,USA,4,5,1297,15371,16668,0
Agriculture|Aquaculture|Electronics|Farming|Hardware + Software|Robotics,174957.335842301,DEU,2,4,518,16191,16709,0
Curated Web,8660000.0,USA,4,2,767,14042,14809,0
E-Commerce|Events|Mobile|Reviews and Recommendations|Social Media|Subscription Businesses|Ticketing,385567.0,GBR,2,2,720,15736,16456,0
Finance|FinTech|Personal Finance|Real Estate|Software|Technology,1610000.0,USA,4,2,1294,15279,16573,0
Big Data|Real Estate,500000.0,USA,1,1,0,16495,16495,0
Clean Technology,142774586.0,CAN,1,1,0,15055,15055,0
Mobile,160000.0,IND,1,1,0,15765,15765,0
Software,270031.0,KOR,1,1,0,15628,15628,0
Biotechnology,2590607.0,USA,5,2,1477,15146,16623,0
Life Sciences|Search,15000.0,USA,1,1,0,15769,15769,1
E-Commerce,23400000.0,USA,4,15,1112,14245,15357,1
Displays|Manufacturing,195700000.0,DEU,5,20,2298,11797,14095,0
Biotechnology,6985203.0,GBR,2,1,1165,13840,15005,0
Analytics|Apps|Big Data|EdTech|Enterprises|Enterprise Software|Human Resources|Mobile|Psychology|SaaS|Software,2850000.0,CAN,4,4,545,15765,16310,0
Clean Technology,1100000.0,USA,1,1,0,14518,14518,0
E-Commerce|FinTech,18349996.0,USA,3,8,795,15471,16266,0
Finance,2000000.0,USA,1,1,0,15011,15011,0
Career Management|Human Resources|SaaS|Software|Systems,18000000.0,USA,1,3,0,11382,11382,1
Hospitality|Marketplaces|Travel|Travel & Tourism,200000.0,LTU,1,1,0,16328,16328,0
Cooking|E-Commerce|Hospitality|Social Media Platforms,56400000.0,USA,8,41,856,15776,16632,0
Delivery|Hospitality,1700000.0,USA,2,12,547,16007,16554,0
Agriculture|SaaS|Services,118000.0,ISR,1,1,0,16601,16601,0
Analytics|Software,65200000.0,USA,3,17,923,15225,16148,0
3D Technology|Health Care|Manufacturing,30000.0,ISR,1,1,0,16310,16310,0
Hardware + Software,37000000.0,USA,1,6,0,13844,13844,1
Enterprise Software,14500000.0,USA,2,3,370,16294,16664,0
Maps|Public Transportation|Social Network Media,3400000.0,USA,2,13,488,13057,13545,0
Semiconductors,29527669.0,USA,3,6,1052,13717,14769,0
Ediscovery|Hospitality|Mobile|Photography|Photo Sharing|Social Network Media,619445.0,GBR,3,3,409,15601,16010,0
Advanced Materials|Specialty Chemicals|Water,126814.0,FRA,1,1,0,15873,15873,0
Education|Edutainment|Recruiting|Training,120000.0,USA,1,3,0,16405,16405,0
Clean Technology,19940192.0,GBR,2,2,713,15245,15958,0
Contact Management|Curated Web|Databases|Synchronization|Trading,28300000.0,USA,4,11,1553,11992,13545,1
Hardware + Software|Robotics,17340000.0,USA,4,20,734,15826,16560,0
Broadcasting|Entertainment|Games|Television,4300000.0,USA,1,1,0,15999,15999,0
Games,500000.0,USA,1,1,0,14889,14889,1
Entertainment|FreetoPlay Gaming|Games|Gift Card|Shopping,525000.0,USA,3,1,402,15706,16108,0
Entertainment|Game|Games|Testing,270862.0,ESP,1,1,0,16233,16233,0
Big Data|CRM|Curated Web|Gamification|Loyalty Programs|Social Media|Virtual Currency,2943000.0,THA,5,10,1045,15566,16611,0
Consulting|Software,3250000.0,USA,2,1,286,14049,14335,0
B2B|Digital Media|Entertainment,19800000.0,ISR,3,10,828,15684,16512,0
Finance|Game|Games,590000.0,GBR,2,3,505,15888,16393,0
Games,10000000.0,GBR,1,3,0,14999,14999,0
Games,4378812.0,GBR,2,2,417,15572,15989,1
Games,4290000.0,SWE,1,2,0,14230,14230,0
Apps|Entertainment|Games,76000000.0,USA,2,8,222,14559,14781,1
Games,664369.0,KOR,2,1,439,15634,16073,0
E-Commerce|Fitness|Health and Wellness|Marketplaces|Sports,39650.0,GBR,1,1,0,15659,15659,0
Games,16910000.0,GBR,2,5,472,13059,13531,0
Mobile|Software,21189.0,USA,2,2,282,15222,15504,0
Games,1000000.0,USA,1,2,0,15343,15343,1
Information Security,14250377.0,USA,3,1,836,15915,16751,0
Social Network Media|Sports,110000.0,GBR,1,2,0,15720,15720,0
Mobile|Recreation|Sponsorship|Sports,10000.0,USA,1,2,0,16040,16040,0
Developer Tools|Games|PaaS|Service Providers,9900000.0,USA,2,28,192,16301,16493,0
Advertising|Entertainment|Online Video Advertising|Software,270820.0,ESP,1,1,0,16234,16234,0
Games|iPhone|Mobile Games,37720000.0,USA,5,19,3402,12418,15820,1
Apps|Facebook Applications|Games|Social Games|Social Network Media|Web Tools,21000000.0,GBR,3,3,231,13949,14180,1
Digital Entertainment|Games|Video Games,5533513.0,ESP,2,5,410,16220,16630,0
Clean Technology|Entertainment,289800.834522512,BGR,4,4,1127,15552,16679,0
Advertising|Mobile,30800000.0,USA,6,8,2393,13970,16363,1
Education,2500000.0,USA,1,1,0,16128,16128,0
Games|Social Games|Television,5000000.0,GBR,1,4,0,15272,15272,0
Health Care,1125000.0,USA,2,2,409,15949,16358,0
Advertising|Analytics|Apps|Brand Marketing|Cause Marketing|Charity|Games|Mobile|Networking|Social Media,2183409.0,GBR,5,6,1096,15065,16161,0
Computer Vision|Games|Kinect,500000.0,USA,1,2,0,13330,13330,0
Music|Social Media,350000.0,FIN,1,1,0,15357,15357,0
Games,30000000.0,RUS,2,2,425,14245,14670,0
Games,6479503.0,KOR,2,4,386,15656,16042,0
Apps|Big Data|Mobile|Predictive Analytics,6000000.0,USA,3,11,1162,14594,15756,1
Games,10000000.0,USA,2,6,396,14823,15219,1
Games,95097200.0,USA,3,10,1952,13388,15340,0
Development Platforms|Game|Mobile,6399999.0,FIN,2,4,323,16091,16414,0
Curated Web,268611.0,GBR,1,1,0,16037,16037,0
Concerts|E-Commerce|Events|Ticketing,150000.0,HKG,1,1,0,15949,15949,0
EdTech|Education|Language Learning,820000.0,USA,3,3,875,14123,14998,1
Games,15400000.0,ISR,5,6,1721,13964,15685,0
Sports,5000000.0,ISR,2,7,858,15351,16209,0
Games,1500000.0,USA,1,5,0,15450,15450,0
Games,4700000.0,USA,3,5,1142,15339,16481,0
Facebook Applications|Games|Social Games,6459235.0,ESP,2,3,862,15588,16450,0
Game|Games,46300000.0,USA,4,18,1083,13757,14840,1
iPad|Mobile|Television,660000.0,USA,1,1,0,15806,15806,0
Games,28700017.0,USA,2,2,798,15568,16366,0
Building Products|Consumer Goods|Manufacturing,1000000.0,USA,1,4,0,16447,16447,0
Home Automation|Internet of Things|Wearables,700000.0,USA,3,3,631,15893,16524,0
Games|iOS|Usability,122980.0,DEU,1,2,0,15553,15553,0
Big Data Analytics|Outdoor Advertising|Small and Medium Businesses,6701279.0,ESP,2,3,4,16202,16206,0
Entertainment|Games|Social Games,1500000.0,ISR,1,1,0,14914,14914,1
Entertainment|Games|Video Games,91250.0,HKG,2,2,181,16071,16252,0
Games|MMO Games|Mobile|Web Development,3000000.0,RUS,1,1,0,15860,15860,0
Games|Mobile|Mobile Games,1300000.0,USA,1,2,0,15376,15376,0
Active Lifestyle|Fitness|Local|Mobile|Social Games|Sports,50000.0,USA,1,1,0,16115,16115,0
Comparison Shopping|Coupons|Discounts,1608361.0,PER,4,4,1004,15340,16344,0
E-Commerce|Internet,2000000.0,MEX,1,1,0,14963,14963,0
Games|Mobile|Social Games,30000.0,NGA,1,1,0,15795,15795,0
Internet|Mobile|Nonprofits,4000000.0,USA,1,3,0,16542,16542,0
Apps|Photo Sharing,600000.0,FRA,1,2,0,16520,16520,0
Software,2500000.0,USA,1,3,0,12346,12346,0
Internet|News|Semantic Search,10500000.0,ESP,2,1,638,15340,15978,0
Software,1000000.0,USA,1,3,0,12943,12943,0
Games|Mobile|Social Television|Television,10000000.0,USA,2,1,1520,14610,16130,0
Cloud Computing|Enterprise Resource Planning|Manufacturing|Software,86500000.0,USA,4,4,1674,14557,16231,0
Biotechnology,2500000.0,FIN,1,1,0,14382,14382,0
Clean Technology,54847500.0,USA,10,9,3419,12563,15982,1
Education|Recruiting|Software|Training,40000.0,USA,1,1,0,15972,15972,0
Web Hosting,83400000.0,USA,4,9,1672,15020,16692,0
Biotechnology,46000000.0,USA,1,7,0,12564,12564,1
Collaborative Consumption|Curated Web|Marketplaces|Toys,16750000.0,USA,2,11,319,16149,16468,0
Enterprise Software,50300006.0,USA,3,10,685,13929,14614,1
Curated Web,3633000.0,USA,2,2,111,15442,15553,0
Ad Targeting|Advertising|Content|Mobile|Monetization|Personalization|Reviews and Recommendations,3800000.0,DEU,3,7,730,14184,14914,1
Audio|Cloud Computing|Developer APIs|Internet|Mobile|Open Source|SMS|Telephony|Venture Capital,1750000.0,USA,1,5,0,15678,15678,0
Curated Web|Photography,2600000.0,USA,1,4,0,14698,14698,1
Ediscovery|Entertainment|iPad|Photography|Video|Video Streaming,5200000.0,USA,2,1,574,15113,15687,0
Design,40000.0,SVN,1,1,0,15538,15538,0
Consumer Electronics|Digital Media|User Experience Design,203000.0,BRA,2,2,245,16080,16325,0
Events|Interest Graph|Social Media|Social Network Media,371810.0,ITA,1,1,0,15558,15558,0
Advertising|Location Based Services|Mobile,1000000.0,NLD,2,2,1015,15485,16500,0
Developer Tools|Information Technology|Mobile,41250.0,HKG,1,1,0,16648,16648,0
Technology,100000.0,USA,1,1,0,16375,16375,0
Analytics|Big Data|Collaboration|Data Integration|Data Visualization|Education|Software,6928571.0,CAN,2,7,646,15943,16589,0
Analytics,4714998.0,USA,3,4,571,14952,15523,0
Agriculture|Distribution|Social Commerce|Social Media,300000.0,USA,1,1,0,15857,15857,0
Curated Web,17000000.0,USA,3,5,1048,12418,13466,1
Curated Web|Music|Social Media|Video,1250000.0,USA,1,1,0,16045,16045,0
Music|Video,2000000.0,USA,1,1,0,13984,13984,0
E-Commerce|Fashion|Jewelry|Online Shopping,1000000.0,USA,1,1,0,16102,16102,1
Hardware + Software|Home Automation|Internet of Things|Lighting,6957000.0,USA,6,9,1098,15553,16651,0
Impact Investing,975000.0,USA,1,11,0,16450,16450,0
Curated Web,30600000.0,USA,3,4,504,14812,15316,0
Games,15800000.0,GBR,2,3,634,15421,16055,0
B2B|Software,1700000.0,EST,2,4,463,16021,16484,0
Consulting,89153325.0,USA,8,8,1726,13742,15468,0
Networking,28963170.0,USA,3,7,862,15239,16101,0
Software,23000000.0,USA,1,6,0,11120,11120,1
Media|Television|Web Hosting,29600000.0,USA,3,13,2122,13504,15626,0
Cloud Computing|Monetization|Web Hosting,750000.0,USA,1,1,0,14000,14000,0
EdTech|Education,162500000.0,USA,2,5,601,15708,16309,0
Consulting,6411000.0,USA,3,2,952,14882,15834,0
Big Data|Cloud Computing|Data Center Infrastructure|Networking|Web Hosting,97000000.0,USA,5,14,1726,14730,16456,0
Biotechnology,5059192.0,NLD,1,2,0,16367,16367,0
Biotechnology,780000.0,DEU,1,5,0,14319,14319,0
Health Care,3378194.0,USA,4,3,2552,13616,16168,0
Wireless,325000.0,USA,1,1,0,16244,16244,0
Advertising,3770000.0,SWE,1,1,0,14487,14487,0
Mobile,4410000.0,USA,1,1,0,14000,14000,1
Health Care,1000000.0,IND,1,3,0,16764,16764,0
Mobile,2150000.0,USA,3,8,478,15317,15795,0
Entertainment|Internet TV|Video,13500000.0,USA,2,15,38,16356,16394,0
Enterprise Application|Enterprise Software|SaaS|Software,100000.0,USA,1,2,0,15400,15400,0
Apps|Curated Web|Finance|Mobile|Personal Finance,4297285.0,IDN,5,1,559,15553,16112,0
Sensors|Software|Wireless,1034862.0,PRT,2,2,851,15128,15979,0
Biotechnology,25274243.0,USA,5,3,1644,14250,15894,0
Curated Web|Gps|Mobile|Social Network Media,3152015.0,FRA,3,6,1636,14706,16342,0
Curated Web,1800000.0,USA,4,9,1186,15401,16587,0
Advertising|Advertising Networks|Advertising Platforms|Mobile Advertising|Performance Marketing|SaaS,5700000.0,ISR,3,5,3220,13483,16703,0
Entertainment|Mobile|Publishing,80000.0,USA,1,1,0,15674,15674,0
Analytics|Big Data|Information Technology,578730.0,GBR,2,2,252,16436,16688,0
Hospitality,14000000.0,USA,1,1,0,16112,16112,0
Bioinformatics|Biotechnology|Health and Wellness|Healthcare Services|Medical,100000.0,IRL,1,1,0,15949,15949,0
Health and Wellness|Health Care|Pharmaceuticals,30000000.0,USA,1,2,0,16406,16406,0
Biotechnology,5444961.0,GBR,9,14,1732,14276,16008,0
Health Care,60000000.0,USA,2,14,1400,13578,14978,1
Enterprise Software,13000000.0,USA,3,5,1335,15282,16617,0
Business Development|Business Productivity|Software,3300000.0,ISR,1,1,0,14043,14043,0
Biotechnology,2204000.0,USA,4,1,2673,13671,16344,0
Databases|Internet|Marketplaces,300000.0,USA,1,2,0,16457,16457,0
Games|Software,153654.0,CAN,1,1,0,15138,15138,0
Business Development|Career Management|Career Planning,1750000.0,USA,3,6,217,16323,16540,0
Staffing Firms,750000.0,USA,2,1,144,16300,16444,0
Coupons|Curated Web|E-Commerce|Retail,2800000.0,USA,2,6,512,15817,16329,0
Employment|Mobile|Recruiting|SaaS,40000.0,USA,1,1,0,16223,16223,0
Diagnostics|Health Diagnostics|Medical,1100000.0,USA,1,1,0,16426,16426,0
Mobile|Retail,568894.870427501,GRC,2,2,365,16161,16526,0
Browser Extensions|Curated Web|Productivity Software|Web Browsers|Web Tools,14500000.0,USA,3,15,1312,15181,16493,0
Mobile,150000.0,USA,2,1,16,15763,15779,0
Financial Services|Mobile,6400000.0,USA,2,12,231,15301,15532,0
Mobile,125000000.0,USA,2,4,111,14184,14295,0
Hospitality,600000.0,JPN,1,2,0,15959,15959,0
Apps|Education|Entertainment|Parenting,104835.0,GBR,1,1,0,16202,16202,0
Games|Mobile Games,65000000.0,USA,2,6,1610,14958,16568,0
Android|Apps|iPhone|Mobile|Tourism|Travel,2079150.0,HUN,1,1,0,14902,14902,0
Games,5000000.0,THA,1,1,0,16721,16721,0
Small and Medium Businesses|Social Media Management,248988.0,GBR,1,1,0,16164,16164,0
Consulting,1059907.0,JPN,1,4,0,16378,16378,0
Banking|Curated Web|Finance|Personal Finance,500000.0,NOR,1,1,0,15998,15998,0
Health Care|Medical,2850000.0,USA,1,1,0,16434,16434,0
Apps|B2B|Mobile|Property Management|Real Estate|SaaS,40000.0,GBR,1,1,0,15918,15918,0
Electronics|Real Time|Sensors|Wireless,135693.0,USA,2,1,141,16509,16650,0
Mobile|Mobile Advertising|Real Time,10000000.0,USA,1,1,0,16398,16398,0
Mobile,6350000.0,SWE,1,1,0,14197,14197,1
Mobile|NFC|Payments|Social Media,161160.0,DEU,2,1,639,15006,15645,0
Accounting|Enterprise Resource Planning|Freelancers|Mobile Payments|Online Scheduling|Payments|Productivity Software|Software,275000.0,USA,3,1,488,15826,16314,0
Apps|Mobile|Software,12000000.0,USA,1,5,0,12732,12732,0
Finance Technology|FinTech|Payments,3452016.0,GBR,2,6,926,15279,16205,0
Travel,55000000.0,CHN,1,3,0,15461,15461,0
Advertising,1000000.0,USA,1,2,0,13787,13787,0
Design,16691.0,GBR,1,1,0,16627,16627,0
Software,2490000.0,USA,2,4,1527,13186,14713,1
Construction,20000000.0,IND,1,1,0,16456,16456,0
Journalism|Maps|Non Profit,40000.0,CHL,1,1,0,15665,15665,0
Biotechnology,3700000.0,USA,2,2,580,15791,16371,0
Enterprise 2.0|Enterprise Software,4600000.0,DNK,3,3,756,14259,15015,1
Computers|Software|Technology,500000.0,USA,1,1,0,16248,16248,0
Information Technology,2000000.0,USA,1,1,0,16590,16590,0
Hardware|Hardware + Software|Photography|Wireless,3464000.0,USA,7,19,730,15826,16556,0
Education,9929825.0,KOR,3,2,637,15048,15685,0
Hospitality,10517930.0,USA,5,2,1380,15182,16562,0
Games,7500000.0,USA,2,4,457,13208,13665,0
Semiconductors,10000000.0,CAN,2,1,808,15306,16114,1
Advertising|Events|Social Media Marketing|Sponsorship,9100000.0,USA,3,3,1534,14699,16233,0
PaaS|Software|Web Development|Web Hosting,40000.0,USA,1,1,0,15940,15940,0
Concerts|Enterprise Software|Entertainment|Events|Mobile|Sports|Ticketing,4110000.0,USA,5,36,426,15826,16252,0
Education|Training|Tutoring|University Students,41250.0,CHN,1,1,0,16252,16252,0
E-Commerce|Software,369713.0,USA,3,1,545,15434,15979,0
Biotechnology|Health and Wellness|Health Care|Medical|Pharmaceuticals,29300000.0,USA,2,5,176,13703,13879,0
Business Development|Enterprises|Enterprise Software|IaaS|Mobile|SaaS|Web Development,6250000.0,USA,3,1,672,15861,16533,0
Real Estate,400000.0,USA,1,1,0,14173,14173,0
Mobile|Social Business|Social Media|Social Media Marketing,2550000.0,USA,2,1,1636,15126,16762,0
Biotechnology,1765594.0,USA,2,1,882,13993,14875,0
Technology,777000.0,USA,2,2,379,16252,16631,0
Hospitality,425000.0,USA,1,4,0,15793,15793,0
Advertising|Apps|Entertainment|Mobile,600000.0,ITA,1,1,0,15922,15922,0
Development Platforms|Industrial|Manufacturing|Training,2500000.0,CAN,1,2,0,16456,16456,0
Software,12000000.0,JPN,1,2,0,14761,14761,1
Business Services|Content|Enterprise Software|Events|File Sharing|Gadget|NFC|Web CMS,1800000.0,USA,5,9,1479,14432,15911,0
Application Platforms|E-Commerce|Health Care|Health Care Information Technology,46200000.0,USA,4,23,1126,15533,16659,0
Games,7500000.0,IND,3,9,762,15980,16742,0
Hardware + Software,457912.0,FRA,1,3,0,14700,14700,0
Apps|Mobile|Polling,2880000.0,USA,2,10,353,15761,16114,1
Apps|Mobile|Software,9000000.0,CAN,2,2,418,14944,15362,0
Software,10000000.0,USA,2,2,132,16135,16267,0
Mobile,10000000.0,USA,2,2,4317,11504,15821,0
Software,200000.0,USA,1,1,0,13236,13236,0
Enterprise Software,7000000.0,IRL,1,3,0,13074,13074,1
Browser Extensions|Curated Web|Image Recognition|Photography,5100000.0,SWE,1,1,0,13467,13467,0
Application Platforms|Design|Manufacturing,528479.0,DNK,1,1,0,15709,15709,0
Web Hosting,26395861.0,USA,6,19,2912,12733,15645,0
Software,1080000.0,USA,1,1,0,13976,13976,0
Analytics,15000.0,USA,1,2,0,15924,15924,0
Content|Education|Finance|Insurance|Marketplaces,6050000.0,USA,2,8,329,16272,16601,0
Business Services|Consulting|Technology,104501.0,GBR,1,1,0,16202,16202,0
Finance|FinTech,69600000.0,IND,5,14,1421,15119,16540,0
Software,2580000.0,USA,2,1,834,14679,15513,0
Hardware + Software,40930000.0,NOR,3,11,2078,14394,16472,0
Education,420875.0,CHL,4,5,792,15522,16314,0
Analytics,7530000.0,USA,2,2,980,12492,13472,1
Internet Marketing|Real Estate|Services,70599032.79325071,FRA,1,1,0,13118,13118,0
Crowdsourcing|Enterprise Software,185419.0,CHL,3,3,367,15278,15645,0
Enterprise Software|Governance|Security|Software,3000000.0,USA,1,1,0,12156,12156,0
Events|Messaging|Polling|Public Relations|Real Time|SMS|Surveys,20000.0,USA,1,1,0,14027,14027,0
Advertising|Market Research|Mobile,114924.0,GBR,1,1,0,15132,15132,0
Social Media,2500000.0,GBR,2,1,474,15993,16467,0
Consulting|Finance|FinTech|Startups,500000.0,AUS,2,1,1296,14955,16251,0
B2B|Enterprise Software|Finance|FinTech|Hardware + Software|Marketplaces|SaaS|Software,70700000.0,USA,4,14,1617,15041,16658,0
Advertising|Enterprise Software|Market Research|Mobile,2770000.0,GRC,3,10,624,15949,16573,0
Alumni,41250.0,HKG,1,1,0,16648,16648,0
Identity|Market Research|Polling|Reviews and Recommendations|Social Network Media|Surveys|Web Hosting,2000000.0,ISR,2,4,731,13514,14245,0
E-Commerce|Mobile Commerce|Social Commerce,26000.0,MEX,1,1,0,16507,16507,0
Biotechnology,9836167.09442583,AUS,1,3,0,15755,15755,0
Photography,62809189.0,CHN,6,14,1492,14000,15492,0
Telecommunications|Wireless,5900000.0,USA,2,6,863,12900,13763,1
Semiconductors,40118148.0,USA,5,3,1739,14572,16311,0
Textiles,3600000.0,IND,1,1,0,16272,16272,0
Education,350000.0,JPN,2,4,150,16375,16525,0
Games,4348183.0,KOR,1,3,0,16293,16293,0
Health Care,1000000.0,ISR,1,1,0,13514,13514,0
Biotechnology,14000000.0,USA,1,1,0,14700,14700,1
Hardware + Software,21000000.0,NLD,1,1,0,13518,13518,0
Business Development|Energy Efficiency|Software,3091250.0,ESP,1,2,0,13262,13262,1
Architecture|PaaS,50000.0,USA,1,1,0,16344,16344,0
Biotechnology,100000.0,USA,1,1,0,16233,16233,0
Biotechnology,3237000.0,FRA,1,4,0,14985,14985,0
Health and Wellness,58135276.0,USA,4,9,2299,13920,16219,0
Software,73500000.0,USA,5,12,2498,10957,13455,1
Browser Extensions|Search|Social Bookmarking,20000.0,USA,1,1,0,15065,15065,0
Biotechnology,32465549.9144792,GBR,4,9,2228,13684,15912,0
Health Care,830000.0,ISR,1,1,0,14879,14879,0
Legal,1198763.0,GBR,1,1,0,14204,14204,0
Curated Web|Fashion|Shopping,22100000.0,USA,3,9,1508,13854,15362,1
Information Technology,1711039.0,FRA,1,1,0,16458,16458,0
Internet|Marketplaces|Mobile|Software|Transportation|Travel,65118.0,LTU,2,1,35,15396,15431,0
Recruiting,120000.0,USA,2,2,31,16405,16436,0
Fashion,1600000.0,THA,2,7,235,16342,16577,0
Price Comparison|Restaurants,270862.0,ESP,1,1,0,16233,16233,0
Consulting|Recruiting|Service Providers|Staffing Firms,500000.0,RUS,1,1,0,15371,15371,0
Entrepreneur,500000.0,CAN,1,1,0,16400,16400,0
Design|E-Commerce|Internet|Marketplaces|Music|Photography|Video,61500000.0,USA,2,5,2388,13879,16267,0
Data Center Automation|Data Visualization|Testing,182055.0,BRA,1,1,0,10926,10926,0
Android|iPad|iPhone|Mobile|NFC,21500000.0,USA,5,1,1069,15168,16237,0
Consulting,2000000.0,USA,1,1,0,15106,15106,0
E-Commerce|Internet Marketing|Ticketing,1500000.0,RUS,1,1,0,15765,15765,0
Software,7500000.0,USA,1,2,0,13628,13628,1
Advertising,23949992.0,USA,5,1,1898,14328,16226,1
Big Data Analytics|Marketing Automation|Mobile Analytics|Telecommunications,34650000.0,ISR,2,7,729,13556,14285,0
B2B Express Delivery|Logistics|Service Providers,255564.0,ITA,2,3,538,15979,16517,0
Mobile,25000.0,USA,1,1,0,15553,15553,0
Digital Media,1702600.0,USA,4,4,601,15803,16404,0
Advertising|Crowdsourcing|Facebook Applications|Photo Sharing|Social Media|Twitter Applications,280000.0,USA,2,3,195,16071,16266,0
Apps|Rapidly Expanding|Software,700000.0,USA,2,4,454,15819,16273,0
Games,29866459.0,USA,2,3,134,14389,14523,1
Advertising|Apps|Brand Marketing|Mobile|Social Media Marketing,838313.0,IRL,4,7,840,15371,16211,0
Celebrity|Chat|Entertainment|Media|Music|News,5500000.0,USA,2,7,487,15008,15495,0
Career Management|Education|Health and Wellness|Language Learning|Music|Nutrition,2500000.0,USA,3,9,174,15672,15846,0
Curated Web,4700000.0,USA,1,3,0,13939,13939,0
FreetoPlay Gaming|Games,1544188.0,SWE,3,2,855,15461,16316,0
E-Commerce,34100000.0,USA,4,15,1179,15397,16576,0
Real Estate,501937.0,ESP,2,1,304,16191,16495,0
Fashion,500000.0,USA,2,1,90,16132,16222,0
Mobile|Personalization,1500000.0,ISR,1,1,0,15383,15383,0
Advertising|Brand Marketing|Content|Creative|Curated Web|Photography|Project Management|Social Network Media|Video,15282497.0,USA,3,2,665,14868,15533,0
Big Data|Communities|Finance|Polling|Software,2410000.0,USA,3,13,457,15400,15857,1
Analytics|Mobile|Social Media Marketing|Virtual Currency,2320000.0,USA,4,15,660,15979,16639,0
Advertising,12250000.0,USA,2,4,543,13545,14088,1
Biotechnology,20629520.0,GBR,6,9,1837,13928,15765,0
Analytics|Internet|Messaging|Sales and Marketing,975000.0,USA,5,4,921,15248,16169,0
Games,25000.0,URY,1,1,0,15584,15584,0
Location Based Services|Mobile|Social Media,831000.0,USA,2,3,365,15584,15949,0
Real Estate,40000.0,USA,1,1,0,15380,15380,0
Hospitality|Marketplaces|Peer-to-Peer|Retail Technology,20000.0,USA,1,1,0,16232,16232,0
Beauty|Digital Media|Fashion|Lifestyle,2800000.0,IND,3,12,857,15887,16744,0
Apps|Mobile|Mobile Commerce|SaaS,1293758.0,GBR,3,3,1167,15340,16507,0
Curated Web|Internet|Networking|Social Media|Startups,98850000.0,USA,3,16,594,15861,16455,0
Apps|Home Owners|Mobile,1024999.0,USA,1,2,0,16364,16364,0
Software,1151496.0,BEL,1,2,0,16268,16268,0
Mobile,3400000.0,USA,1,1,0,12893,12893,0
Gamification|Hardware + Software|Social Media|Sports,25000.0,USA,1,2,0,15400,15400,0
Medical Devices,36000000.0,USA,2,3,370,16358,16728,0
Games,9425000.0,USA,3,8,405,15126,15531,0
Entertainment,42000000.0,USA,1,4,0,11688,11688,1
Software,31400000.0,USA,2,6,477,12940,13417,0
Health Care|Healthcare Services|Medical,46500000.0,IND,2,7,657,16041,16698,0
Auctions|E-Commerce|Lifestyle|Marketplaces|Online Shopping,8009431.0,USA,2,2,693,14294,14987,0
Crowdfunding|Financial Services,1500000.0,USA,1,3,0,16289,16289,0
Design,125000.0,PHL,1,1,0,15796,15796,0
Apps|Business Development|Collaboration|Colleges|Curated Web|EdTech|Education|File Sharing|Internet|Networking|Technology,2100000.0,USA,2,5,413,16282,16695,0
Software,3400000.0,USA,2,7,467,13489,13956,1
Health Care|Information Technology|Software,14950000.0,USA,3,3,955,13404,14359,1
Cloud Computing|Data Security|Privacy|Security,2000000.0,USA,2,3,564,15340,15904,1
Biotechnology,249099998.0,USA,5,37,2919,12396,15315,1
Development Platforms|Infrastructure|Software,8500000.0,USA,1,2,0,16608,16608,0
CRM|Enterprises|Internet|Local Businesses|Point of Sale|Retail|SaaS|Small and Medium Businesses|Web Development,1750000.0,ISR,1,2,0,15162,15162,0
Fashion|Location Based Services|Mobile|Shopping|Social Media,4600000.0,USA,2,6,283,14985,15268,0
Big Data,2250000.0,USA,2,8,141,16160,16301,0
Communities|E-Commerce|Fashion|Internet|Marketplaces|Mobile|Real Time|Social Commerce|Social Media|Technology,40500000.0,USA,3,19,1540,15006,16546,0
Renewable Energies,40000000.0,USA,1,1,0,16329,16329,0
CRM|Loyalty Programs|Software,3200000.0,USA,1,2,0,16205,16205,0
Biotechnology,6396054.0,USA,3,3,231,14361,14592,0
Search|SEO,745000.0,POL,2,3,288,15476,15764,0
Clean Energy|Energy Efficiency|Energy Management,1550000.0,TUR,1,1,0,13763,13763,0
Security,2350000.0,USA,1,3,0,13781,13781,1
Ad Targeting|Advertising,13550000.0,USA,4,11,1284,14655,15939,1
Health Care|Health Diagnostics|Medical Devices,1912996.0,USA,4,4,730,15400,16130,1
Manufacturing,350000.0,USA,1,1,0,15459,15459,0
Apps|iPad|iPod Touch|Point of Sale|Software,15000000.0,USA,1,1,0,16601,16601,0
Point of Sale|Real Time|Retail Technology,622858.0,DEU,1,1,0,16419,16419,0
Search,2000000.0,AUS,3,2,1412,14861,16273,0
Games,1500000.0,USA,1,1,0,13571,13571,0
Business Services|Design|Enterprises,36519.0,KOR,1,1,0,15748,15748,0
Blogging Platforms|Curated Web,200000.0,CAN,1,1,0,15840,15840,0
Software,4000000.0,ISR,1,1,0,14710,14710,0
Apps|Mobile,3882595.0,USA,3,13,371,15295,15666,0
Facebook Applications|Productivity Software|Sales and Marketing|Social Media|Twitter Applications|Web Development,143083.0,ARG,2,2,70,15422,15492,1
E-Commerce|Postal and Courier Services,160000.0,IND,1,7,0,16594,16594,0
Blogging Platforms|Curated Web|Networking,10140000.0,USA,5,23,1863,14000,15863,1
Delivery|Retail,310219.0,GBR,1,1,0,16629,16629,0
Messaging,700000.0,USA,3,10,537,14457,14994,1
Software,1000000.0,IND,1,1,0,16581,16581,0
Finance|Software,718000.0,USA,2,6,126,15720,15846,0
Apps|Mobile|Restaurants,925000.0,USA,1,1,0,16251,16251,0
Messaging,24300000.0,USA,2,5,771,12759,13530,1
Advertising|Forums,31249996.0,USA,4,13,1849,14767,16616,0
Analytics,610000.0,USA,2,8,212,15279,15491,0
Software,11000000.0,USA,1,4,0,11631,11631,1
Hospitality|Restaurants,58000000.0,USA,1,4,0,13311,13311,1
Semiconductors,8000000.0,CAN,1,3,0,12972,12972,0
Hospitality,154320.0,USA,1,1,0,16112,16112,0
Crowdfunding|Digital Media|News|Publishing|Search Marketing,350000.0,USA,3,2,396,16071,16467,0
Retail,44579707.0,GBR,1,1,0,16259,16259,1
Coupons|E-Commerce|Internet,132562.0,BRA,2,2,61,15918,15979,0
E-Commerce,750000.0,GBR,1,1,0,15891,15891,0
Mobile|Photo Sharing|Social Network Media,75000.0,USA,1,3,0,16191,16191,0
Sporting Goods,2500000.0,USA,1,2,0,16337,16337,0
Coupons|E-Commerce|Loyalty Programs|Mobile Commerce|Mobile Payments|Payments|Point of Sale|Retail Technology,176700000.0,GBR,3,2,443,15938,16381,0
E-Commerce|Hunting Industry|Marketplaces,650000.0,USA,1,1,0,16190,16190,0
Energy,40000.0,CHL,1,1,0,16222,16222,0
Hardware + Software,6000000.0,USA,1,4,0,13848,13848,0
Data Center Automation,62750002.0,USA,8,14,936,14364,15300,0
Sports,8000000.0,SWE,1,1,0,13647,13647,0
Curated Web,6000000.0,USA,1,2,0,13910,13910,0
Security,254995.0,USA,2,1,578,15539,16117,0
Clean Technology,1400000.0,USA,1,1,0,13907,13907,0
Nanotechnology,113643.0,GBR,1,2,0,16049,16049,0
Web Hosting,14970000.0,DEU,2,3,755,15517,16272,0
Clean Technology,50000000.0,USA,1,2,0,14050,14050,0
Public Transportation,1948368.0,CHN,1,1,0,15918,15918,0
Enterprise Software,14800000.0,IND,3,7,988,15340,16328,0
Clean Energy|Clean Technology|Energy|Internet|Portals|Price Comparison|Startups,1575000.0,USA,3,6,524,14789,15313,1
Mobile,9000000.0,NZL,2,3,166,15811,15977,0
Clean Technology,9981363.0,SWE,2,1,1832,14518,16350,0
Cloud Computing|Cloud Management|Networking|Software|Wireless,6000000.0,USA,2,3,378,14944,15322,1
Web Hosting,3200000.0,USA,1,1,0,14790,14790,0
Software,5300000.0,USA,1,1,0,16203,16203,0
Industrial Automation|Intelligent Systems|VoIP,71000000.0,USA,6,22,2223,9496,11719,1
Business Services|Consulting|Facebook Applications|Sales and Marketing|Services|Social Media|Social Media Marketing,19398821.0,USA,3,1,1378,13242,14620,1
Big Data|Cloud Infrastructure|Predictive Analytics,25000.0,USA,1,1,0,15742,15742,0
Web Hosting,31720203.0,USA,3,5,1390,13164,14554,0
Batteries|Manufacturing|Renewable Energies,27000000.0,USA,3,12,2667,12733,15400,0
Big Data Analytics|Clean Technology|Energy IT|Energy Management|Internet of Things,12366014.0,USA,16,7,1876,14334,16210,0
Apps|Email|Messaging,11900000.0,USA,3,21,470,15202,15672,0
Clean Technology|Energy|Industrial Energy Efficiency,31756275.0,USA,7,5,2570,13664,16234,0
Energy|Industrial|Innovation Management|Lasers|Manufacturing,13103215.903560301,GBR,1,5,0,12804,12804,1
Information Services,6698864.0,USA,2,2,120,16217,16337,0
Nanotechnology,10000000.0,USA,1,1,0,13079,13079,0
Clean Technology,17738913.0,GBR,4,7,571,15177,15748,0
Hardware + Software,979000.0,GBR,1,2,0,13888,13888,0
Analytics|Reviews and Recommendations|Social Commerce|Software,75120312.0,USA,7,15,3143,13118,16261,1
Search,33000000.0,USA,3,11,396,13269,13665,1
Education|Services,2500000.0,USA,1,2,0,12326,12326,1
Clean Technology,65000000.0,TWN,1,1,0,13514,13514,0
Human Resources|Recruiting|Technology,7500000.0,USA,2,4,364,16252,16616,0
Hardware + Software,39496651.0,USA,7,30,2562,13864,16426,1
Renewable Tech,1354614.0,GBR,2,1,271,16338,16609,0
Health Care,86500000.0,USA,5,19,2359,13878,16237,0
Analytics|Big Data|Consumers|Curated Web,135692.0,GBR,2,4,383,16080,16463,0
Graphics|Presentations|Promotional|Software|Video,780000.0,GBR,2,3,368,15321,15689,0
Clean Energy|Clean Technology|Services,750000.0,USA,1,1,0,16502,16502,0
Entertainment|Games|Graphic Design|Media|Social Media,2500000.0,IRL,2,6,753,15584,16337,0
Software,4022000.0,USA,2,6,281,16205,16486,0
Enterprise Software|Human Resources|Social Business,2150000.0,USA,1,3,0,15691,15691,0
Biotechnology,33800000.0,FRA,2,5,1474,14848,16322,0
Android|Financial Services|Local Commerce,28000000.0,USA,2,9,358,16372,16730,0
Finance|FinTech,70200000.0,CHN,5,12,2618,13910,16528,0
Mobile,1000000.0,CAN,1,2,0,15796,15796,0
Publishing,21000000.0,CHN,1,3,0,13783,13783,0
Photography,59640000.0,CHN,4,5,2130,13118,15248,1
Clean Technology,3000000.0,USA,1,2,0,13902,13902,0
Photography,706500000.0,CHN,5,9,3195,12784,15979,1
Transportation,60000000.0,CHN,1,6,0,16379,16379,0
Banking|Cyber Security|Wireless,118000.0,DEU,2,2,507,16010,16517,0
Media|Photo Sharing|Software,643300.0,IRL,1,6,0,16086,16086,0
Distribution,12800000.0,IND,1,1,0,16701,16701,0
E-Commerce,40000.0,USA,1,1,0,15180,15180,0
Biotechnology,250000.0,USA,1,1,0,15160,15160,0
Human Resources|Sustainability|Technology,9750000.0,USA,4,8,1621,14917,16538,0
Electronic Health Records|Health and Wellness|Health Care|Physicians,157519998.0,USA,12,59,2059,14304,16363,0
Accounting|Analytics|SaaS,1699290.0,AUS,3,4,723,15705,16428,0
Health Care|Marketplaces|SaaS|Software,124000000.0,IND,3,10,1102,15551,16653,0
Big Data|Cloud Data Services|Cyber Security|Information Technology,5400000.0,USA,2,6,290,16405,16695,0
Electronics,8100000.0,GBR,1,1,0,16462,16462,0
Software,2400000.0,USA,1,1,0,16646,16646,0
Software,4850000.0,USA,3,4,561,16049,16610,0
Apps|Health Care|Life Sciences,25000.0,USA,1,1,0,16315,16315,0
Health Care,627000.0,FRA,1,2,0,13431,13431,0
Analytics|Retail Technology,1000000.0,USA,2,8,106,16587,16693,0
Analytics|Big Data|Customer Service|Software|Tech Field Support,10477146.0,USA,3,14,859,15765,16624,0
Health and Wellness,5858102.0,USA,3,1,1281,15315,16596,0
Ad Targeting|Big Data Analytics|Brand Marketing|Content|Messaging|Mobile|Music|Psychology,157923.0,GBR,1,2,0,15737,15737,0
Consulting,9686236.0,USA,1,1,0,16072,16072,0
Biotechnology|Health Diagnostics,2875000.0,USA,2,5,755,15251,16006,0
Biotechnology,4500000.0,USA,1,1,0,15993,15993,0
Public Transportation,13060025.0,USA,6,1,1984,13514,15498,0
Architecture|Business Intelligence|Software,6776999.0,USA,7,1,1779,13944,15723,1
Biotechnology|Health Diagnostics,50795000.0,USA,2,1,565,16162,16727,0
Biotechnology,36100000.0,USA,2,1,1427,15286,16713,0
Biotechnology,25600000.0,USA,1,6,0,16566,16566,0
Biotechnology,115400002.0,USA,3,7,1028,14943,15971,1
Health Care,150000000.0,USA,1,4,0,15797,15797,0
Advertising,1515000.0,USA,2,8,546,15400,15946,0
Computers|Networking|Technology,10000000.0,USA,2,4,391,12112,12503,0
Biotechnology,13400000.0,CAN,1,3,0,16707,16707,0
Biotechnology|Health Diagnostics,93000000.0,USA,3,3,6070,10317,16387,0
Analytics|Fitness|Medical,14500000.0,USA,1,1,0,16526,16526,1
Databases|Drones,11000000.0,USA,2,6,401,15930,16331,0
Business Intelligence|Software,1970000.0,GBR,1,1,0,13502,13502,0
Software,2150000.0,USA,2,5,611,12947,13558,1
Analytics|Developer APIs|Finance|FinTech|Services,2818000.0,USA,4,10,583,15187,15770,1
E-Commerce,33500000.0,CHN,2,5,638,11109,11747,0
Clean Technology,9500005.0,USA,4,1,1181,14615,15796,0
Consulting|Health Care,12020000.0,USA,2,2,217,14621,14838,1
Advertising,4300000.0,USA,1,2,0,13963,13963,0
Finance|Software,552270.0,IRL,1,1,0,11486,11486,0
Biotechnology|Health Diagnostics,56750000.0,USA,3,9,1278,13500,14778,0
Analytics|Big Data|Business Intelligence|Developer APIs|Machine Learning,100000.0,USA,1,1,0,14975,14975,0
Enterprise Resource Planning|Predictive Analytics|SaaS,15000000.0,USA,1,3,0,16407,16407,0
Analytics|Artificial Intelligence|Big Data|Machine Learning|Reviews and Recommendations,230000.0,MYS,1,2,0,16195,16195,0
Mobile Commerce,1850000.0,USA,2,5,570,16102,16672,0
Customer Service|Predictive Analytics|Small and Medium Businesses,103243.0,USA,2,2,181,15706,15887,0
Enterprise 2.0|Market Research,650000.0,AUT,1,1,0,15676,15676,0
Health and Wellness,20500009.0,USA,3,9,825,15588,16413,1
Software,36825000.0,USA,5,14,1789,14763,16552,0
Analytics|Big Data Analytics|Deep Information Technology|Government Innovation|Law Enforcement|Predictive Analytics|Public Safety|SaaS,3675000.0,USA,2,3,733,15529,16262,0
Software,50000.0,SWE,1,1,0,13978,13978,0
Hardware|Lifestyle|Mobile,250000.0,USA,2,6,292,16399,16691,0
Cloud Computing|Software,250000.0,USA,2,2,512,12886,13398,0
Beauty|Consumer Internet|E-Commerce|Social Commerce|Women,800000.0,ISR,1,4,0,15622,15622,0
Enterprise Software,17000000.0,USA,1,1,0,13756,13756,0
Biotechnology,57968922.8844951,GBR,2,7,160,13691,13851,1
Software,11250000.0,USA,2,5,1518,14860,16378,0
Health and Wellness,1400000.0,USA,1,1,0,16715,16715,0
Health and Wellness,4000000.0,USA,1,1,0,14875,14875,1
Analytics|Business Intelligence|Information Services,61000000.0,USA,4,12,1241,15461,16702,0
Software,4010000.0,DNK,1,2,0,13542,13542,0
Publishing|Startups,1364033.0,ITA,1,1,0,16218,16218,0
Analytics,293900.0,USA,3,3,550,14637,15187,0
Technology,1200000.0,USA,2,6,353,16369,16722,0
Babies|Biotechnology|Parenting,2650000.0,HKG,1,4,0,16407,16407,0
Clean Technology,15650000.0,USA,3,4,715,13278,13993,1
Brand Marketing|Hospitality|Mobile|Mobile Payments|Point of Sale|Restaurants|Social Media,70000.0,USA,2,4,43,15841,15884,0
Enterprise Software,8763259.0,USA,7,1,4244,12373,16617,0
Software,6411000.0,USA,3,3,1093,14517,15610,0
Education,55500.0,USA,1,1,0,16562,16562,0
Apps|Augmented Reality|Fantasy Sports|Games|Mobile|Sports,8300000.0,USA,3,5,819,14988,15807,0
Education,240000.0,USA,1,1,0,15645,15645,0
Biotechnology,13566295.0,USA,4,1,1228,14549,15777,0
Health and Wellness|Health Care|Medical,100000.0,USA,1,1,0,16512,16512,0
Software,1375000.0,USA,2,1,246,16485,16731,0
Enterprise Software|Networking,2960000.0,USA,3,6,2802,13848,16650,0
Concerts|Crowdfunding|Curated Web|Events|Ticketing,406500.0,LBN,3,4,890,15577,16467,0
Software,490007.121436832,GBR,1,1,0,13529,13529,0
Education,33711000.0,USA,3,12,1833,14923,16756,0
Artificial Intelligence|Computer Vision|Social Media|Video on Demand|Video Streaming,20000.0,USA,3,4,334,15857,16191,0
EdTech|Education,85000.0,NLD,2,1,65,15797,15862,0
Education|Video,10000.0,OMN,1,1,0,15826,15826,0
CRM|Presentations|Salesforce Killers,720000.0,USA,3,1,335,16191,16526,0
Biotechnology,100183473.0,USA,6,9,2483,13754,16237,0
EdTech|Education,9500000.0,USA,2,2,352,14062,14414,1
Entertainment|Startups|Travel|Travel & Tourism,2700000.0,IND,2,4,230,16302,16532,0
Software,14000000.0,ISR,3,5,1115,12940,14055,1
Blogging Platforms|Web Hosting,1500000.0,USA,2,1,896,15645,16541,0
Advertising|Journalism|Local|News,312004.0,GBR,3,2,403,15006,15409,0
Internet|Media|Public Relations,9786.0,POL,1,2,0,16270,16270,0
Advertising|Apps|Education|iOS|iPad|Media|News|Publishing|Software|Tablets|Web Development,3600000.0,CAN,2,6,722,15776,16498,0
Curated Web|Publishing,6000000.0,USA,1,2,0,14126,14126,0
Android|iOS|Mobile|SaaS,268000.0,POL,2,2,792,15034,15826,0
News,500000.0,IND,1,1,0,15340,15340,0
Health and Wellness|Publishing,7057846.66482148,CAN,1,1,0,12859,12859,0
Curated Web,1070000.0,MEX,2,1,353,15905,16258,0
Finance|Financial Services|Internet,200000.0,ESP,1,1,0,15340,15340,0
E-Commerce|Internet|Open Source|Software,14779992.0,FRA,4,18,1961,14173,16134,0
Finance|Financial Services|Internet,1287243.0,ITA,2,12,324,16008,16332,1
Semiconductors,8000000.0,USA,2,1,372,14623,14995,0
Messaging,10000000.0,USA,1,2,0,13291,13291,0
Brand Marketing|Business Services|Creative|Design|Internet|Printing|Public Relations|Sales and Marketing|Services,25000.0,USA,2,2,524,15779,16303,0
Hardware + Software|Manufacturing,33500000.0,USA,1,1,0,14627,14627,1
Bio-Pharm|Biotechnology|Pharmaceuticals,95000000.0,USA,3,17,1530,12222,13752,0
Automotive|Enterprise Software|Hardware + Software|Machine Learning|Predictive Analytics,25000.0,USA,1,2,0,16559,16559,0
Brand Marketing|Events|Photography|Software,120000.0,USA,1,1,0,16405,16405,0
Internet,120000.0,USA,1,1,0,16267,16267,0
E-Commerce|Lingerie|Retail,2000000.0,IND,1,3,0,16321,16321,0
Games,3600000.0,FRA,1,1,0,15113,15113,0
Content Delivery|Digital Media|Internet Technology|Social Media,1500000.0,DEU,2,2,642,16024,16666,0
Biotechnology,1658000.0,USA,2,1,31,15733,15764,0
Network Security,4000000.0,USA,1,1,0,16239,16239,0
Big Data|Predictive Analytics|Software,9551530.0,USA,3,8,1218,15398,16616,0
E-Commerce|Ticketing,100000.0,GBR,1,1,0,13708,13708,0
Health and Wellness,1500000.0,USA,1,2,0,15022,15022,0
Health and Wellness|Health Care|Mobile Health,2205500.0,USA,6,21,169,15887,16056,0
Security,10000000.0,USA,2,4,571,12467,13038,0
Advertising|Content|Content Syndication|Entertainment|Film|Internet|Promotional|Video,4000000.0,DNK,1,1,0,13848,13848,0
Software,350000.0,USA,1,1,0,15715,15715,0
Enterprise Software,5000000.0,USA,1,2,0,13059,13059,0
Data Security|Information Technology|IT and Cybersecurity|Security|Web Tools,11127000.0,USA,4,8,660,15845,16505,0
Biotechnology|Health and Wellness|Health Care,7200000.0,CAN,2,3,193,16506,16699,0
Biotechnology,10200000.0,USA,2,2,12,15093,15105,0
Health and Wellness|Medical|Pharmaceuticals,10000000.0,CHE,1,3,0,16490,16490,0
Health and Wellness,250000.0,USA,1,1,0,15355,15355,0
Presentations|Software,71260000.0,USA,4,6,2514,13879,16393,0
Advertising|Facebook Applications|Social Media,500000.0,ISR,1,1,0,15706,15706,0
Big Data|Optimization|Startups,40000.0,USA,1,1,0,16055,16055,0
Curated Web,300000.0,USA,1,1,0,15175,15175,0
E-Commerce,150000.0,JPN,2,4,469,16043,16512,0
Coupons|Shopping,100000.0,IND,1,1,0,16363,16363,0
Auctions|E-Commerce|Online Auctions,400000.0,USA,1,1,0,14504,14504,0
Clean Technology|Risk Management,12000000.0,USA,1,4,0,15048,15048,0
Hotels|SaaS|Software,10381850.0,FRA,2,4,451,16028,16479,1
Curated Web,1670000.0,USA,3,33,155,15309,15464,0
Curated Web|Price Comparison,3000000.0,AUS,2,4,404,16096,16500,0
Comparison Shopping|Curated Web|E-Commerce|Peer-to-Peer,1000000.0,USA,1,2,0,15778,15778,0
E-Commerce,350000.0,USA,2,1,529,15862,16391,0
E-Commerce,250000.0,GBR,1,7,0,15721,15721,0
Advertising|Analytics|Big Data|Digital Media|Freemium|Network Security|SaaS|Subscription Businesses,1325000.0,USA,4,3,1215,15131,16346,0
Clean Technology,1400000.0,USA,3,1,2064,14678,16742,0
Software,413000.0,SWE,1,1,0,14697,14697,0
Mobile|Photography,120000.0,USA,2,2,121,16405,16526,0
Software,6199900.0,USA,2,1,2278,12940,15218,0
Health Care,4350000.0,USA,2,1,487,16222,16709,0
Curated Web,632500.0,USA,4,1,959,14706,15665,0
Health Care,14250000.0,USA,3,7,1147,13149,14296,1
Software|Storage|Virtualization,60000000.0,USA,2,9,103,16008,16111,0
Health Care,15000000.0,USA,1,1,0,15462,15462,0
Enterprises|Manufacturing,31750000.0,USA,3,8,397,10772,11169,0
Bio-Pharm|Health and Wellness|Therapeutics|Waste Management,12533144.0,SGP,1,3,0,16351,16351,0
Games,53000000.0,IND,1,1,0,15877,15877,0
Biotechnology,516685.0,USA,3,1,749,15335,16084,0
Health and Wellness,8000000.0,USA,1,1,0,16149,16149,0
Mobile|Photo Sharing|Social Media,930000.0,JPN,2,5,747,15850,16597,0
Real Estate,12866000.0,USA,1,2,0,16110,16110,0
Analytics|News|Opinions|Social Media|Tracking,525000.0,USA,3,13,228,15866,16094,0
Biotechnology,33151129.0,USA,3,12,660,13887,14547,0
Finance|Financial Services,91640001.0,USA,3,3,3494,13045,16539,0
3D|Hardware|Hardware + Software|Sensors,29400000.0,ISR,3,6,1618,13368,14986,1
Biotechnology,5500000.0,USA,1,1,0,15943,15943,0
Manufacturing,1000000.0,USA,2,3,1410,13770,15180,0
Food Processing,3500000.0,USA,2,4,589,15930,16519,0
All Students|Education|Robotics|Technology,792183.0,GBR,4,4,577,15949,16526,0
Software,66891.0,ITA,1,1,0,15943,15943,0
E-Commerce,3912490.0,FRA,1,2,0,16318,16318,0
Clean Technology|Fuels|Oil & Gas,59000000.0,USA,4,1,2192,13514,15706,0
Clean Technology,107000000.0,USA,5,12,1976,14711,16687,0
Public Relations,42000000.0,USA,1,1,0,12055,12055,0
Payments|Services,5000000.0,USA,1,3,0,12303,12303,0
Manufacturing,950000.0,USA,1,1,0,16100,16100,0
Data Privacy|Enterprise Software|Software,21000000.0,USA,1,2,0,11772,11772,1
Biotechnology,89901817.0,USA,4,11,1642,15015,16657,0
Clean Technology,10000000.0,CHE,1,2,0,14300,14300,0
Printing,11400000.0,USA,2,3,0,12501,12501,1
E-Commerce,4250000.0,USA,1,6,0,16373,16373,0
3D Printing,41250.0,HKG,1,1,0,16648,16648,0
Software,40000000.0,USA,1,5,0,11690,11690,1
Software,325006.0,USA,4,2,1122,14846,15968,0
E-Commerce,26200000.0,BRA,2,11,790,15560,16350,0
Fashion|Information Technology|Personalization|Printing,700000.0,RUS,1,1,0,15645,15645,0
E-Commerce,810094.0,IND,2,4,627,15968,16595,0
Hardware + Software,100000.0,USA,1,1,0,15706,15706,0
3D Printing|Software,840323.0,NLD,2,1,757,15991,16748,0
Internet,4500000.0,IND,1,1,0,16464,16464,0
Analytics|Big Data Analytics|Cloud Computing|Machine Learning|SaaS,1400000.0,USA,1,1,0,15371,15371,1
Hardware + Software,10529998.0,USA,4,3,1081,15342,16423,0
Consulting|Digital Media|Recruiting|Social Recruiting,100000.0,GBR,1,1,0,15708,15708,0
Medical,7000000.0,CAN,1,1,0,12682,12682,0
Biotechnology|Medical|Pharmaceuticals,15000000.0,USA,1,1,0,15869,15869,1
Analytics|Business Intelligence|Enterprises|Enterprise Software|Offline Businesses|Retail|Security|Technology|Video,23999700.0,USA,3,28,782,15218,16000,0
Clean Technology,9400000.0,USA,2,1,966,14344,15310,0
Search,7270987.0,GBR,4,1,1923,14302,16225,0
Cloud Computing|Cloud Data Services|Cloud Infrastructure|Communications Infrastructure|Data Integration|Embedded Hardware and Software|Enterprise Software|Internet of Things|Messaging|Real Time|Software|Technology,2320000.0,USA,1,2,0,14662,14662,0
Enterprise Software|Field Support Services|Google Glass|Insurance|Insurance Companies|Manufacturing|Mobile Enterprise|Wearables,6150000.0,USA,3,4,349,15993,16342,0
Mobile|Recruiting|Social Media|Startups,136779.0,KOR,2,1,122,15431,15553,0
Big Data|E-Commerce|Retail|Software,172713.0,TUR,1,1,0,16195,16195,0
Software,4100000.0,USA,2,2,151,13118,13269,0
Analytics,4875000.0,CAN,2,5,627,15645,16272,0
Security,2400000.0,USA,1,1,0,13059,13059,0
E-Commerce|Fashion|Retail,501642500.0,ESP,4,8,953,14886,15839,0
Biometrics|Security,29132871.0,USA,7,4,1990,13088,15078,0
Search,180000.0,USA,1,1,0,15949,15949,0
Software,414957.0,USA,2,1,375,15800,16175,0
Data Security|Security,2250000.0,USA,1,2,0,15497,15497,1
Finance,82000000.0,USA,2,2,629,15902,16531,0
News,1300000.0,USA,2,2,802,15540,16342,0
Doctors|Electronic Health Records|Health and Wellness|Medical|Physicians,417500000.0,USA,3,1,1364,14965,16329,0
Big Data|Data Privacy|Data Security|Financial Services|Telecommunications,1200000.0,GBR,1,5,0,16633,16633,0
Finance,355900000.0,USA,3,3,454,15827,16281,0
Advertising|Email Marketing|Marketing Automation|Retail,1857500.0,USA,4,10,664,15225,15889,0
3D|3D Printing|Application Platforms,20000.0,RUS,1,1,0,15796,15796,0
Internet|Mobile|Telecommunications,9300819.0,FRA,1,2,0,14644,14644,0
Celebrity|Charity|Curated Web|Nonprofits,2500000.0,USA,2,16,187,15675,15862,0
Finance,8000000.0,IND,1,1,0,15191,15191,1
3D|Augmented Reality|Internet|Online Shopping|Photography|Retail,540000.0,USA,3,3,622,15948,16570,0
Game|Games|Social Media,259989.0,AUT,1,1,0,14929,14929,0
Home & Garden|Home Renovation,17500000.0,USA,2,15,134,16203,16337,0
Biotechnology,2238535.0,GBR,2,5,887,13825,14712,0
Biotechnology,9514000.0,USA,13,12,693,14287,14980,1
Curated Web,449964.0,USA,1,1,0,15584,15584,0
Biotechnology,38500445.0,USA,3,7,1772,13551,15323,0
E-Commerce|Personalization,6000.0,CZE,1,1,0,15218,15218,0
Business Services|Information Technology|Software,15000000.0,USA,1,5,0,11520,11520,1
Hardware + Software,1000000.0,USA,1,1,0,15034,15034,0
Health Care,1600000.0,GBR,1,1,0,14518,14518,0
Bridging Online and Offline|Consumer Goods|Search,150000.0,RUS,1,2,0,15887,15887,0
Biotechnology,73422000.0,DEU,2,14,793,14550,15343,1
Curated Web|Nonprofits,340000.0,USA,1,2,0,15775,15775,0
Biotechnology,91667625.0,USA,3,2,14,16623,16637,0
Biotechnology,4000000.0,USA,2,3,1426,13643,15069,0
Software,15820000.0,USA,1,1,0,13313,13313,0
Consulting,994000.0,DEU,1,2,0,13805,13805,0
Accounting|BPO Services|Business Productivity|Business Services|Finance|Human Resources|Optimization|Professional Services|Project Management|Tracking,58000.0,USA,1,1,0,16455,16455,0
Software,3040000.0,GBR,1,1,0,13704,13704,0
Business Productivity|Productivity Software,4000000.0,USA,1,2,0,11495,11495,1
SaaS|Software,12690000.0,USA,6,2,2348,14250,16598,0
Information Technology|Services|Software,1346323.0,PRT,1,1,0,16275,16275,0
Analytics|Business Intelligence|Development Platforms|Software,7750000.0,USA,1,1,0,11877,11877,1
Software|Technology,8815715.0,USA,3,3,991,13514,14505,0
B2B|Internet|Internet Marketing,1340440.0,BRA,1,2,0,16283,16283,0
Construction|Software,49000000.0,USA,3,7,3003,13538,16541,0
Biotechnology,75000000.0,USA,2,2,1504,13502,15006,0
Enterprise Software|Health and Wellness|SaaS|Supply Chain Management,5100000.0,USA,2,8,594,15555,16149,0
Analytics|SaaS|Services,10000000.0,USA,1,1,0,12214,12214,0
Cloud Computing|Enterprise Purchasing|Enterprise Software|Procurement|SaaS|Supply Chain Management,5200000.0,CAN,3,9,968,15670,16638,0
Health and Wellness,18701000.0,USA,4,3,961,15756,16717,0
Application Platforms|Digital Media|Home Automation|Internet of Things|Services|Software,124130954.0,USA,4,1,1554,14614,16168,0
Communications Infrastructure|Service Providers|Software,142627.0,BRA,2,2,92,15826,15918,0
Health Care|Software,12500000.0,USA,1,1,0,16267,16267,0
Alumni|Crowdfunding|Education|Emerging Markets|Enterprises|Finance,100000000.0,GBR,2,3,0,16657,16657,0
Automotive,9345794.0,GBR,1,1,0,16652,16652,0
E-Commerce|Farmers Market|Organic Food|Specialty Foods,20000.0,USA,1,1,0,16287,16287,0
Curated Web,7540000.0,USA,4,21,100,16267,16367,0
Analytics|Databases|Education|Information Services|Sustainability,100000.0,USA,1,1,0,16283,16283,0
Collaboration|Productivity Software|Project Management|Software|Task Management,1310000.0,USA,3,17,566,14075,14641,1
Printing|SaaS|Search|Web Development,50000.0,CHE,1,1,0,13149,13149,0
Video,25000.0,USA,1,1,0,16467,16467,0
Biotechnology,29591206.0,USA,5,2,2695,13679,16374,0
Career Management|Manufacturing|Networking|Social Media|Social Network Media,4500000.0,RUS,3,2,1205,13912,15117,0
Education|High School Students|Online Education|Training,301531.0,BRA,4,4,791,15461,16252,0
Biotechnology,33000000.0,NLD,3,4,1592,13599,15191,1
Software,21250027.0,USA,4,22,2450,11485,13935,0
Computers|Enterprise Software|Information Technology|Services,5000000.0,USA,1,4,0,12404,12404,1
Personal Finance,1958854.0,GBR,1,1,0,16503,16503,0
Apps|Internet|Recruiting|Sports,35000.0,USA,2,1,328,15862,16190,0
Tracking,6500000.0,USA,2,5,490,13137,13627,1
Online Scheduling|Optimization|Software|Supply Chain Management,2500000.0,USA,1,1,0,15216,15216,0
Curated Web,1488888.0,USA,3,8,872,14823,15695,0
Enterprise Software,19500000.0,USA,1,2,0,15784,15784,0
Analytics,5500000.0,USA,3,4,2081,14543,16624,0
E-Commerce,40000.0,CHL,1,1,0,15911,15911,0
Data Mining|E-Commerce|Manufacturing|Retail,9043356.09036829,IRL,3,6,1364,14861,16225,0
Hardware + Software,7000000.0,USA,1,2,0,13567,13567,1
B2B|EdTech|Social Media,3375000.0,USA,3,3,739,14816,15555,0
Apps|Medical Devices|Technology,2500000.0,CAN,1,1,0,15120,15120,0
Finance,460000.0,USA,3,3,1032,13973,15005,0
Social Media|Software,40000.0,IND,2,2,217,16056,16273,0
Finance,1183804.0,GBR,2,1,3269,13269,16538,0
Biotechnology,15219122.0,USA,3,1,1036,15582,16618,0
Pharmaceuticals,5000000.0,USA,1,1,0,12754,12754,0
Biotechnology,4100000.0,TUR,1,2,0,13601,13601,0
Software|Testing,315380.0,EST,1,2,0,13993,13993,0
Consumer Lending|Financial Services,250300000.0,USA,9,34,3328,13149,16477,0
Legal,1750000.0,USA,1,3,0,13007,13007,0
Data Visualization|Finance Technology|FinTech,118000.0,USA,1,1,0,16517,16517,0
Bicycles,13550000.0,USA,3,4,413,15793,16206,0
Design,6600000.0,USA,3,12,419,15426,15845,0
Clean Technology,63200000.0,USA,5,12,2094,14202,16296,0
Project Management|Software,3500000.0,USA,1,1,0,16240,16240,0
Fashion,20000.0,USA,1,1,0,15431,15431,0
Curated Web,38025999.0,USA,4,12,1199,14741,15940,1
Business Productivity|Communities|EdTech|Education|Social Travel|Software|Universities,1300000.0,USA,3,3,850,15908,16758,0
Music|Networking,23000000.0,USA,2,4,436,13757,14193,0
Career Planning|Enterprise Software|Events|Hardware,344000.0,CAN,2,2,378,15674,16052,0
Classifieds,462249.0,TUR,1,1,0,16073,16073,0
Clean Technology|Hospitality|Technology,550000.0,IND,1,1,0,16587,16587,0
Biotechnology,33323892.0,USA,4,10,1808,13473,15281,0
Games,6000000.0,USA,1,3,0,16476,16476,0
Enterprise Software,51900000.0,USA,3,7,850,15061,15911,1
Messaging,4000000.0,ISR,1,2,0,12829,12829,0
Finance,10000000.0,USA,1,1,0,15386,15386,0
Biotechnology,63000000.0,USA,6,13,2336,13292,15628,0
Biotechnology,5337000.0,USA,3,4,1600,14487,16087,0
Agriculture|Clean Technology|Social Entrepreneurship,1129000.0,USA,2,3,1371,14679,16050,0
Biotechnology,70219776.0,BEL,3,6,1757,14642,16399,0
Clean Technology,20000000.0,USA,1,2,0,14431,14431,0
Biotechnology,1541809.0,SWE,1,1,0,15015,15015,0
FinTech|Local Businesses|Local Services|Payments|Real Estate,2250000.0,AUS,3,6,575,16035,16610,0
Mobile,210000.0,RUS,1,2,0,15461,15461,0
Advertising|Brand Marketing|Finance|Lead Generation|Sales and Marketing,2793000.0,USA,6,21,644,15034,15678,0
Beauty|E-Commerce|Health and Wellness|Marketplaces,5923950.0,ESP,3,4,890,15279,16169,0
Coupons|E-Commerce|Promotional,30000.0,USA,1,1,0,15706,15706,0
Analytics|Enterprise Software|Mobile|Social Media Marketing|Software,1700000.0,USA,2,2,1359,14061,15420,0
Advertising Platforms|Promotional,100000.0,USA,2,2,589,15694,16283,0
Advertising|B2B|Promotional|Small and Medium Businesses|Social Media Management,145000.0,EST,5,2,568,15715,16283,0
Analytics|Customer Service|Loyalty Programs|Predictive Analytics|Reviews and Recommendations|SaaS|Software,1037000.0,USA,3,13,696,15949,16645,0
Food Processing,3000000.0,USA,1,1,0,13966,13966,0
Mobile Payments|Network Security|Online Scheduling|SaaS|Small and Medium Businesses|Social Media Marketing|Software,1500000.0,USA,1,9,0,16034,16034,0
Mobile,17200000.0,USA,2,4,154,13398,13552,0
Biotechnology,80231452.0,CAN,5,10,1551,14970,16521,1
Consulting,66230.0,BEL,1,2,0,14335,14335,0
Mobile,3072516.0,USA,2,1,261,16147,16408,0
Mobile,16300000.0,USA,2,5,379,12079,12458,0
Food Processing,1600000.0,GBR,1,5,0,16674,16674,0
Android|Apps|iPhone|Mobile|Productivity Software,11600000.0,CAN,3,2,3614,13067,16681,1
Biotechnology,49800000.0,USA,3,5,583,16000,16583,0
Advertising|Brand Marketing|Clinical Trials|Consumers|Fitness|Health and Wellness|Health Care|Life Sciences|Market Research,1850000.0,USA,2,2,224,16244,16468,0
Enterprise Software|Software|Technology,79000000.0,USA,5,25,1596,12339,13935,1
Analytics|Customer Service|Customer Support Tools|Direct Sales|E-Commerce|Marketplaces|SaaS,860000.0,ISR,3,2,518,16071,16589,0
Networking,8000000.0,USA,1,2,0,12684,12684,0
Clean Technology,42187000.0,USA,11,18,2006,13679,15685,0
Angels|Biotechnology|Deep Information Technology|Medical Devices|Venture Capital,1500000.0,USA,1,4,0,16587,16587,0
Advertising|E-Commerce|Facebook Applications|Marketing Automation,954513.0,USA,3,9,654,15613,16267,0
Application Platforms|Curated Web|Mobile,1250000.0,USA,1,13,0,15883,15883,0
Geospatial|Industrial|Industrial Automation,1000000.0,AUS,1,2,0,16710,16710,0
Health Care,28365200.0,USA,4,3,801,15516,16317,0
Real Estate,2225000.0,ARG,3,4,549,15765,16314,0
Clean Technology,177000.0,SGP,1,2,0,16671,16671,0
Crowdfunding|Real Estate,866859.0,GBR,2,1,304,16119,16423,0
Financial Services|Real Estate,9767635.0,GBR,2,11,194,16321,16515,0
Real Estate,2000000.0,USA,1,1,0,13179,13179,1
Intellectual Asset Management|Property Management|Software,39994.0,IRL,1,1,0,15869,15869,0
E-Commerce|Real Estate,129000000.0,SGP,3,6,2715,13879,16594,0
Health and Wellness|Healthcare Services|Information Technology|Medical,7000000.0,USA,1,1,0,16071,16071,1
Internet|Software|User Experience Design,670000.0,CAN,1,3,0,16233,16233,0
Marketplaces|Real Estate|Realtors|Social Network Media,393353.0,BRA,3,2,1065,14975,16040,0
Commercial Real Estate|Information Services|Real Estate,3000000.0,IND,1,2,0,16589,16589,0
Real Estate,30000000.0,IND,1,1,0,16399,16399,0
Nonprofits,3200000.0,USA,2,2,546,16121,16667,0
Diagnostics|Information Technology|Medical|Software,1919773.0,BRA,4,4,410,16116,16526,0
Biotechnology|Medical,509656.0,ESP,1,3,0,14876,14876,0
Social Media,240000.0,JPN,2,4,328,15525,15853,0
FinTech|Investment Management|Marketplaces|SaaS|Security|Venture Capital,4375000.0,USA,2,2,873,15553,16426,0
Biotechnology|Health Care|Medical|Therapeutics,73272800.0,NLD,4,12,2708,13545,16253,1
Consulting|Information Services|Service Providers,4000000.0,USA,1,2,0,12437,12437,0
Biotechnology,35039850.0,USA,3,2,3119,13654,16773,0
Corporate Training|Education|Recruiting,2350000.0,USA,4,5,313,16351,16664,0
Predictive Analytics|Social Media|Social Media Management|Social Media Monitoring|Software,1400000.0,USA,1,3,0,15475,15475,0
Biotechnology,45049261.0,GBR,2,11,323,15161,15484,1
Financial Services,42176988.7035965,AUS,1,4,0,16681,16681,0
Information Technology|Startups,2700000.0,USA,1,1,0,13837,13837,0
Brand Marketing|Business Development|CRM|Lead Generation|SaaS|Software,139411.0,GBR,1,1,0,13997,13997,0
Credit|Crowdfunding|Finance|FinTech|Marketplaces|Peer-to-Peer|Personal Finance,354900000.0,USA,12,43,3681,12874,16555,0
Diagnostics|Nanotechnology|Pharmaceuticals,19299.0,USA,1,1,0,16020,16020,0
CRM|Enterprises|Google Apps|SaaS|Software,10000000.0,USA,2,16,699,15826,16525,0
Health Care,3000000.0,USA,2,2,2346,12898,15244,0
Enterprise Software|SaaS|Software,30121228.0,USA,8,3,2125,14228,16353,0
Bio-Pharm|Health Diagnostics|Medical,1060000.0,USA,1,2,0,16381,16381,0
Information Technology|Manufacturing|Storage,26400000.0,USA,3,6,1713,13089,14802,1
Information Security|Security,1572364.0,ESP,1,1,0,15219,15219,0
Biotechnology|Pharmaceuticals,4000000.0,ISR,1,3,0,14722,14722,0
Biotechnology,7130238.78319605,AUT,3,5,750,13149,13899,0
Health Diagnostics|Software,23728080.0,DEU,5,13,1583,13276,14859,0
Biotechnology,67000000.0,AUS,4,11,3222,13410,16632,0
Biotechnology,10000000.0,ISR,1,1,0,16722,16722,0
Health Care,8000000.0,USA,1,2,0,16040,16040,0
Automotive|Electronics|Systems|Technology,84000000.0,USA,1,3,0,15530,15530,0
Intellectual Property|Open Source|Security|Software,4190878.0,CAN,1,1,0,13893,13893,1
Information Security|Network Security,37150000.0,USA,3,11,923,15828,16751,0
Health and Wellness|Medical|Pharmaceuticals,12000000.0,USA,1,1,0,11607,11607,0
Data Security|Financial Services|Manufacturing,6300000.0,USA,1,2,0,12433,12433,1
Hospitality,22000000.0,USA,1,1,0,15954,15954,0
Biotechnology,24010000.0,USA,4,4,2177,12377,14554,1
Automotive|Security|Service Providers,452335.0,GBR,1,1,0,12585,12585,0
Big Data Analytics|Cyber Security|Health and Wellness|Health Care Information Technology,1350000.0,USA,4,3,362,16080,16442,0
Collaboration|Diagnostics|Health Diagnostics|Medical Devices|Technology,553573.0,CAN,1,1,0,16295,16295,0
Diagnostics|Medical|Pharmaceuticals,28002500.0,USA,3,3,1127,13587,14714,0
Biotechnology,7138312.0,CHE,3,2,1112,15351,16463,0
Biotechnology,126538660.0,USA,5,22,2444,13762,16206,1
Biotechnology,290000.0,USA,4,4,415,13033,13448,0
Biotechnology,110635271.0,USA,3,13,2570,14116,16686,0
Biotechnology,7016360.0,DEU,1,1,0,13747,13747,0
Public Transportation,207210700.0,USA,8,38,1847,14769,16616,0
Biotechnology|Specialty Chemicals,3500000.0,USA,1,5,0,15675,15675,0
Project Management|Software,200000.0,THA,1,1,0,15371,15371,0
Biotechnology|Health Care|Mobile|Software,315349979.0,USA,10,16,4780,11443,16223,0
Biotechnology,750000.0,USA,1,2,0,15588,15588,0
Consumer Goods,2000000.0,IND,1,1,0,16647,16647,0
Biotechnology,8250000.0,USA,2,7,358,13342,13700,1
Manufacturing,52000000.0,USA,1,1,0,14110,14110,1
Hardware|Marketplaces,133000.0,USA,2,1,78,15845,15923,0
Mobile,1600000.0,FIN,1,3,0,15706,15706,1
Software,2000000.0,USA,1,1,0,15743,15743,0
App Stores|Cloud Computing|Cloud Infrastructure|Collaboration|Communications Infrastructure|Developer APIs|File Sharing|Infrastructure|Personal Data|Social Network Media,5564999.0,DEU,3,1,555,15670,16225,0
Batteries|Computers|Online Shopping,181000000.0,USA,5,19,4673,11276,15949,1
Data Security|Email|Messaging|Security,2550000.0,CHE,2,2,229,16283,16512,0
Enterprise Software,8000000.0,USA,3,5,1186,14438,15624,0
Automotive|Diagnostics|Fleet Management|Gps|Software|Wireless,135000.0,USA,3,2,641,14975,15616,0
Enterprise Software,18384392.0,USA,5,5,1661,13171,14832,1
Health Care,6000000.0,USA,1,2,0,13962,13962,0
Fitness|Health and Wellness|Health Care,1400000.0,USA,1,1,0,16659,16659,0
Pharmaceuticals,827866.0,GBR,1,1,0,16315,16315,0
SaaS,266192.0,GBR,2,3,90,16040,16130,0
Agriculture|B2B|Information Technology|Marketplaces|Services|Software,1418000.0,CAN,5,8,780,15810,16590,0
Education|Internet|Recruiting,1693537.0,GBR,3,2,612,16161,16773,0
Biotechnology,6179090.0,GBR,1,1,0,14963,14963,0
Medical Devices,18800000.0,USA,2,6,513,16160,16673,0
Software,1796636.0,USA,2,4,640,14792,15432,0
Semiconductors,40000000.0,USA,4,15,1560,12682,14242,1
Hardware + Software,3164252.71049446,GBR,2,4,749,13901,14650,0
Biotechnology,8471104.0,USA,2,1,174,16507,16681,0
Health Care,6300000.0,USA,2,11,1329,12062,13391,0
Android|Apps|Internet|Mobile,25000.0,USA,1,1,0,16336,16336,0
Biotechnology,2410000.0,DNK,1,3,0,14277,14277,1
Apps|Sensors|Technology,19299.0,NLD,1,1,0,16020,16020,0
Mobile,11000000.0,USA,2,1,603,14469,15072,0
Music,40000.0,CHL,1,1,0,16049,16049,0
Health Care|Health Diagnostics|Medical,31000000.0,USA,2,16,561,11355,11916,1
Biotechnology,96500000.0,GBR,2,1,846,14400,15246,0
Intelligent Systems|Software|Storage,7999996.0,USA,4,2,184,15637,15821,1
Mobile,8581390.0,USA,4,4,1675,13607,15282,0
Advertising|Consumers|Mobile|NFC,8450972.0,USA,2,1,589,15470,16059,0
Advertising|Analytics,10411000.0,USA,4,5,1678,13273,14951,1
Networking|Real Estate,4000000.0,USA,1,1,0,15776,15776,0
Hardware + Software,3170000.0,DEU,1,1,0,13422,13422,0
Cloud Infrastructure|Distribution|Internet of Things|Mobile|Proximity Internet|Real Time,725000.0,USA,2,2,209,15874,16083,0
Biotechnology,105000.0,USA,2,4,482,15485,15967,0
Finance,52353659.0,FRA,4,5,1888,14730,16618,0
Clean Technology,51500000.0,USA,2,6,589,14670,15259,0
Human Resources|Internet|Recruiting,400000.0,RUS,1,1,0,15584,15584,0
Advertising|Internet|Monetization|Public Relations|Social Media|Television|Video,1314175.0,ESP,3,4,279,14518,14797,0
Software,1097000.0,FRA,2,3,399,13129,13528,0
Consumer Electronics|Mobile|Photography,2200000.0,USA,3,4,270,16265,16535,0
Displays|Hardware + Software,147558930.0,USA,3,2,660,14614,15274,0
Apps|Health Care Information Technology|Internet of Things|Personalization|Privacy|Quantified Self|Software|Tracking,700000.0,CHE,3,2,569,15522,16091,0
Software,90000000.0,BRA,3,13,583,16042,16625,0
Curated Web,1150000.0,ARG,1,1,0,15323,15323,0
Internet of Things|Semiconductors|Wireless,22600179.0,USA,3,4,342,16399,16741,0
Publishing,7000000.0,USA,1,6,0,12423,12423,0
Therapeutics,73360292.0,GBR,2,9,1044,15530,16574,0
Biotechnology,57800000.0,USA,3,1,603,15539,16142,1
Internet|Music|Social Media|Video Streaming,909601.0,GBR,5,3,1749,14342,16091,0
Legal,23000000.0,USA,2,6,472,13573,14045,1
Health Care,1000000.0,USA,1,1,0,16386,16386,0
Health Care|Healthcare Services|Hospitals,25000000.0,USA,1,3,0,12062,12062,1
Cloud Computing|Creative|Finance|Search|Software|Video Streaming|Web Development,618000.0,FRA,3,4,519,14999,15518,0
Biotechnology,3930701.0,GBR,1,2,0,13223,13223,0
Public Relations,11600000.0,GBR,1,4,0,12565,12565,1
E-Commerce|Mobile|Mobile Commerce|Mobile Payments,100000.0,IDN,1,3,0,15187,15187,0
Apps|Fitness|Health and Wellness|Mobile,30000.0,USA,1,1,0,15918,15918,0
Biotechnology|Health Care,417100000.0,USA,11,57,5077,11584,16661,1
Consulting,13182687.0,GBR,1,1,0,15986,15986,0
Publishing|Software,1016289.0,ITA,3,6,486,15796,16282,0
B2B|Content|Lead Generation,62000.0,USA,1,2,0,16455,16455,0
Enterprise Software,1392000.0,FRA,1,3,0,14413,14413,0
Gps|Location Based Services|Travel,4000000.0,USA,2,1,833,13917,14750,0
Communities|Crowdfunding|Data Integration|Nonprofits|Social Fundraising|Software,1925000.0,USA,2,2,293,16170,16463,0
Analytics,620000.0,USA,2,1,535,15803,16338,0
News,3700000.0,USA,2,1,1707,14860,16567,0
Games,639000.0,DEU,2,2,844,13339,14183,0
Education|Entrepreneur|Startups,100000.0,GBR,1,1,0,15918,15918,0
Analytics|Brand Marketing|Social Media,300000.0,UKR,1,1,0,16052,16052,0
Curated Web,6552136.0,USA,3,4,491,15131,15622,1
Enterprise Software|Publishing|Web Development,170000.0,GBR,2,2,179,15155,15334,0
News,2750000.0,USA,1,1,0,13939,13939,0
Apps|Blogging Platforms|Curated Web|Email Newsletters|Facebook Applications|iPad|iPhone|News|Publishing|SaaS,405955.0,GBR,2,1,380,14488,14868,0
Advertising|Marketing Automation,63000000.0,USA,6,20,2726,13879,16605,0
Apps|Cloud Computing|Developer APIs|Mobile|Real Time|Software|Web Development,60100000.0,USA,4,18,1279,15420,16699,0
Advertising,14500000.0,USA,3,6,794,13651,14445,0
Big Data|Blogging Platforms|Finance|Social Network Media,35000.0,ARG,1,3,0,16102,16102,0
News,630000.0,GBR,1,2,0,14298,14298,0
Communities|Gamification|Loyalty Programs|Software|User Experience Design,1000000.0,CAN,1,1,0,15645,15645,0
Biotechnology,83900000.0,USA,6,14,2288,14314,16602,0
Health Care,27541217.321805604,GBR,1,4,0,16035,16035,0
Bio-Pharm|Biotechnology|Pharmaceuticals,1000000.0,USA,1,1,0,16497,16497,0
Health and Wellness|Health Care|Medical Devices,500000.0,ISR,1,2,0,15849,15849,0
Biotechnology,93500000.0,USA,5,17,2690,13640,16330,0
Pharmaceuticals,209059.0,GBR,1,1,0,16130,16130,0
Data Centers|Information Technology|Location Based Services|Web Hosting,25733401.0,GBR,1,2,0,16254,16254,1
Advertising,2300000.0,USA,1,1,0,16239,16239,0
Advertising|Internet Marketing|Software,1200000.0,IRL,1,4,0,16463,16463,0
iPhone|News,9800000.0,USA,2,9,253,14888,15141,1
Analytics|Data Integration|Security,1135000.0,USA,2,2,219,16069,16288,0
Hardware + Software,121044236.0,USA,3,1,470,15664,16134,1
3D|Entertainment|Messaging,5800000.0,USA,1,4,0,13594,13594,1
Apps|Mobile,1750000.0,USA,2,11,488,15522,16010,0
Technology,30000000.0,USA,1,1,0,12535,12535,0
Health Care,6050000.0,USA,3,4,1064,15070,16134,0
Consumer Electronics|Software,2623873.0,FIN,2,2,288,16007,16295,0
Advertising|Content|Content Discovery|Content Syndication|Internet Technology|Technology,43485455.0,USA,4,6,1971,14736,16707,0
E-Commerce,40000.0,USA,1,1,0,15314,15314,0
Biotechnology,40000.0,CHL,1,1,0,15954,15954,0
Energy|Innovation Engineering|Services,1300000.0,USA,1,1,0,14214,14214,1
Apps|Fitness|Health and Wellness|Mobile|Mobile Social|Social Network Media,2640044.0,CAN,3,9,539,15737,16276,0
Apps|Entertainment|iPad|Media|Mobile|Tablets,2200000.0,USA,1,4,0,15126,15126,0
Hospitality|Restaurants|Specialty Foods,1750000.0,USA,1,1,0,16177,16177,0
Chat|Games|Messaging|Social Games|Virtual Worlds,2932278.0,USA,2,1,1153,13206,14359,0
Android|iPhone|Loyalty Programs|Mobile,50000.0,USA,1,1,0,15019,15019,1
Advertising,1700000.0,USA,1,1,0,15569,15569,0
Big Data|Cloud Computing|CRM|Incentives|Internet Marketing|Local|Loyalty Programs|Mobile|SaaS|Sales and Marketing|Social Media,4000000.0,USA,2,6,485,15447,15932,0
Analytics|Big Data|Gamification|Incentives|Loyalty Programs|SaaS,11500000.0,USA,3,11,1065,15125,16190,1
Fitness|Health and Wellness,20000.0,USA,1,1,0,16287,16287,0
Apps|Audio|Media|Podcast|Social Media,120000.0,USA,1,2,0,16622,16622,0
Gambling|Games|Sports|Travel,223214.0,AUS,1,3,0,16055,16055,0
Internet|Services|Specialty Foods,52584.0,PER,1,1,0,15279,15279,0
Automotive|Information Technology|Infrastructure|Services|Software,85500000.0,USA,5,18,1822,14418,16240,0
Clean Technology,5100000.0,USA,2,1,356,15996,16352,0
Design|Electronics|Manufacturing|Service Providers|Telecommunications,25000000.0,USA,2,2,67,13637,13704,1
Apps|Mobile|NFC|Payments,77669.0,CAN,1,1,0,15767,15767,0
Nonprofits,150000.0,USA,1,1,0,16062,16062,0
Chat|E-Commerce|Small and Medium Businesses,1500000.0,USA,1,1,0,16555,16555,0
Hardware + Software|Social Network Media|Video|Video Streaming,68200000.0,USA,6,12,2156,11953,14109,1
Clean Technology|Energy Management|Solar,15000000.0,CAN,3,4,421,15830,16251,1
Transportation,1600000.0,USA,2,2,1188,15340,16528,0
Email Marketing|Google Apps|Internet Marketing|Search|SEO|Services|Social Media,1700.0,USA,1,1,0,16096,16096,0
Clean Technology,1250000.0,CHE,1,1,0,14594,14594,0
Biotechnology,20500000.0,USA,2,3,339,15860,16199,0
Web Hosting,19500000.0,USA,3,6,608,12551,13159,1
Health and Wellness,10000.0,USA,1,1,0,15949,15949,0
Enterprise Software|Storage,530856468.0,USA,8,32,1775,14518,16293,1
Mobile,17000000.0,USA,3,10,1653,14217,15870,1
Advertising|Email Marketing|SMS,15910140.0,GBR,1,1,0,15896,15896,0
Biotechnology,750000.0,USA,1,1,0,14963,14963,0
Automotive,10000000.0,USA,2,4,344,15713,16057,1
Enterprise Software|Knowledge Management|Machine Learning|Semantic Search|Text Analytics,15000000.0,USA,2,2,677,15960,16637,0
Internet of Things|IT and Cybersecurity|Lighting|Location Based Services|Telecommunications|Wireless,4595242.0,GBR,3,3,1113,15340,16453,0
Biotechnology,3600000.0,GBR,2,5,371,12382,12753,0
Gambling|Games,15401200.0,USA,3,3,1293,13572,14865,0
Printing,16600216.0,USA,2,1,75,16366,16441,0
Cosmetics,463779.0,SGP,1,1,0,15918,15918,0
Clean Technology,10281191.0,USA,3,1,1134,13458,14592,0
Internet|IT and Cybersecurity|SaaS,3100000.0,ISR,1,3,0,12305,12305,1
Finance|Technology,105000000.0,USA,2,1,81,16363,16444,0
Curated Web,8450000.0,USA,3,3,984,12784,13768,0
Digital Media|Fashion|Lifestyle|Women,2500000.0,USA,1,10,0,16560,16560,0
Hardware|Monetization|Networking|Network Security,6500000.0,USA,2,3,325,16111,16436,0
Clean Technology,65700000.0,USA,11,15,2897,12899,15796,0
Biotechnology,4830067.47772653,GBR,2,5,510,16219,16729,0
Health and Wellness,10000000.0,CAN,1,2,0,13573,13573,0
Technology,28000.0,USA,1,1,0,15584,15584,0
Curated Web,137250.0,GBR,1,1,0,16069,16069,0
Mobile,12670000.0,CHE,1,3,0,13780,13780,1
Career Management|Education|Professional Services,300000.0,IND,2,2,282,16252,16534,0
Mobile|Wireless,5000000.0,GBR,1,6,0,16447,16447,0
Business Services|Marketing Automation|Marketplaces,13364740.0,GBR,1,4,0,16300,16300,0
Crowdsourcing|Design|Language Learning|Marketplaces|Online Shopping,1051271.0,JPN,3,3,971,15496,16467,0
CRM|Data Visualization|Enterprise Software|Gps|Logistics|NFC|Real Time|Software,269009.0,CHL,3,4,610,15826,16436,0
Android|Geospatial|iPhone|Location Based Services|Mobile,1500000.0,USA,2,5,242,15225,15467,0
Apps|Career Planning|EdTech|Education|SaaS|Self Development,175000.0,USA,4,3,302,15706,16008,0
Bitcoin|Marketplaces,300000.0,USA,2,10,216,16185,16401,0
Analytics,17100000.0,ISR,3,7,1332,14649,15981,0
Biotechnology,9076957.0,USA,2,1,290,15723,16013,0
Digital Media|Information Services|Information Technology|Social Games|Software,5000000.0,GBR,1,1,0,16294,16294,0
Consumer Behavior|Corporate Wellness|Health and Wellness|Personal Health,161391.0,USA,2,1,957,15434,16391,0
Digital Media|File Sharing|Mobile,1500000.0,USA,2,7,391,16071,16462,0
Apps|Mobile,3390000.0,USA,3,1,920,15541,16461,0
Cloud Computing|Enterprise Software|Real Time,1000000.0,GBR,2,12,373,14761,15134,0
Internet of Things|Location Based Services|Mobile|SaaS,118000.0,USA,1,1,0,16517,16517,0
Curated Web,1700000.0,USA,1,9,0,15964,15964,0
Mobile Payments|Software,35094596.462506704,USA,10,2,966,15747,16713,1
App Marketing|Big Data|Mobile Advertising|Mobile Analytics|Mobile Software Tools,8215242.0,USA,2,3,398,16246,16644,0
Biotechnology,49600064.0,USA,5,3,1694,14550,16244,0
Consumer Goods|Services|Specialty Foods,2350000.0,USA,1,2,0,14061,14061,0
Curated Web|Web Development,1566000.0,IRL,1,3,0,13970,13970,0
Freemium|SaaS|Search|Software|Web CMS,780000.0,GBR,2,2,809,15109,15918,0
Mobile Games,4700000.0,USA,3,2,629,15797,16426,0
Mobile|Social Games,425000.0,USA,4,1,107,16172,16279,0
Commercial Solar|Energy Efficiency|Testing,235000.0,USA,2,2,91,15431,15522,0
Manufacturing,757625.0,GBR,1,2,0,15981,15981,0
Software,3360807.0,CAN,1,1,0,12755,12755,0
Clean Energy|Clean Technology|E-Commerce|Renewable Energies|Solar|Startups,1009000.0,USA,2,1,584,14761,15345,0
Curated Web|Developer APIs|Postal and Courier Services|Printing,208688.0,GBR,1,1,0,16139,16139,0
Software,5100000.0,USA,1,3,0,15916,15916,0
Semiconductors,38000000.0,USA,2,7,255,13070,13325,0
Agriculture|Internet of Things|Sensors,40000.0,GBR,2,2,400,16222,16622,0
Mobile,1700000.0,USA,1,1,0,15823,15823,0
Curated Web|Marketplaces|Neuroscience|Recruiting,2500000.0,USA,1,6,0,15968,15968,0
Software,2000000.0,USA,1,8,0,16715,16715,0
Analytics|Business Intelligence,41500000.0,NLD,2,3,946,15782,16728,0
Hardware + Software,6030000.0,GBR,2,7,1208,14804,16012,0
Energy,1443047.30138681,CAN,4,3,574,16139,16713,0
Clean Technology,10000000.0,ISR,1,3,0,13927,13927,0
Consulting|Databases|Hardware + Software|Networking|Operating Systems|Software,6000000.0,CAN,1,2,0,16133,16133,0
Software,18720000.0,USA,4,12,1394,13325,14719,1
Sales and Marketing|Services|Technology,12383031.0,DEU,1,1,0,12479,12479,1
Biotechnology,9699336.0,GBR,3,10,1920,13194,15114,0
Design|Home Decor|Interior Design,5000.0,CAN,1,1,0,15978,15978,0
Biotechnology,12018047.0,USA,2,7,1624,13924,15548,0
Advertising,1500000.0,USA,1,1,0,13027,13027,1
Software,10669070.0,BEL,2,4,251,13298,13549,1
Enterprise Search|Search,6350000.0,USA,4,7,2284,13695,15979,0
Security,34400000.0,USA,3,14,1141,12373,13514,1
Ad Targeting|Advertising|Advertising Platforms|Digital Media|Media|Video,8000000.0,USA,1,2,0,16161,16161,0
Banking|Finance|FinTech|Software|Technology,20000000.0,USA,1,2,0,15785,15785,1
Business Intelligence|Investment Management|Mobile|Social Media|Stock Exchanges,5000000.0,CAN,1,3,0,16314,16314,0
Software,6000000.0,USA,1,1,0,13719,13719,0
Software,50000.0,CAN,1,1,0,15859,15859,0
Software,5970000.0,USA,1,9,0,16667,16667,0
Employment|Human Resources|Marketplaces|Recruiting,2414850.0,FRA,1,2,0,15152,15152,0
Manufacturing,1123633.0,ESP,1,5,0,16679,16679,0
Software,2500000.0,USA,1,3,0,16464,16464,0
Software,245000.0,RUS,2,2,343,15614,15957,0
EdTech|Education,820000.0,USA,1,1,0,13467,13467,0
Clean Technology|Hardware,23500000.0,USA,3,10,617,15587,16204,0
Analytics|E-Commerce|Enterprise Search|Enterprise Software|Search,2858333.0,USA,3,12,727,15946,16673,0
Semiconductors,17400000.0,USA,4,2,2353,13941,16294,0
Clean Technology|Energy Efficiency|Smart Grid,7970000.0,USA,2,2,273,14889,15162,0
Concerts|Consulting|Entertainment|Price Comparison|Software|Sports|Technology,1125000.0,USA,2,1,433,14106,14539,0
Nanotechnology|Organic|Semiconductors|Video,132999998.0,USA,10,29,3752,12996,16748,0
Education|K-12 Education|Training,941697.0,IND,1,2,0,16153,16153,0
Mobile,2900000.0,USA,2,2,635,15584,16219,0
Finance|FinTech|Mobile Payments,16500000.0,CHN,2,2,386,15706,16092,0
E-Commerce,8000000.0,CHN,1,2,0,16247,16247,0
Curated Web|Technology,575400000.0,CHN,4,12,2796,13149,15945,1
Mobile|Video,16600000.0,USA,5,9,1002,13978,14980,1
Logistics,9000000.0,IND,1,4,0,16769,16769,0
Hospitality|Mobile|Restaurants,1651194.0,DEU,2,4,962,15340,16302,0
Health and Wellness|Health Care Information Technology|Mobile Health|Telephony,3000000.0,IND,2,2,73,16325,16398,1
Enterprise Software,11682806.0,GBR,2,5,946,15649,16595,0
Online Dating|Social Commerce|Social Media,20000000.0,CHN,2,2,462,16071,16533,0
Cloud Computing|Web Hosting,20000000.0,CHN,1,2,0,16071,16071,0
Hardware + Software,8100000.0,CHN,1,1,0,14496,14496,0
Clean Technology,10000000.0,CHN,1,1,0,13990,13990,0
Mobile,10000.0,CHN,1,1,0,15553,15553,0
Clean Technology|Energy|Renewable Energies,1177588.0,FRA,2,4,392,16062,16454,0
Delivery|Postal and Courier Services|Transportation,1000000.0,RUS,1,2,0,15461,15461,0
Health Care|Health Care Information Technology|Health Services Industry|Hospitals,23800264.0,USA,6,7,2025,14727,16752,0
Apps|Mobile|Small and Medium Businesses,66237.0,BGR,2,2,153,16191,16344,0
Analytics,1720000.0,USA,2,4,222,15779,16001,1
Analytics|Business Intelligence|Software|Web Development,12500000.0,USA,1,2,0,12758,12758,1
Apps|Education|Entertainment|Language Learning,450000.0,TWN,1,5,0,16400,16400,0
Curated Web|Personalization|SaaS,3000000.0,USA,2,10,510,15782,16292,0
Music,600000.0,USA,2,9,554,13269,13823,1
Analytics|Bioinformatics|Software,650000.0,USA,1,1,0,15553,15553,0
Data Centers|Data Integration|Software,26360000.0,USA,2,11,1095,12638,13733,0
Enterprise Software|Manufacturing,2002378.0,USA,3,1,1434,15328,16762,0
EdTech|Education,900135.0,BRA,1,1,0,16216,16216,0
Communications Hardware,100000000.0,BRA,1,1,0,16518,16518,0
CRM|Media|Mobile|Publishing|QR Codes|Sales and Marketing|Web CMS,300000.0,AUS,2,4,397,13634,14031,0
Advertising|Publishing|Social Media Marketing|User Experience Design,6100000.0,USA,3,9,1646,14978,16624,0
Coupons|CRM|Finance|Mobile|Retail|Reviews and Recommendations,72582.0,GBR,2,2,299,15267,15566,0
Android|Apps|Events|Internet|iPhone|Meeting Software|Mobile|Software,153531.0,SWE,1,2,0,15933,15933,0
Enterprise Software,8600000.0,USA,2,7,1579,15070,16649,0
Advertising,15170000.0,GBR,1,1,0,13861,13861,0
Apps|Health and Wellness|Health Care|Health Care Information Technology|Mobile,65952.0,DEU,1,1,0,16308,16308,0
Mobile,40000.0,CHL,1,1,0,15778,15778,0
Consumer Goods,82000000.0,IDN,1,6,0,16636,16636,0
E-Commerce|Video|Web Tools,1700000.0,ISR,1,3,0,14185,14185,0
Mobile Software Tools|SaaS|Text Analytics|Web CMS,1500000.0,USA,2,3,973,15126,16099,0
Software,43449200.0,FRA,3,7,1829,13396,15225,0
Software,23260000.0,USA,3,10,961,12346,13307,1
Software,12700000.0,USA,3,8,417,12051,12468,1
Health and Wellness|Healthcare Services|Information Technology,16300000.0,USA,2,6,412,15784,16196,0
Semiconductors,25000000.0,USA,1,4,0,13313,13313,0
Software,30000.0,CHN,1,1,0,14975,14975,0
Mobile,891177.0,GBR,1,1,0,14137,14137,0
Software,350000.0,CAN,1,1,0,15826,15826,0
Advertising|App Marketing|Mobile Video|QR Codes|Software,150000.0,USA,2,6,106,15034,15140,0
Biotechnology,7516103.0,USA,6,4,1957,14624,16581,0
Education|Entertainment|Games|Mobile,918015.0,BRA,5,5,546,15706,16252,0
Consumers|Hospitality|Restaurants|Social Commerce,9300000.0,IDN,3,12,785,15953,16738,0
Contact Management|NFC|Software,7207.0,POL,1,1,0,15187,15187,0
Comparison Shopping|Curated Web|Design|E-Commerce|File Sharing|Social Commerce,15000.0,USA,1,1,0,15400,15400,0
Internet of Things,20000.0,GRC,1,1,0,15917,15917,0
Colleges|Life Sciences|Material Science|Universities,22864.0,CAN,1,1,0,16315,16315,0
Loyalty Programs|Product Development Services|QR Codes,1000000.0,RUS,1,1,0,15584,15584,0
Advertising|Location Based Services|Mobile|Psychology|Real Time,5100000.0,GBR,2,5,815,15040,15855,0
Market Research|Mobile,50733.0,MEX,1,1,0,15675,15675,0
Biotechnology,24497760.0,AUS,3,1,3880,12172,16052,0
Security,49000000.0,USA,5,14,1525,12997,14522,0
Health Care,85484760.0,USA,9,4,2088,14545,16633,0
Analytics|Computers|Enterprise Software,7305000.0,USA,3,5,519,15929,16448,0
Software|Web Hosting,6700000.0,NOR,1,3,0,12926,12926,1
Hardware|Mobile,2500000.0,IND,1,2,0,13149,13149,0
Consumer Electronics|Internet of Things|Technology,7000000.0,USA,1,1,0,16414,16414,0
Clean Technology,54000000.0,USA,4,7,2670,13739,16409,0
Analytics|Consumer Behavior|News,50000.0,USA,1,1,0,16470,16470,0
Finance|Outsourcing|Technology,40000.0,CHL,1,1,0,16222,16222,0
Location Based Services|Messaging,20000.0,USA,1,1,0,16269,16269,0
Education,25832058.0,USA,4,17,1295,15359,16654,0
Biotechnology,1000000.0,USA,1,2,0,15664,15664,0
Software,2290000.0,FRA,1,1,0,14862,14862,0
Finance|FinTech,51000000.0,USA,2,5,801,13514,14315,0
Business Intelligence|Clean Energy|Clean Technology|Data Visualization|Energy Efficiency,160000.0,USA,2,1,120,15371,15491,0
Career Management|Content|Education|Mobile|SaaS|Social Media,570500.0,USA,3,11,278,16111,16389,0
Digital Media|Search,154053900.0,FRA,1,1,0,13953,13953,0
Analytics|Big Data|Big Data Analytics|Digital Media|SaaS,4100000.0,USA,2,3,450,16221,16671,0
Internet|Software|Startups,1000000.0,USA,1,1,0,15340,15340,0
Analytics|Facebook Applications|Social Television|Television|Twitter Applications,150000.0,BRA,2,3,651,15614,16265,0
Health and Wellness,100000.0,USA,2,1,80,16042,16122,0
Software,5000000.0,USA,1,4,0,16238,16238,0
Digital Media|Social Games|Virtualization,15700000.0,USA,3,25,321,16324,16645,0
E-Commerce|Security|Training,40000.0,BRA,1,1,0,15440,15440,0
Semiconductors,2573200.0,FRA,2,1,287,16118,16405,0
B2B|E-Commerce|Online Shopping|Sales and Marketing,1500000.0,CYP,1,1,0,15322,15322,0
Health and Wellness,265778.0,GBR,1,1,0,15936,15936,0
Marketplaces|Property Management|Rental Housing,20000.0,USA,1,1,0,16436,16436,0
Cloud Computing|Cloud Infrastructure|Data Center Infrastructure|Data Centers|Services|Web Hosting,25000000.0,USA,1,1,0,14755,14755,1
Health Care,6085000.0,USA,4,1,804,15792,16596,0
Software,1556838.0,KOR,1,3,0,16296,16296,0
Semiconductors,3731807.0,FRA,1,1,0,16406,16406,0
Hardware + Software,47069660.0,USA,8,12,2310,14111,16421,0
Software,220000000.0,USA,2,5,862,15475,16337,0
Market Research|Photography,2600000.0,USA,2,2,1434,13921,15355,0
Analytics|Cloud Data Services|Developer APIs|Finance Technology|FinTech|Internet|Marketplaces|Search,5400000.0,CAN,1,1,0,16387,16387,0
Collaboration|Enterprise 2.0|Enterprise Software|Knowledge Management|Social Business,150000.0,USA,2,2,155,15756,15911,0
Information Services|Information Technology,34499960.0,USA,2,9,216,16206,16422,0
Finance|FinTech|News,150000.0,USA,1,2,0,13514,13514,0
Health Care|Medical|Medical Devices|Technology,60358285.0,GBR,3,11,2116,14549,16665,0
Construction,207900000.0,USA,2,2,69,11976,12045,1
Biotechnology|Health Diagnostics,28712619.0,USA,3,1,779,14398,15177,1
Mobile|Semiconductors,50750012.0,USA,7,15,2951,13406,16357,0
Nanotechnology,1908237.0,GBR,1,1,0,14412,14412,1
Software,4580000.0,USA,2,5,796,14840,15636,0
Advertising,65299999.0,USA,4,9,1706,13573,15279,0
Enterprise Software|Finance|Stock Exchanges|Trading,40000.0,USA,1,1,0,15279,15279,0
Analytics,3000000.0,USA,1,1,0,13493,13493,0
Semiconductors|Wireless,166153980.0,USA,11,37,3122,13299,16421,0
Analytics|Biotechnology|Health Diagnostics,43999999.0,USA,5,8,1543,14116,15659,0
Hedge Funds|Market Research|Trading,1000000.0,USA,1,1,0,16191,16191,0
Communities|Health and Wellness|Medical|Networking|Physicians|Social Media,41049041.0,USA,4,3,1618,14333,15951,0
Big Data Analytics|Business Intelligence|Social Media,26215.0,PER,1,1,0,16314,16314,0
Finance|Finance Technology|FinTech|Investment Management|Wealth Management,41250.0,HKG,1,1,0,16071,16071,0
App Stores|Health Care|Health Care Information Technology|Medical Devices|Mobile|Mobile Devices|Mobile Health,50000.0,USA,3,3,684,16056,16740,0
Analytics|SaaS|Software,12000000.0,USA,2,5,1741,14532,16273,0
Biotechnology,3200000.0,CHN,1,1,0,16720,16720,0
Cloud Computing|Human Resources|Recruiting,500000.0,SGP,1,1,0,15737,15737,0
Analytics|Business Intelligence|Cloud Computing|SaaS,9400000.0,USA,2,2,707,13887,14594,1
Hospitality,182610.0,USA,1,1,0,15889,15889,0
Curated Web,23800000.0,USA,3,8,625,15734,16359,0
Health and Wellness|Wearables,22000000.0,USA,2,3,419,15706,16125,0
Biotechnology|Health and Wellness|Health Care,20500000.0,JPN,1,5,0,16475,16475,0
Enterprise Software,7600000.0,USA,3,4,1533,13609,15142,1
Hardware + Software,2424402.0,GBR,1,1,0,16168,16168,0
Biotechnology,7536731.0,USA,3,1,464,14413,14877,0
Education|Games,2115100.0,USA,3,5,432,14464,14896,0
Biotechnology,1050000.0,USA,1,2,0,15519,15519,0
Enterprise Software,3540000.0,USA,1,1,0,13450,13450,0
Health Care|Medical|Medical Devices,500000.0,USA,1,2,0,15492,15492,0
Security,6800990.0,USA,2,3,128,16110,16238,0
Software,200000.0,USA,1,1,0,13858,13858,0
Biotechnology,22039074.0,GBR,6,1,1248,14975,16223,0
Software,1000000.0,CAN,1,1,0,13074,13074,0
Information Technology|Outsourcing,50500000.0,USA,2,4,785,10876,11661,1
Mobile,15007503.0,CHN,1,1,0,14944,14944,0
Biotechnology|Medical,37000000.0,USA,2,2,697,14064,14761,0
Security,10411307.0,USA,7,6,1908,14637,16545,0
Communications Hardware,18000000.0,USA,1,6,0,12478,12478,0
Curated Web|E-Commerce|Gift Card,4200000.0,USA,3,8,429,15885,16314,0
Finance|FinTech,2750000.0,USA,2,1,314,15882,16196,0
Digital Media|Health Care Information Technology|Predictive Analytics,7000000.0,USA,1,12,0,16496,16496,0
Biotechnology,23000000.0,GBR,2,3,349,16366,16715,0
Hardware + Software,35638334.0,USA,5,2,1478,13444,14922,0
Apps|Fleet Management|Tracking,23865186.0,GBR,1,1,0,13909,13909,0
Enterprise Software|Life Sciences,5200000.0,USA,2,16,495,15393,15888,0
Consulting,5400000.0,ARG,1,1,0,16274,16274,0
Biotechnology,58025045.0,USA,2,4,703,13655,14358,0
Advertising,28300000.0,USA,3,5,686,13634,14320,1
E-Commerce|Eyewear|Fashion|Retail,250000.0,ITA,1,2,0,16441,16441,0
Software,1800000.0,USA,1,2,0,16091,16091,1
Advertising|Analytics|Big Data|Data Mining|E-Commerce|Internet|Publishing|Sales and Marketing,34850000.0,GBR,3,6,1459,14883,16342,0
Software,676246.0,ESP,1,2,0,16269,16269,0
E-Commerce|Search|Video,152842.0,FIN,1,1,0,16358,16358,0
Software,1631433.22515535,GBR,4,4,1003,15553,16556,0
Curated Web|Location Based Services|Mobile|Online Dating,130000.0,CAN,1,1,0,14590,14590,0
Semiconductors,39231994.0,USA,18,27,2978,11449,14427,1
Consulting,718450.0,FRA,1,1,0,14627,14627,0
Clean Technology,107500000.0,USA,4,13,1992,14092,16084,0
Enterprise Software,1500000.0,USA,1,1,0,14488,14488,0
Enterprise Software|Identity Management|Internet of Things|Mobile|RFID|Security|Tracking,650000.0,USA,2,2,340,15309,15649,0
EdTech|Education,2455000.0,USA,4,5,888,15737,16625,0
Public Transportation|Services|Transportation,101851.801554666,BRA,1,2,0,16375,16375,0
Social Network Media,270862.0,ESP,1,1,0,16233,16233,0
Web Hosting,2990000.0,FRA,1,6,0,14767,14767,0
Android|Curated Web|iPhone|Mobile|SMS,1000000.0,USA,2,2,15,16096,16111,0
Legal,3750000.0,USA,1,1,0,14635,14635,0
Consulting|Manufacturing|Software,81000000.0,SGP,2,2,2620,12325,14945,0
Clean Technology,4200000.0,USA,1,1,0,16042,16042,0
Consulting,4600000.0,USA,1,2,0,14461,14461,0
Education,90000000.0,USA,1,4,0,11192,11192,1
Employer Benefits Programs|Finance Technology|Investment Management|Personal Finance,2000000.0,USA,1,1,0,16675,16675,0
M2M|Software,12500000.0,USA,1,2,0,13375,13375,1
Mobile Advertising|Mobile Analytics|Personalization,2900000.0,USA,1,11,0,16290,16290,0
Payments,225000000.0,CHN,4,3,372,16161,16533,0
Creative Industries|News|Professional Networking,800000.0,USA,1,6,0,16225,16225,0
Finance|FinTech,10000000.0,CAN,1,4,0,13158,13158,0
Software,13000000.0,IND,1,1,0,14839,14839,0
Sports,18950000.0,USA,5,5,1084,13993,15077,0
EdTech|Education,450000.0,USA,2,1,84,16217,16301,0
Software|Training|Web Design|Web Development,500000.0,USA,1,1,0,16414,16414,0
Information Technology|Services,5300000.0,USA,2,4,742,12802,13544,0
Digital Media|Enterprise Software|SaaS|Video,3999898.0,GBR,3,6,396,13818,14214,0
Android|Application Platforms|Chat|Cloud Computing|Cloud Infrastructure|Communications Infrastructure|Enterprise Software|Facebook Applications|iOS|Location Based Services|Mobile|Networking|SaaS|Services|Unifed Communications|Video Chat|Video Streaming|VoIP,1220000.0,GBR,2,2,1246,14245,15491,0
Bitcoin|Mobile Payments,50000.0,USA,1,1,0,16556,16556,0
Software,4100000.0,USA,1,1,0,13488,13488,0
Software,1800000.0,USA,1,2,0,15645,15645,1
Games,12375000.0,AUS,3,1,1198,15377,16575,1
E-Commerce,3970817.0,USA,4,1,1596,14860,16456,0
Health Diagnostics|Medical|Services,2700000.0,USA,1,3,0,12041,12041,0
Mobile,8800000.0,CAN,3,2,628,15204,15832,0
Internet Marketing|SaaS|Search Marketing|SEO|Software,1240000.0,IND,4,6,1643,14892,16535,0
App Stores|iPhone|Mobile,30250000.0,USA,5,15,1374,12928,14302,1
Apps|Mobile|Payments,9000000.0,USA,3,10,668,15386,16054,0
Enterprise Software,184235885.0,CAN,5,14,3118,13402,16520,0
Enterprise Software,5200000.0,USA,1,3,0,12982,12982,0
Home Decor,20000.0,USA,1,1,0,16468,16468,0
Big Data Analytics|SaaS|Software,66500000.0,USA,3,23,1333,15180,16513,0
E-Commerce,78500000.0,USA,6,17,1327,13392,14719,1
Clean Technology,10234700.0,GBR,1,1,0,14123,14123,1
Health Care,1300000.0,USA,5,3,543,15709,16252,0
Transportation,607000.0,IND,2,1,0,16716,16716,0
Advertising|Media,35000000.0,USA,5,10,1193,12478,13671,1
Software,1280000.0,USA,2,2,578,15084,15662,1
Software,8900000.0,USA,1,1,0,13573,13573,0
Curated Web|E-Commerce|Retail|Sales and Marketing|Social Media,2043396.0,USA,4,10,682,15446,16128,0
Apps,1000000.0,GBR,1,1,0,16422,16422,0
Curated Web,346000000.0,IND,6,26,1833,14699,16532,0
Mobile|Networking|Photo Sharing,505000.0,USA,1,8,0,15340,15340,0
Content|News,9076257.0,GBR,2,11,287,15852,16139,0
Education|Human Computer Interaction|Language Learning|Text Analytics,218000.0,USA,2,2,261,16206,16467,0
Biotechnology,31300000.0,USA,3,5,1400,13480,14880,0
Advertising|Business Services,4000.0,USA,2,1,2286,11301,13587,1
Social Media,100000.0,USA,1,1,0,14785,14785,0
Hardware|Hardware + Software,12300000.0,USA,3,3,1480,13392,14872,0
Advertising|Search|Visual Search,6000000.0,RUS,4,5,1282,13466,14748,0
Advertising|Analytics|Digital Media|Media|Mobile|Mobile Analytics|Predictive Analytics|Publishing,3250000.0,USA,1,1,0,16701,16701,0
Business Services|Cloud Data Services,14000000.0,SWE,1,1,0,16297,16297,0
Collaboration|Mobile Commerce|Mobile Devices,45000000.0,USA,2,7,807,15916,16723,0
Beauty|Fitness|Health Care,300000.0,USA,2,5,0,16467,16467,0
Android|Apps|EdTech|Education|Facebook Applications|iPhone|Mobile,10061414.0,GBR,3,5,887,15248,16135,1
Financial Services|Gift Card,2000000.0,USA,1,2,0,16100,16100,0
Clean Technology,113300000.0,IND,1,1,0,14103,14103,0
Crowdsourcing|E-Commerce,185325006.0,USA,8,20,3078,13335,16413,0
Computers|Technology,395680.0,VEN,1,1,0,16467,16467,0
Education,51500000.0,USA,2,8,375,11076,11451,0
Finance|FinTech|Software,6250000.0,USA,4,2,1246,15069,16315,0
Internet of Things|Personal Health|Quantified Self,175000.0,USA,4,4,530,16010,16540,0
Flash Sales|Travel,130748.0,ITA,1,1,0,15861,15861,0
Human Resources|Recruiting,644016.0,CHE,1,2,0,15645,15645,0
Cloud Management|Cloud Security|File Sharing,20323.0,NLD,1,1,0,15991,15991,0
E-Commerce|Enterprise Software|Software,150000.0,USA,3,4,546,15279,15825,0
Technology,134900000.0,USA,6,23,1429,15071,16500,0
Apps|Entertainment|Television,405350.0,GBR,1,1,0,16344,16344,0
Games,32842.0,BGR,1,1,0,15826,15826,0
All Students|Education|Mobile,12000000.0,USA,1,4,0,16762,16762,0
Software,10000000.0,USA,1,2,0,12926,12926,1
Software|Video|Video Streaming,24750000.0,USA,3,17,1583,13290,14873,1
Big Data|Enterprise Software|Storage,66800000.0,USA,3,10,1070,15400,16470,0
Nanotechnology,6538000.0,SWE,2,5,220,13067,13287,0
Business Services|Travel,890000000.0,CHN,8,15,3226,13361,16587,1
Big Data|Finance|FinTech|Software,1140000.0,FRA,3,1,390,15371,15761,0
Cloud Computing|Legal|SaaS|Software,149112.0,ARG,3,3,397,15340,15737,0
Curated Web|Semantic Search,141000000.0,USA,3,15,1473,14696,16169,0
Business Services|Enterprise Software|Homeland Security|Network Security|Storage|Virtualization,42906442.0,USA,8,5,1788,14565,16353,0
Semiconductors,30000000.0,USA,2,7,519,12927,13446,1
Software,260000.0,FIN,1,2,0,13522,13522,0
B2B|Crowdsourcing|Enterprise Software|Internet|Lead Generation|Marketplaces|SaaS|Sales Automation|Software,400000.0,USA,1,2,0,16332,16332,0
Business Development|Business Services|CRM|Digital Signage|Estimation and Quoting|Optimization|SaaS|Sales and Marketing|Software,650000.0,USA,1,6,0,15848,15848,0
Curated Web|Estimation and Quoting|Location Based Services|Web Tools,9202.57852641456,IRL,1,2,0,15742,15742,0
Biotechnology|Health Diagnostics,16200027.0,USA,3,3,1007,15405,16412,1
Bio-Pharm|Biotechnology|Pharmaceuticals,62661128.6164423,GBR,1,1,0,14125,14125,1
Advertising|Analytics|Digital Rights Management|Sales and Marketing,21000000.0,NLD,1,6,0,11394,11394,1
Curated Web,15000000.0,BMU,1,1,0,13704,13704,0
Analytics|Financial Services|FinTech|Investment Management,5200000.0,USA,2,8,573,16051,16624,0
Android|Apps|Information Technology|iPhone|Mobile|Services|Software|Windows Phone 7,1085084.0,ITA,3,6,876,15522,16398,0
Analytics|Business Services|Crowdsourcing|Location Based Services|Mobile|Point of Sale|Retail Technology|Software,31758235.0,USA,4,9,2438,14284,16722,0
Training,400000.0,USA,1,5,0,16702,16702,0
Advertising|App Marketing|Big Data|Mobile,597375.0,GBR,1,5,0,14365,14365,0
SaaS|Security|Software,2500000.0,ESP,2,3,477,15598,16075,0
Hardware + Software,5500000.0,USA,1,1,0,12998,12998,0
E-Commerce,10000000.0,CHN,2,4,304,14549,14853,0
Health and Wellness|Health Care|Mobile,48500000.0,CHN,2,3,375,16314,16689,0
Sales Automation|Software,31170000.0,USA,2,6,520,14244,14764,0
Consumers|Digital Media|Digital Rights Management|Enterprise Software|Entertainment|Music|Television,1000000.0,HKG,1,1,0,15608,15608,0
Finance Technology|Internet of Things|Mobile Payments,1755027.0,USA,1,2,0,16751,16751,0
Analytics|Business Analytics|Business Intelligence,25000.0,USA,2,2,64,16083,16147,0
Enterprise Software,7000000.0,USA,1,2,0,13845,13845,0
Advertising|Facebook Applications|SaaS|Social Media|Social Media Marketing,3006074.0,SWE,1,2,0,15847,15847,0
Cloud Computing|EdTech|Education|Productivity Software,25000.0,USA,1,1,0,16191,16191,0
Computers|Software,10000000.0,IND,1,3,0,16428,16428,0
Photography,10500000.0,USA,3,21,264,14800,15064,1
Software,495000.0,AUS,2,3,288,16288,16576,0
Software,67100000.0,USA,4,10,1745,14865,16610,0
Location Based Services|Mobile|Mobile Commerce|Social Media,2454859.0,USA,6,17,1066,15041,16107,0
Enterprise Resource Planning,13071895.0,CHN,1,1,0,13665,13665,0
Travel,10000000.0,CHN,1,1,0,15857,15857,0
Apps,1000000.0,IND,2,7,165,16507,16672,0
Curated Web,23084124.0,DEU,4,6,1818,13118,14936,1
Collaboration|Creative|Curated Web|Music,15400000.0,IND,2,1,1067,15384,16451,0
Advertising|Brand Marketing|Lead Generation|Predictive Analytics|Social Media Marketing|Surveys,2000000.0,USA,1,4,0,16337,16337,0
Mobile|Social Media,37000.0,USA,3,1,945,15034,15979,0
Finance,2580000.0,DEU,1,2,0,13381,13381,0
E-Commerce|Internet,400000.0,CAN,1,4,0,15901,15901,0
Semiconductors,35158297.0,USA,5,8,2301,14365,16666,0
Legal,5220000.0,CHN,2,3,456,13027,13483,0
Consumers|E-Commerce|Manufacturing|Retail|Supply Chain Management,25000000.0,USA,1,1,0,16418,16418,0
Biotechnology,77433082.0,USA,3,9,1974,14665,16639,0
Apps|Software|Video Chat,3300000.0,USA,1,4,0,15764,15764,0
Music Venues,775000.0,USA,1,1,0,16162,16162,0
Hardware + Software|SaaS|Wearables,4886.0,IND,1,1,0,16375,16375,0
E-Commerce,115000.0,BRA,2,8,304,15461,15765,0
Big Data|Mobile|Personalization|Video,665000.0,USA,3,3,775,15826,16601,0
Automotive|Services|Technology,605092.0,BGR,4,3,244,16161,16405,0
Augmented Reality|Exercise|Fitness|Health and Wellness|Recycling|Sports,332500.0,USA,2,5,100,15879,15979,0
Software,28300000.0,USA,5,6,3164,13088,16252,0
Auto|Automotive|Cars|Racing|Sponsorship|Sports|Ticketing,100000.0,GBR,1,1,0,15377,15377,0
Clean Technology|Consumer Electronics|Home Automation|Water,10500000.0,USA,6,22,735,16029,16764,0
Web Hosting,21000000.0,USA,1,1,0,12090,12090,1
Brand Marketing|Internet|Promotional|Software,40000.0,CHL,1,1,0,16222,16222,0
Cloud Computing|IaaS|Software|Web Hosting,11500000.0,USA,1,3,0,11017,11017,1
Software,12951250.0,BEL,3,6,1276,14517,15793,0
Auctions|Discounts|E-Commerce|Gift Card|Mobile,3500000.0,USA,2,1,609,13879,14488,0
Enterprise Software,7039680.0,USA,3,4,789,15883,16672,0
Game,2774376.0,KOR,2,3,339,16062,16401,0
3D|Consumer Electronics|Hardware + Software|Human Computer Interaction|Sensors,180000.0,USA,1,1,0,16086,16086,0
E-Commerce|Fashion,14012022.0,FRA,2,3,651,15876,16527,0
Manufacturing,4500000.0,USA,1,2,0,12982,12982,0
Advertising|Semantic Web|SEO,24000000.0,USA,4,11,1310,13239,14549,1
Consulting,40000.0,CHL,1,1,0,15777,15777,0
Software,2000000.0,USA,1,2,0,14356,14356,0
Software|Telecommunications|VoIP,8000019.0,ISR,2,1,996,13984,14980,1
Internet Service Providers|Security|Software|Tech Field Support,98000000.0,CAN,1,1,0,14145,14145,0
CRM|Curated Web|Social Media Marketing|Social Media Monitoring,9000000.0,CAN,2,4,552,13662,14214,1
Real Time|Tracking,11000000.0,USA,2,8,149,12606,12755,0
Web Hosting,4140000.0,CAN,1,2,0,14715,14715,1
Creative|Design|Development Platforms|Entertainment|Games,4500000.0,USA,1,3,0,16611,16611,0
Clinical Trials|Medical|Pharmaceuticals,11000000.0,USA,1,4,0,12677,12677,0
Information Technology|Location Based Services|Social Network Media,1550000.0,USA,1,2,0,13117,13117,0
News,30774557.0,USA,3,3,1549,14389,15938,0
Health Care,3450000.0,USA,1,1,0,15615,15615,0
Clean Technology,220000.0,USA,1,2,0,15461,15461,0
Advertising,5300000.0,USA,1,1,0,14031,14031,0
Search,1000000.0,USA,1,2,0,13514,13514,0
Local Businesses|Security,5596492.44325226,GBR,3,2,755,15857,16612,0
Messaging|Software,1000000.0,USA,1,1,0,15340,15340,0
Mobile,11384091.0,FRA,3,8,3059,11323,14382,0
Hardware + Software,99000.0,USA,1,1,0,13937,13937,0
Mobile|Wireless,95369999.0,USA,5,23,2625,11495,14120,0
Broadcasting|Curated Web|Digital Media|Internet Radio Market|Music|Social Media,577000.0,GRC,2,1,642,15095,15737,0
Internet Radio Market|Music,6000000.0,BEL,3,4,1461,13879,15340,0
Software,22274927.0,GBR,1,2,0,11666,11666,0
Retail,120000000.0,USA,2,3,349,15999,16348,1
Hardware + Software,9000000.0,USA,1,3,0,13308,13308,0
Entertainment,1000000.0,USA,1,1,0,16567,16567,0
Diagnostics|Health Care|Health Diagnostics|Medical,1593460.0,IRL,1,2,0,15135,15135,0
Advertising|Software,87500000.0,USA,3,12,2128,14488,16616,0
Biotechnology,212900000.0,USA,6,34,2215,13605,15820,1
Analytics|Business Intelligence|Marketing Automation|Predictive Analytics|Sales and Marketing,128850000.0,USA,6,34,2139,14506,16645,0
Hardware + Software,10435000.0,USA,4,5,1054,15633,16687,0
Hardware + Software,7650000.0,ISR,1,2,0,13663,13663,0
Analytics|Big Data|Health and Wellness|Health Care Information Technology|Image Recognition|SaaS,2850000.0,USA,2,6,1322,14975,16297,0
Manufacturing|Product Search|Services,120000000.0,USA,1,1,0,13119,13119,0
Apps|iPhone|Mobile|Real Estate,12800000.0,USA,5,26,692,15855,16547,0
Enterprise Software,1760000.0,GBR,1,1,0,13020,13020,1
Digital Media|EdTech|Education|Media|Technology|Textbooks,86000000.0,USA,7,17,1978,14549,16527,0
Concerts|Curated Web|Events|Music|Social Commerce|Ticketing,20000.0,USA,1,1,0,15764,15764,0
Enterprise Software,15000000.0,USA,1,1,0,16006,16006,0
Apps|Mobile|Search,18852.0,USA,1,1,0,15586,15586,0
Design|Enterprises|Storage,5000000.0,USA,1,2,0,12363,12363,0
Technology,16000000.0,USA,1,5,0,11346,11346,0
Health Care,1647446.0,CHN,2,3,401,16102,16503,0
Robotics,2600000.0,USA,2,1,229,16008,16237,0
Apps,486000.0,IND,2,5,222,16394,16616,0
Advertising|App Marketing|Mobile,100000.0,USA,1,1,0,16283,16283,0
Software,2135922.0,GBR,3,2,417,16246,16663,0
Biotechnology,19500000.0,IND,1,2,0,15930,15930,0
E-Commerce,100000.0,IND,1,1,0,16657,16657,1
Biotechnology,138660528.0,USA,6,12,2512,13620,16132,0
Software,15000000.0,USA,1,2,0,10927,10927,1
Curated Web|Developer Tools|Testing|Web Development,4170000.0,USA,2,7,436,16040,16476,0
Information Services|Information Technology|SaaS,67500000.0,USA,2,1,2265,14456,16721,0
Analytics|Big Data|Databases|Software,26284825.0,USA,5,10,1333,14285,15618,1
Education|Finance|K-12 Education|Marketplaces,4500000.0,USA,2,8,905,15642,16547,0
Curated Web|E-Commerce|Gift Card,87200000.0,USA,5,14,1178,15279,16457,0
Charities|Charity|Non Profit|Nonprofits|Software,2650000.0,GBR,1,1,0,16218,16218,0
Web Hosting,3250000.0,USA,1,2,0,13353,13353,0
E-Commerce|Printing,51600000.0,JPN,5,16,1265,15218,16483,0
Curated Web|E-Commerce|Travel,42400000.0,JPN,2,2,1457,13256,14713,1
Advertising,1500000.0,USA,1,2,0,13330,13330,1
E-Commerce,2500000.0,IDN,2,4,388,16206,16594,0
Crowdfunding|Internet|Music|Music Venues|Sports|Sports Stadiums|Transportation,1350000.0,USA,2,3,63,16398,16461,0
Beauty|Fitness|Health and Wellness|Lifestyle|Social Media,20000.0,USA,1,1,0,16270,16270,0
Enterprises|Entrepreneur|Internet|Nonprofits|Payments|Politics|Startups|Technology|Transaction Processing,10500000.0,USA,3,27,1089,14956,16045,0
Enterprise Software|Health and Wellness|Software,68850000.0,USA,5,13,1819,13313,15132,1
Social Media,3500000.0,USA,3,4,610,15284,15894,0
Enterprise Software|Health and Wellness|Human Resources|Neuroscience,1500000.0,USA,2,4,1049,15142,16191,0
DOD/Military|Professional Networking|Social Media,6950000.0,USA,4,3,572,15431,16003,0
Crowdsourcing|Enterprise Software|Human Resource Automation|Human Resources|Social Media,20000.0,USA,4,4,583,16092,16675,0
Enterprise Software|Gamification|Project Management|SaaS|Social Media,1363000.0,USA,3,4,653,15675,16328,0
B2B|Collaboration|Communities|Productivity Software|Project Management|SaaS,353420.0,USA,2,5,256,16135,16391,0
Software,24250000.0,GBR,1,1,0,14543,14543,1
Travel,23500000.0,ISR,1,1,0,16397,16397,0
Analytics|Search|SEO|Video,36750000.0,USA,4,15,1934,13676,15610,0
Intellectual Asset Management|Technology|Tracking,457835.0,AUS,1,1,0,16511,16511,0
Apps|Exercise|Mobile,15000000.0,CHN,1,2,0,16632,16632,0
Biotechnology,87172231.0,USA,3,3,1338,15308,16646,0
Technology|Telecommunications|Wireless,628000.0,RUS,1,1,0,15672,15672,0
Web Hosting,1000000.0,USA,1,1,0,13388,13388,0
Startups,10000000.0,USA,1,2,0,16595,16595,0
Advertising,20000000.0,CHN,1,2,0,13879,13879,0
Clean Technology,186190000.0,USA,2,10,51,13939,13990,0
Analytics|E-Commerce|Supply Chain Management,5000000.0,GBR,1,1,0,15681,15681,1
Biotechnology,15486363.0,USA,2,11,636,15945,16581,0
Browser Extensions|Personalization|Search,750000.0,USA,3,8,732,13725,14457,0
Fashion,525000.0,USA,2,2,589,15993,16582,0
Curated Web|Interest Graph|Reviews and Recommendations|Semantic Web,5100000.0,USA,4,19,1852,14031,15883,0
Finance,12000000.0,POL,1,1,0,14903,14903,0
Analytics|Apps|Collaboration|Crowdsourcing|Opinions|Polling|SaaS|Surveys,187500.0,USA,3,1,122,16465,16587,0
EdTech|Education,650000.0,USA,2,5,52,16019,16071,0
Software,38979.0,USA,1,1,0,15685,15685,0
Databases|Genetic Testing|Health Care,50000.0,USA,1,2,0,16490,16490,0
Data Centers,35000000.0,CAN,2,9,378,15973,16351,0
E-Commerce|Lifestyle|Mobile|News|Publishing|Sports|Technology,7343000.0,USA,4,11,1092,15149,16241,0
Mobile,34995.0,USA,1,1,0,14393,14393,0
Health Care,3926094.0,USA,4,3,913,15675,16588,0
Games|Media|Outsourcing|Search|Social Media|Startups,40000.0,DEU,1,1,0,15309,15309,0
Manufacturing,7920000.0,GBR,1,1,0,13992,13992,0
Biotechnology,12803748.0,USA,4,2,1866,14638,16504,0
Biotechnology,97401413.0,USA,7,21,2092,14462,16554,0
Mobile,4183800.0,GBR,2,5,826,13118,13944,0
Biotechnology,56040950.0,USA,4,1,1707,14649,16356,0
Cloud Management|Point of Sale|Systems,350000.0,USA,1,1,0,16141,16141,0
Language Learning|Training,40000.0,CHL,1,1,0,16222,16222,0
Software,89000000.0,USA,4,6,2282,14139,16421,1
Education|Software,206517.0,NLD,2,3,157,16071,16228,0
Software,10866000.0,CAN,2,4,406,13221,13627,1
Analytics|Big Data|Big Data Analytics|Machine Learning|Predictive Analytics|Text Analytics,20000000.0,USA,2,6,471,16013,16484,0
Health Care|Medical|Pharmaceuticals,2350000.0,USA,1,1,0,14859,14859,0
Mobile|Mobile Emergency&Health|Public Safety|Technology,5000000.0,USA,1,1,0,16659,16659,0
Mobile,4184999.0,USA,1,1,0,16204,16204,0
Messaging,16000000.0,USA,4,13,1923,13300,15223,1
Hardware + Software,25500000.0,USA,2,2,824,12985,13809,0
Email|Messaging,1000000.0,USA,1,17,0,14823,14823,1
Software,14620000.0,USA,3,6,2840,13172,16012,1
Advertising|Enterprise Software|Finance|FinTech|Mobile Video|Video,8748376.0,USA,4,14,1101,15187,16288,0
Biotechnology,87386000.0,USA,4,5,1751,14501,16252,1
Games,44000000.0,USA,4,8,2860,13665,16525,0
Design|E-Commerce|Fashion|Gold|Jewelry,720214.251950002,GBR,4,2,1657,15065,16722,0
Internet|Language Learning|Services,3484811.0,JPN,2,6,1883,13976,15859,1
Education|Software,25000.0,USA,1,1,0,15664,15664,0
Clean Technology,30000000.0,USA,1,1,0,14586,14586,0
Mobile Payments|Payments|Security,31000.0,USA,1,1,0,16495,16495,0
Finance|Financial Services|Real Estate,1115000.0,USA,3,1,501,14548,15049,0
Social Media,1320000.0,EST,1,1,0,13509,13509,0
Information Technology,50000000.0,IND,2,1,1,16449,16450,0
Mobile,9000000.0,USA,1,4,0,11746,11746,0
Curated Web|Reviews and Recommendations,1400000.0,USA,1,9,0,14055,14055,0
Customer Service|Email Marketing|Reputation|Reviews and Recommendations|Small and Medium Businesses|Software|Surveys|Web Hosting,24500000.0,USA,4,10,1299,13542,14841,0
Curated Web|Opinions|Reviews and Recommendations|Software|Web Tools,100000.0,USA,1,1,0,13889,13889,0
Biotechnology,343000.0,USA,1,1,0,14799,14799,0
Automotive|Logistics|Robotics,145000.0,CAN,4,4,570,16021,16591,0
Mobile|SaaS|Wireless,46000000.0,USA,5,15,1953,13020,14973,0
Analytics|Legal|Search,9200000.0,USA,2,8,582,15522,16104,0
Fraud Detection,1973629.0,GBR,2,2,201,16506,16707,0
Cloud Computing|Cloud Management|Enterprise Software|IaaS|Software,54000000.0,USA,3,12,1237,15218,16455,0
Biotechnology,88300000.0,USA,2,21,1013,12055,13068,1
Software,20700000.0,USA,3,9,1223,13124,14347,0
E-Commerce|Education|K-12 Education,850000.0,USA,1,1,0,16071,16071,0
Software,120000.0,USA,1,2,0,16267,16267,0
Games,40000.0,SLV,1,1,0,15940,15940,0
Food Processing,512000.0,USA,1,4,0,16657,16657,0
Manufacturing,67576091.0,USA,8,9,2743,13466,16209,0
Education|Tutoring,400000.0,CAN,2,1,620,15034,15654,0
Medical Devices,10000000.0,USA,1,5,0,12349,12349,0
Music|Personalization|Social Television|Television,2320000.0,CHE,2,3,657,15308,15965,0
Brand Marketing|Content|Lead Generation|Marketplaces|Sports|Weddings,325000.0,USA,2,6,333,15750,16083,0
Automotive,37000000.0,USA,2,5,356,12593,12949,1
Mobile,12500000.0,USA,1,2,0,14452,14452,0
Games|Peer-to-Peer|Television,16030566.0,USA,4,4,3054,13514,16568,1
Industrial|Technology|Water Purification,9300000.0,USA,1,6,0,16504,16504,0
Networking,3500000.0,USA,1,1,0,16386,16386,0
Health Care|Health Care Information Technology,24000000.0,USA,1,6,0,16357,16357,0
Games,50000000.0,USA,2,3,1030,15328,16358,0
Enterprise Software|Risk Management|Supply Chain Management,40000.0,USA,1,1,0,15673,15673,0
Education|Teachers,570000.0,RUS,1,2,0,15706,15706,0
Sports|Ticketing,58800000.0,USA,6,11,3592,12843,16435,0
FinTech|Payments,11600000.0,IND,2,22,218,16517,16735,0
Automotive|Freelancers|Software,38890000.0,USA,6,4,3028,13160,16188,1
Music,10000000.0,USA,3,7,820,12809,13629,0
Design|Manufacturing|Public Safety|Security,11000000.0,ISR,1,1,0,15384,15384,0
SaaS|Software,16499986.0,USA,3,3,420,16162,16582,0
Design|Services|Transportation,9500000.0,USA,1,4,0,12529,12529,0
Manufacturing,2160000.0,USA,2,4,2065,13293,15358,0
Advertising|Content Syndication|Film|Software|Television|Web Development,10000000.0,USA,1,2,0,14610,14610,0
Education|Employment|Marketplaces|Startups,281426.0,CAN,1,2,0,16252,16252,0
Manufacturing,15000000.0,CHN,2,3,1186,12509,13695,1
Music,125700000.0,USA,6,6,1630,14531,16161,0
Civil Engineers,1000000.0,ISR,1,1,0,16771,16771,0
Hardware,40000.0,USA,1,1,0,15775,15775,0
Apps,20000.0,USA,1,1,0,16287,16287,0
Developer APIs|Internet|Mobile|Music|Software,1500000.0,AUT,2,1,833,14154,14987,0
B2B|Cloud Security|Cyber Security,850000.0,ISR,1,3,0,15900,15900,0
Defense,2250000.0,USA,2,3,201,16099,16300,0
Mass Customization|Mobile|SaaS|Software,910000.0,USA,2,2,1096,14643,15739,0
Internet|Investment Management,1000000.0,USA,1,1,0,12753,12753,0
Mobile,2580000.0,GBR,1,1,0,13744,13744,0
Clean Technology,4500000.0,SWE,1,2,0,14918,14918,0
Health Care,40000.0,CHL,1,1,0,15335,15335,0
Biotechnology|Health Care,20040271.0,USA,6,9,1808,14879,16687,0
Big Data Analytics|Coupons|Digital Media|Email Marketing|Loyalty Programs|Marketing Automation|Point of Sale|Predictive Analytics|Technology,5000000.0,USA,1,2,0,16442,16442,0
Apps|Consumer Electronics|Game|Software,250000.0,GBR,1,3,0,16591,16591,0
Natural Language Processing|Social Media Management|Social Media Marketing|Translation,787030.0,GBR,2,4,68,16190,16258,0
CRM|Social Business|Social CRM|Software,17550668.0,USA,5,6,2242,13514,15756,0
Advertising|Advertising Platforms|Email|Email Newsletters,50000.0,USA,1,1,0,16314,16314,0
Enterprise Software|SaaS,15799990.0,USA,5,6,1330,13675,15005,0
Advertising|Internet Marketing|Sales and Marketing|Semantic Search|SEO|Social Media|Web Presence Management,127335670.0,USA,8,7,4083,12478,16561,1
Software,40000.0,USA,1,1,0,15663,15663,0
Big Data Analytics|Brand Marketing|Facebook Applications|Messaging|Online Scheduling|Social Media|Social Network Media|Twitter Applications,640000.0,TUR,3,2,245,16101,16346,0
Analytics|Direct Marketing|Machine Learning|Predictive Analytics,20000.0,USA,1,1,0,15810,15810,0
Architecture|Design|Green,12934371.0,USA,8,22,599,15899,16498,0
Advanced Materials,14300000.0,USA,1,2,0,13678,13678,0
Enterprise Software,8550000.0,USA,1,3,0,13192,13192,1
Analytics|Artificial Intelligence|Mobile|Natural Language Processing|Semantic Search,1850000.0,USA,2,9,138,15749,15887,0
Design|Digital Media|Publishing,544701.135419223,GBR,3,3,569,16191,16760,0
Apps|E-Books|Mobile,114644.0,DEU,1,2,0,15887,15887,0
Software,20996540.0,AUS,2,1,404,15980,16384,0
Apps,2400000.0,SWE,1,1,0,16674,16674,0
Communities|Development Platforms|Document Management,1120000.0,USA,2,8,200,16405,16605,0
Content|Photography|Publishing,465000.0,GBR,1,1,0,15903,15903,0
Android|Contact Management|Mobile,80000.0,USA,2,3,213,16130,16343,0
Finance,7000000.0,USA,1,2,0,14566,14566,0
Content Creators|E-Commerce|Monetization,250000.0,USA,1,3,0,16192,16192,0
Hardware + Software,500000.0,USA,2,3,163,15792,15955,0
Curated Web,14200000.0,USA,2,6,7,14697,14704,1
Finance|FinTech|Tracking,4777000.0,USA,3,8,365,14761,15126,1
Publishing|Web Design|Web Development,760000.0,USA,2,2,274,16252,16526,0
Software,8000000.0,USA,4,11,1078,15447,16525,0
Content|Content Creators|Content Delivery|Internet Marketing|Mobile|Software|Web Design,13595000.0,USA,4,5,1436,15196,16632,0
Food Processing,550000.0,USA,1,8,0,16266,16266,0
Health and Wellness|Hospitality|Nutrition,375000.0,USA,2,11,141,15861,16002,0
Software,13196231.0,USA,2,2,730,13468,14198,1
Hardware + Software,16000000.0,IND,1,1,0,14092,14092,0
Advertising|Advertising Platforms|Retail Technology,271249.0,GBR,2,3,128,16442,16570,0
Enterprise Software,127125009.0,CAN,4,2,1691,14868,16559,0
Biotechnology,3000000.0,USA,1,1,0,14304,14304,0
Software,150000.0,USA,1,1,0,15271,15271,0
E-Commerce|Marketplaces,35000.0,ARG,1,2,0,16130,16130,0
3D|Architecture|Commercial Real Estate|Property Management|Real Estate,1200000.0,USA,1,1,0,15530,15530,0
Biotechnology,1609750.0,USA,2,1,1414,14582,15996,0
Business Development|Marketplaces|Professional Networking|Real Estate,5775000.0,USA,5,3,808,15614,16422,0
Real Estate,1600000.0,USA,4,8,802,15765,16567,0
Broadcasting|Games,72000000.0,USA,3,3,635,13593,14228,1
Real Estate,2650000.0,USA,2,5,538,14610,15148,0
Advertising|Analytics|SaaS|Video,9236000.0,GBR,7,9,1582,15002,16584,0
Enterprise Software,3625000.0,USA,3,5,791,14445,15236,1
Crowdfunding|Events|Incubators|Media|Social Media,90000.0,USA,2,2,463,16063,16526,0
Content|Networking|Social Media,8300000.0,USA,2,1,881,13088,13969,0
Messaging,20201497.0,USA,7,3,1517,14525,16042,0
Digital Media|Market Research|Media|Mobile|Mobile Devices,909150.0,GBR,2,3,465,15910,16375,0
Technology,1100000.0,USA,2,2,947,10593,11540,1
Facebook Applications|NFC|RFID|Social Media|Software,130000.0,AUT,1,1,0,15323,15323,0
Databases|Developer Tools|Mobile|Mobile Software Tools|Software,29000000.0,USA,3,16,1392,15126,16518,0
Advertising|Career Management|Search,22700000.0,USA,4,8,2575,13879,16454,0
Software,13000000.0,USA,2,3,428,12836,13264,0
Software,86401577.0,USA,8,2,2816,12416,15232,1
Curated Web,431846.0,GBR,1,1,0,15925,15925,0
Technology,1955001.19980588,GBR,2,2,1187,15584,16771,0
Property Management|Real Estate|Realtors|Search|Software,7100000.0,USA,2,6,451,15940,16391,0
Beauty|Cosmetic Surgery|Dental|Doctors|Health and Wellness|Lifestyle|Medical|Q&A|Reviews and Recommendations|Social Media|Social Network Media,1950000.0,USA,2,1,430,13626,14056,0
Software|Speech Recognition|Technology,65463.0,RUS,2,2,230,15554,15784,0
Advertising|E-Commerce|Enterprise Software|Messaging|Online Shopping|Real Time,100000000.0,USA,1,2,0,15560,15560,0
Software,10354400.0,DEU,1,1,0,13891,13891,0
Games,82750000.0,USA,3,4,1388,12551,13939,0
Social Network Media|Travel,1800000.0,USA,2,3,997,13102,14099,1
FinTech|Real Estate,46250000.0,USA,6,11,1142,15614,16756,0
Health Care,10000000.0,ISR,1,1,0,16398,16398,0
Mobile|Real Estate|Real Time|Realtors|Video,320000.0,USA,2,4,817,15493,16310,0
Biotechnology,5650000.0,USA,2,5,1775,12797,14572,0
Biotechnology,2028242.0,DNK,3,3,725,14312,15037,0
E-Commerce,2550000.0,IND,2,1,366,13879,14245,0
Biotechnology,433949840.0,USA,6,8,2434,12734,15168,0
Games,2000000.0,USA,1,1,0,13031,13031,1
Fashion,4800000.0,USA,2,11,401,16252,16653,0
E-Commerce|Email,2000000.0,USA,1,7,0,16231,16231,0
Games,1000000.0,USA,1,1,0,13914,13914,0
Advertising|Content|Digital Media|Publishing|Social Media,18750000.0,USA,3,19,892,15639,16531,0
Health Care,100000.0,USA,1,1,0,15518,15518,0
Flash Storage|Software|Storage,6700000.0,USA,2,3,417,14214,14631,0
Information Services|Information Technology|Real Estate,269000.0,USA,2,1,155,16071,16226,0
Clean Technology,2516500.0,USA,6,1,974,15796,16770,0
E-Commerce,11430259.0,DEU,3,7,838,15246,16084,0
Exercise|Health and Wellness|Mobile|Sports,25000.0,USA,1,2,0,16130,16130,0
Film|Photography|Product Development Services,19299.0,GBR,1,1,0,15922,15922,0
Mobile,15000000.0,USA,2,2,781,14103,14884,1
E-Commerce,40000.0,GBR,1,1,0,15663,15663,0
Biotechnology,73480066.0,USA,4,10,1026,14386,15412,1
Wholesale,42889.0,GBR,1,1,0,16254,16254,0
Clean Technology,40000.0,NLD,1,1,0,16051,16051,0
Software,522965.0,GBR,2,2,710,14998,15708,0
Travel,1482369.0,ESP,3,7,199,15790,15989,0
Advertising Platforms|Big Data Analytics|Consumer Behavior|Email Marketing,95000.0,HKG,2,2,191,16375,16566,0
Curated Web,840000.0,USA,2,5,366,15126,15492,1
Software,2000000.0,JPN,1,2,0,16414,16414,0
Employment|Human Resources|Networking|Recruiting|Social Media|Universities,12500.0,PER,1,1,0,15979,15979,0
Software,415000.0,USA,2,3,147,15558,15705,0
Biotechnology|Health Care,3300000.0,USA,1,3,0,16133,16133,0
Curated Web|Internet|Mobile,1740415.0,FRA,2,3,481,15746,16227,0
Public Relations,9298870.0,FRA,1,3,0,15763,15763,0
Enterprise Software,22500000.0,USA,3,3,1862,14103,15965,0
Consumer Electronics|Electronics|Health and Wellness|Sports|Technology|Wearables,17000000.0,CAN,3,4,826,15357,16183,1
Computers|Enterprise Software,20000000.0,USA,1,1,0,15729,15729,0
Data Security|Security,16000000.0,USA,1,4,0,13268,13268,1
Health Care|Medical|Therapeutics,15000000.0,USA,1,2,0,16538,16538,0
Software,1715000.0,USA,2,1,294,16359,16653,0
Software,12000000.0,USA,2,5,360,13189,13549,0
Analytics|Cyber Security|Information Security,32900000.0,USA,4,19,2115,14426,16541,0
E-Commerce,195000.0,CHL,5,7,530,16071,16601,0
E-Commerce,50000.0,USA,1,1,0,15431,15431,0
Charity|Communities|Security,50000.0,USA,1,1,0,15636,15636,0
Employment|Enterprise Software|Human Resources|Social Recruiting,75000.0,USA,2,2,313,15758,16071,0
Career Management|Employment|Human Resources|News|Recruiting,350000.0,USA,1,2,0,16566,16566,0
Crowdsourcing|Employment|Enterprise Software|Marketplaces|Recruiting,1100000.0,USA,2,5,0,15922,15922,0
Colleges|Curated Web|Demographies|Education|High Schools|Recruiting|Soccer|Sports|Video,50000.0,USA,1,1,0,16010,16010,0
Games,1500000.0,USA,1,1,0,15812,15812,0
Billing|Enterprise Software|Information Technology|SaaS,19600000.0,USA,3,16,1543,14820,16363,0
Education|Educational Games|Teachers,183924.0,USA,2,1,274,16436,16710,0
Clean Technology,85000000.0,USA,2,2,390,13686,14076,1
Pharmaceuticals,2630000.0,USA,4,1,420,16071,16491,0
Clean Technology|Software,14000000.0,USA,2,2,632,14145,14777,1
Clean Technology|E-Commerce|Environmental Innovation|Game Mechanics|Gamification|Recycling|Sustainability,85200000.0,USA,6,27,2422,12842,15264,0
Clean Technology|Enterprise Software|Manufacturing|Recycling,620000.0,USA,2,1,167,14730,14897,0
Games,41500000.0,USA,2,3,1197,13493,14690,0
Advertising,1431239.0,GBR,4,4,712,15390,16102,0
Software,33199999.0,USA,4,15,1493,12500,13993,1
Enterprise Software|Professional Services|Virtual Workforces,2500000.0,USA,1,1,0,15426,15426,0
Business Services|Cyber|Cyber Security,2500000.0,USA,1,1,0,16520,16520,0
Mobile Games,50000.0,USA,1,1,0,16029,16029,0
Collaborative Consumption|Design|Marketplaces|Product Design,1000000.0,USA,1,1,0,16308,16308,0
Security,16200000.0,USA,2,7,520,13213,13733,0
Advertising|Optimization,706870.0,ESP,2,3,9,14396,14405,0
Security,20000.0,PSE,1,1,0,16290,16290,0
Enterprise Software,1836000.0,USA,3,1,1079,15504,16583,0
Analytics|Apps|iOS|iPad|iPhone|Mobile,1100000.0,USA,1,1,0,14916,14916,0
Marketplaces|Mobile Games|SaaS,118000.0,USA,1,1,0,16517,16517,0
Social Media,25000.0,ESP,1,1,0,15553,15553,0
News|Venture Capital,5000000.0,USA,1,1,0,11603,11603,0
Apps|Games|Mobile|Software,1500000.0,USA,1,5,0,15764,15764,1
Enterprise Software|Games|Internet,52840.0,ESP,1,1,0,15857,15857,0
Software,15208650.0,USA,4,1,1374,14816,16190,0
Mobile,9620000.0,GBR,2,5,1540,11590,13130,1
EdTech|Education|Gamification|Technology,442213.0,COL,5,5,699,15553,16252,0
E-Commerce,10000000.0,CAN,1,1,0,16733,16733,0
Games|Location Based Services|Mobile|Social Media,15500000.0,USA,3,6,445,14975,15420,0
Enterprise Software|Finance,418000.0,USA,1,4,0,15248,15248,0
Games,153147.775823071,NOR,1,1,0,16742,16742,0
Consumer Internet|Content|Curated Web|Local|Marketplaces|Media|Mobile|Mobile Commerce,2300000.0,USA,2,10,810,15683,16493,0
Information Technology,17136.0,NLD,1,1,0,16571,16571,0
Advertising|Internet Marketing|Sales and Marketing|Search Marketing|SEO|Technology|Web Development,250000000.0,USA,3,3,1609,14833,16442,0
Analytics|Finance Technology|FinTech|Loyalty Programs,1664558.0,GBR,1,1,0,16161,16161,0
Ticketing,865923.1972548821,GBR,1,1,0,16763,16763,0
Cloud Computing|Data Center Infrastructure|Web Hosting,40000000.0,USA,1,1,0,15413,15413,0
Hardware + Software|Internet Service Providers|Telecommunications,30000000.0,USA,1,1,0,12423,12423,0
Curated Web|Local|Local Search|Network Security|Online Scheduling|Service Providers,7400000.0,USA,1,2,0,14826,14826,1
Biotechnology,1865968.0,CHE,3,2,2072,14329,16401,0
Big Data Analytics|Civil Engineers|Cloud Data Services|Drones|Geospatial|Infrastructure|Mining Technologies,3194560.0,FRA,3,3,391,16191,16582,0
Chat|Collaboration|Enterprise Software|File Sharing|Mobile|Project Management|Video Conferencing,19749994.0,USA,6,11,1463,14929,16392,0
Health and Wellness,61652379.0,USA,6,7,2322,13866,16188,0
Art|Curated Web|Design|E-Commerce|Internet|Marketplaces,15500000.0,USA,1,2,0,16575,16575,0
Curated Web,8328770.0,IND,3,7,1065,14396,15461,1
Collaborative Consumption|Crowdsourcing|Location Based Services|Mobile|Transportation,2525000.0,USA,2,10,1186,14610,15796,0
News|Social Media,50100000.0,USA,2,17,3408,12935,16343,1
Enterprise Security|Enterprise Software|Mobile|Virtualization,4250000.0,USA,1,2,0,16442,16442,0
Health Care|Hospitals|Medical,600000000.0,BRA,1,1,0,16553,16553,0
Environmental Innovation,24384296.0,GBR,2,3,0,16331,16331,0
Curated Web|Discounts|Mobile|Mobile Commerce,250000.0,GBR,1,1,0,15266,15266,0
Health Care|Medical Devices,2700000.0,ISR,1,2,0,13335,13335,0
Design,11000000.0,USA,1,5,0,12080,12080,1
Clean Technology,25900000.0,USA,4,12,1717,12977,14694,0
Real Estate,167820000.0,USA,8,36,3395,13027,16422,0
E-Commerce,600000.0,RUS,1,1,0,15602,15602,0
Biotechnology,70200000.0,ISR,4,6,1715,14921,16636,1
CRM|Enterprise Software|SaaS,30000.0,USA,1,1,0,16314,16314,0
Security,242000.0,FRA,1,2,0,13405,13405,0
Hardware + Software,65000000.0,ARE,1,2,0,14164,14164,0
Big Data|Cloud Data Services|Databases|Enterprise Software|IaaS|Networking|Open Source|PaaS|SaaS,28000000.0,USA,3,7,1051,15560,16611,0
Software,72000000.0,USA,1,2,0,15938,15938,0
Curated Web|Music,3854828.0,USA,2,2,1597,13951,15548,0
Curated Web|Music|Television,9563440.0,USA,3,5,601,13818,14419,0
Analytics,15024396.0,CAN,3,6,3639,12496,16135,0
Oil & Gas|Public Safety|Telecommunications|Utilities|Wireless,15000000.0,CAN,1,3,0,13062,13062,0
Software,12453432.0,USA,2,1,1533,14736,16269,0
Watch,1362032.0,FRA,1,1,0,16255,16255,0
Consumers|E-Commerce,55100000.0,SGP,6,28,1357,15309,16666,0
Semiconductors,26100000.0,IRL,3,10,964,13623,14587,0
Analytics|Software,24450000.0,USA,4,14,818,15811,16629,0
Biotechnology|Health and Wellness|Physicians,9300718.0,USA,4,6,2302,13502,15804,1
Biotechnology|Healthcare Services|Medical,10200000.0,USA,1,6,0,12369,12369,0
CRM|Data Integration|Marketing Automation|Software,11649999.0,USA,2,2,614,15651,16265,0
Consulting,1212201.0,GBR,1,1,0,16153,16153,0
Cyber|Mobile Security|Software,56100000.0,USA,5,25,2895,13636,16531,0
E-Commerce|Web Development,3000000.0,USA,3,2,1098,15364,16462,0
Hardware + Software,16749688.0,USA,4,7,3550,13160,16710,0
Security,17700000.0,USA,1,3,0,12374,12374,1
Clean Technology|Energy|Energy Storage,1175760.0,IRL,1,3,0,15324,15324,0
Curated Web|Software,3004225.0,USA,2,3,2079,12363,14442,0
Educational Games|K-12 Education|Mobile|Mobile Games,20000.0,AUS,1,1,0,15431,15431,0
Business Services|Legal|Printing,782109.0,GBR,2,2,79,16587,16666,0
Ediscovery|Games,8110454.0,USA,5,8,2112,13573,15685,1
Web Hosting,26900000.0,ISR,3,7,796,15553,16349,0
Analytics,11800000.0,USA,3,2,3665,12357,16022,0
Biotechnology,11898299.0,USA,5,2,1427,14671,16098,0
Clean Technology,42250000.0,USA,5,9,1335,14155,15490,1
Semiconductors,29311481.0,USA,4,2,2030,14473,16503,0
E-Commerce|Manufacturing,64000000.0,SGP,3,8,882,14944,15826,0
Security,52000000.0,USA,3,8,721,12874,13595,0
Web Hosting,28000000.0,USA,2,11,863,11505,12368,0
Enterprise Software,25000.0,USA,1,1,0,16083,16083,0
Clean Technology,19000000.0,USA,2,4,484,15308,15792,0
Information Technology|Mobile|Mobile Commerce,40000.0,USA,1,1,0,16594,16594,0
Curated Web|Parenting|Photography|Video,961000.0,USA,2,9,277,15610,15887,0
Curated Web,8049999.0,USA,4,8,527,16139,16666,0
Photography|Video,880000.0,USA,1,1,0,15600,15600,0
Internet of Things|Mobile,22153.0,CAN,1,1,0,15675,15675,0
Clean Technology,8800000.0,CAN,1,1,0,14474,14474,0
E-Commerce,30000.0,RUS,1,1,0,15979,15979,0
Finance|Home & Garden|Internet|Investment Management|Real Estate|Startups|Technology,1583500.0,USA,4,4,717,15915,16632,1
E-Commerce|Reviews and Recommendations|SaaS|Software,8809276.56900479,GBR,4,6,3008,13504,16512,0
Curated Web|Incentives|Social Network Media,1300000.0,USA,2,11,350,15628,15978,0
E-Commerce,787401.0,SGP,2,6,1135,14975,16110,0
Recruiting,2000000.0,USA,1,4,0,16625,16625,0
Employer Benefits Programs|Social Media|Social Recruiting,1625000.0,IRL,1,1,0,15958,15958,0
Fashion,80400000.0,USA,5,12,1899,14653,16552,0
E-Commerce|SaaS,330000.0,IND,1,1,0,16453,16453,0
Digital Signage|Enterprises|News|Retail|Software,9000000.0,USA,1,1,0,12863,12863,0
Health Care,500000.0,USA,1,1,0,15119,15119,0
Computers|Information Technology|Software,13500000.0,USA,2,6,234,12199,12433,1
Big Data|E-Commerce|Fashion|Predictive Analytics,14404676.0,USA,4,4,489,15644,16133,0
Analytics|Human Resources|SaaS,3600000.0,USA,1,3,0,16716,16716,0
Security|Virtualization,18500000.0,USA,2,2,770,14351,15121,0
Health and Wellness,11750000.0,USA,2,2,512,15644,16156,0
Hardware + Software,11600000.0,USA,1,3,0,16163,16163,0
Security,2750000.0,USA,1,1,0,13101,13101,0
Enterprise Software|Retail|Software,72700000.0,USA,4,3,2729,13348,16077,0
EdTech|Education|Internet|Search,5000000.0,GBR,1,1,0,16533,16533,0
Development Platforms|Health Care|Medical Devices,14000000.0,USA,1,1,0,12480,12480,0
Games,2500000.0,FIN,1,1,0,16735,16735,0
E-Commerce|Fashion,12000000.0,USA,1,5,0,16527,16527,0
Automotive|Clean Technology,2000000.0,SWE,1,1,0,14734,14734,0
Manufacturing|Medical|Medical Devices,9000000.0,USA,2,6,315,11936,12251,0
Curated Web,3181000.0,USA,3,4,622,14160,14782,0
Analytics|Mobile Video|Video|Video Chat|Video on Demand|Video Streaming,201777.0,GBR,2,3,201,16071,16272,0
Software,10000000.0,USA,1,4,0,15986,15986,1
Security,177000.0,GBR,1,4,0,13131,13131,0
Biotechnology|Health Care,177000000.0,USA,5,17,2502,13599,16101,1
E-Commerce,40000.0,CHL,1,1,0,15408,15408,0
Mobile|Mobile Commerce|Mobile Payments,3004773.0,USA,6,18,1238,15441,16679,0
Apps|Information Technology|Internet|Software,64634.0,ITA,1,1,0,16324,16324,0
Curated Web,7819999.0,USA,3,1,1164,14614,15778,0
Clean Technology,17982000.0,CAN,5,12,2153,14197,16350,0
Energy|Oil & Gas|Services,10000000.0,USA,1,1,0,12514,12514,0
Health Care,1000000.0,USA,1,1,0,13514,13514,0
Health Care,5300000.0,USA,1,3,0,15131,15131,0
Software,23350000.0,USA,5,7,2860,13398,16258,0
Biotechnology,10000000.0,ISR,1,3,0,15474,15474,0
Biotechnology,108391875.0,USA,3,17,559,16016,16575,1
Biotechnology,21000000.0,JPN,4,26,2740,13375,16115,0
Consumer Goods|Groceries|Marketplaces,183652.0,DEU,3,3,334,16222,16556,0
Enterprise Software|Internet|Mobile,250000.0,USA,1,2,0,15796,15796,0
Services,1000000.0,IND,1,2,0,16554,16554,0
Health and Wellness|SaaS|Software,20000.0,USA,1,1,0,15857,15857,0
Software,3949998.0,USA,3,2,340,15719,16059,1
Health and Wellness,25000.0,USA,1,1,0,15665,15665,0
Fitness|Health and Wellness|Startups,100000.0,USA,1,1,0,15706,15706,0
Health and Wellness,40000.0,CHL,1,1,0,16052,16052,0
Advertising|iPad|iPhone|Local|Mobile|Social Media|Startups|Tablets|Venture Capital,37397.0,JPN,1,1,0,14713,14713,0
Analytics|Chemicals|Manufacturing,35000000.0,USA,1,1,0,16105,16105,0
Mobile,350000.0,USA,2,3,273,15492,15765,0
Internet|Organic Food|Specialty Foods,2000000.0,USA,1,9,0,16567,16567,0
Big Data Analytics|Machine Learning|Natural Language Processing,83877.0,GBR,1,1,0,16575,16575,0
Biotechnology|Health Diagnostics,4734165.0,GBR,2,2,571,14757,15328,1
Manufacturing,10000000.0,USA,2,3,95,14812,14907,0
Bio-Pharm|Biotechnology|Medical,49000000.0,USA,2,6,1269,11323,12592,0
Clean Technology,40000.0,PER,1,1,0,15376,15376,0
EdTech|Education,20000.0,USA,1,2,0,16275,16275,0
Games,3000000.0,CHN,3,3,730,14579,15309,0
Outsourcing|Software,2000000.0,USA,1,1,0,13109,13109,0
Enterprise Software,69000000.0,USA,4,13,945,15209,16154,1
Analytics|Enterprises,125000.0,USA,2,1,41,15800,15841,0
B2B|Business Development|Business Services|Charity|Finance|FinTech|Hospitality|Networking|Nonprofits|Sales and Marketing|Venture Capital,121000000.0,USA,3,38,1931,14610,16541,0
Games,250000000.0,USA,2,2,1167,15364,16531,0
Software,7500000.0,USA,2,6,479,12486,12965,1
Health Care|Hospitals|Pharmaceuticals,1500000.0,USA,1,1,0,16449,16449,0
Messaging|Mobile|Private Social Networking|Video,700000.0,CAN,1,5,0,15748,15748,1
Customer Service|Messaging|Mobile|SMS|Startups,6000000.0,USA,2,3,674,15091,15765,0
Health Care|Health Care Information Technology|Pharmaceuticals,48400000.0,USA,4,7,1582,10988,12570,1
Hardware + Software,13799000.0,DEU,5,5,752,15992,16744,0
Curated Web|Marketplaces|Transportation,95000000.0,USA,10,25,2193,14549,16742,0
Software,6900832.0,USA,2,2,361,15978,16339,0
Apps|Mobile Commerce|Personalization,9000000.0,USA,1,2,0,16268,16268,0
Enterprise Software|Storage|Virtualization,4000000.0,USA,1,1,0,14985,14985,1
Advertising|Internet,20323.0,ISR,1,1,0,15991,15991,0
News,2617230.0,RUS,1,1,0,14944,14944,0
Analytics|Big Data|Email|Mobile|SaaS|Sales and Marketing|SMS|Social Media,675000.0,USA,1,6,0,15065,15065,0
Software|Supply Chain Management,22394159.0,FIN,1,1,0,16687,16687,0
Messaging,32500000.0,USA,2,8,416,12884,13300,0
Biotechnology,15000000.0,USA,1,3,0,13622,13622,1
Data Centers,14000000.0,USA,1,2,0,11960,11960,1
Biotechnology,55050000.0,USA,3,12,1984,13443,15427,0
Artificial Intelligence|Business Intelligence|Data Visualization|Human Resources|Information Technology|SaaS,1340000.0,NOR,4,2,552,16035,16587,0
Clean Technology,54000000.0,USA,5,16,3002,12727,15729,1
Delivery|Hospitality,6000000.0,USA,3,5,414,16274,16688,0
Biotechnology,26231110.0,USA,4,2,667,15545,16212,0
Game,6000000.0,USA,2,3,120,16589,16709,0
Games,17292326.0,USA,2,6,1914,13682,15596,0
Software,1000000.0,USA,1,6,0,14595,14595,0
Software,10000000.0,USA,1,2,0,16510,16510,0
Manufacturing,7800000.0,USA,3,7,1021,14593,15614,1
E-Commerce|Online Travel|Social Travel,3600000.0,JPN,2,1,541,15784,16325,0
Biotechnology|Health Care,357129887.0,USA,8,22,2408,13815,16223,1
Hardware + Software,1990000.0,GBR,1,1,0,13947,13947,0
Real Estate,3000000.0,USA,1,2,0,12145,12145,0
Photography|Product Development Services|Project Management|SaaS|Video,100000.0,USA,2,4,168,15825,15993,0
Public Relations,6051497.0,USA,3,3,2159,13514,15673,1
Digital Media,250000.0,USA,1,1,0,16130,16130,0
Health and Wellness,301000000.0,USA,2,1,747,14446,15193,0
Hardware + Software,210000.0,USA,1,4,0,15967,15967,0
Software,8000000.0,USA,3,2,428,15309,15737,0
Health and Wellness,96150000.0,USA,3,1,1089,15660,16749,0
Biotechnology,15300755.0,USA,5,2,1896,14874,16770,0
Mobile,4000000.0,DEU,3,7,422,16252,16674,0
Chat|Market Research|Project Management|Social Media,422000.0,USA,1,7,0,16414,16414,0
Manufacturing,5763.0,DNK,1,1,0,16395,16395,0
All Students|Collaboration|Mobile,59500000.0,USA,4,23,1003,15340,16343,0
Manufacturing|Outdoors|Sporting Goods,30000000.0,USA,1,1,0,12062,12062,0
Analytics,8500100.0,USA,3,4,1594,15070,16664,0
Finance|FinTech|Mobile|Mobile Payments,23000000.0,USA,6,22,1239,15274,16513,0
Software,2500000.0,USA,1,1,0,13266,13266,0
Technology,2000000.0,USA,1,7,0,16374,16374,0
File Sharing|Games|Video|Web Tools,5580000.0,USA,2,2,1827,13695,15522,0
Geospatial|Hardware + Software|Predictive Analytics,1254600.0,ITA,1,1,0,15485,15485,0
Home Renovation,100000.0,USA,2,2,31,16252,16283,0
Manufacturing,9300000.0,USA,3,4,1835,13500,15335,0
Enterprises|Mobile Security|Mobility|Security,1000000.0,USA,1,1,0,15812,15812,1
Cars|Information Technology|Internet of Things,1500000.0,RUS,1,1,0,16395,16395,0
File Sharing|Media|Mobile|Music|Networking|Photography|Social Media|Video|Video Streaming,2700000.0,USA,3,4,533,13634,14167,0
Biotechnology,67500000.0,USA,1,5,0,15287,15287,1
Education,40000000.0,USA,1,1,0,16120,16120,1
Medical|Medical Devices,32700000.0,USA,2,5,241,12024,12265,1
Health and Wellness,30000000.0,USA,1,1,0,15005,15005,1
Biotechnology,40000000.0,USA,1,9,0,13398,13398,0
Entertainment|Online Dating|Social + Mobile + Local,117206.0,GBR,2,1,270,16249,16519,0
Technology,20000000.0,USA,1,7,0,11109,11109,0
Agriculture|Energy Efficiency|Supply Chain Management|Waste Management,1970000.0,CHN,1,1,0,15390,15390,0
Clean Technology,540000000.0,IND,3,4,874,15861,16735,0
Chemicals|Clean Technology,198730677.0,USA,1,1,0,14057,14057,1
Clean Technology,32200000.0,USA,2,8,1638,14546,16184,0
Financial Services,500000.0,IND,1,1,0,16748,16748,0
Analytics|Big Data,28000.0,USA,1,1,0,15896,15896,0
Chat|Events|Facebook Applications|Social Media,9000000.0,USA,2,4,671,13239,13910,0
Clean Technology,75000000.0,USA,2,4,265,15309,15574,0
Biotechnology,78537524.0,USA,5,2,1813,14304,16117,0
Semiconductors,9396402.0,CAN,3,2,584,16076,16660,0
E-Commerce|Fashion|Marketplaces|Mobile|Online Shopping,190000.0,ARG,2,3,92,16283,16375,0
Clean Technology|Renewable Energies|Solar,435728.0,GBR,1,1,0,16310,16310,0
Biotechnology,1200000.0,USA,1,2,0,13482,13482,0
Financial Services,146000000.0,USA,3,11,1087,15622,16709,0
Apps|Games|Home Automation|Mobile|Software,30000.0,ROM,1,1,0,16310,16310,0
Innovation Management|Medical|Professional Services,34300000.0,USA,1,10,0,11697,11697,0
Retail,1400000.0,USA,1,7,0,16734,16734,0
Biotechnology,33000000.0,GBR,1,4,0,12023,12023,0
Health Care,1810000.0,USA,2,5,293,15805,16098,0
Crowdsourcing|Curated Web|Recruiting|Web Development,7400000.0,CHN,3,3,114,15796,15910,0
Curated Web|Social Media|Technology,478000000.0,CHN,2,7,781,13218,13999,1
Crowdsourcing|Postal and Courier Services|Service Providers,15000000.0,CHN,1,2,0,16378,16378,0
Finance,133205128.0,CHN,2,2,431,15645,16076,0
Retail,1150000.0,CAN,1,2,0,16386,16386,0
Application Platforms|E-Commerce Platforms|Internet|Online Rental,340426.0,CHN,3,3,365,15553,15918,0
E-Commerce|Fashion,114400000.0,USA,4,13,1758,14665,16423,0
Curated Web|Online Rental|Real Estate|Software,50000.0,USA,1,1,0,14903,14903,0
Personal Finance,15000.0,USA,1,2,0,15465,15465,0
Big Data|Real Estate|Reviews and Recommendations,250000.0,USA,1,3,0,15653,15653,0
Property Management|Real Estate|SaaS|Software,357500.0,USA,3,1,775,15758,16533,0
Curated Web|Human Resources|Marketplaces|Online Rental|Real Estate,385980.0,ESP,1,2,0,15998,15998,0
Collaboration|Collaborative Consumption|Marketplaces|Online Rental|Real Estate|Rental Housing|Search,40000.0,USA,1,1,0,15660,15660,0
Online Rental|Real Estate,25000.0,USA,2,4,1765,14396,16161,0
Online Rental|Property Management|Real Estate|Software|Startups,8565083.0,GBR,3,6,783,15583,16366,0
Real Estate,6923782.0,USA,3,5,818,14187,15005,1
Analytics|B2B|Real Estate|SaaS,4000000.0,USA,2,8,213,16185,16398,0
Cars|Online Rental|Small and Medium Businesses,86611.0,LVA,2,2,1165,14858,16023,0
Facebook Applications|Finance|Internet|Internet Marketing|Lead Generation|Real Estate|Sales and Marketing|Social Network Media|Startups,68246.0,USA,2,3,639,13757,14396,1
Internet,2000000.0,IND,1,2,0,16762,16762,0
Curated Web,305000.0,USA,1,1,0,15156,15156,0
Curated Web,675000.0,USA,2,3,343,15099,15442,1
Real Estate,3730000.0,USA,2,1,652,14061,14713,0
E-Commerce|Transportation,100000000.0,CHN,2,4,458,15187,15645,0
Curated Web,496000.0,SWE,1,1,0,14031,14031,0
Analytics|Commercial Real Estate,22350000.0,USA,4,24,838,15765,16603,0
Market Research,1254544.0,USA,1,1,0,16134,16134,0
Curated Web,20000.0,USA,1,1,0,15826,15826,0
Beauty|Biotechnology|Cosmetics|Cosmetic Surgery,460000.0,USA,1,5,0,16073,16073,0
Curated Web,21300000.0,USA,6,8,2021,13726,15747,0
Wireless,1230000.0,SWE,1,2,0,12935,12935,0
Software,15200000.0,USA,2,4,622,13487,14109,0
Software,17000000.0,USA,4,4,475,16128,16603,0
SaaS,1500000.0,USA,1,10,0,16609,16609,0
Enterprise Software,20000000.0,USA,1,2,0,15884,15884,0
Bio-Pharm|Biotechnology|Medical,13000000.0,USA,1,4,0,11796,11796,1
Health Care|Medical|Therapeutics,30000000.0,GBR,1,3,0,16702,16702,0
Advertising|Home Renovation|Internet Marketing|Lead Generation|Marketing Automation|Real Estate,84590402.0,USA,7,9,3353,12867,16220,0
App Marketing|Curated Web|Mobile Commerce,2940000.0,USA,3,4,872,15841,16713,0
Email|Finance|FinTech|Software,118000.0,USA,1,1,0,15461,15461,0
Curated Web|Identity|Internet,1384222.0,USA,7,6,555,15522,16077,0
Biotechnology,1600000.0,GBR,1,2,0,14929,14929,0
Software,836000.0,JPN,1,2,0,16547,16547,0
Advertising,1000000.0,USA,1,6,0,15584,15584,1
Big Data Analytics|Loyalty Programs|Mobile|Retail,35000.0,USA,2,1,160,15857,16017,0
Curated Web|Enterprise Software|Internet|Internet Marketing|Local Businesses|Reputation|Reviews and Recommendations|Social Media|Surveys,67250000.0,USA,6,19,1640,14125,15765,0
Reputation,2238246.0,FRA,1,2,0,16611,16611,0
Human Resources,144890.0,CHL,3,3,518,15796,16314,0
Advertising|Reviews and Recommendations|Social Search,117394.0,GBR,2,3,31,15522,15553,0
Document Management|Outsourcing|Technology,30000000.0,USA,1,5,0,11275,11275,1
E-Commerce|Mobile|Mobile Commerce|Peer-to-Peer|Sporting Goods|Sports,150500.0,USA,4,3,627,15625,16252,0
Technology,12406622.565103501,USA,2,2,0,14727,14727,0
Enterprise Software|Real Estate|Social Media Marketing|Social Network Media|Technology,18035387.0,CAN,12,1,2043,14426,16469,1
Application Platforms|Cloud Infrastructure|Enterprise Software,6400000.0,USA,4,13,1290,15340,16630,0
Elder Care|Service Providers|Services,164186803.454129,USA,2,2,106,12487,12593,0
Education,120000.0,USA,1,1,0,16405,16405,0
Commercial Real Estate|Real Estate,2800000.0,USA,2,9,274,16498,16772,0
Services,120000.0,USA,1,1,0,16405,16405,0
Curated Web|SaaS,920000.0,USA,2,7,323,13800,14123,0
Market Research,2120000.0,JPN,1,2,0,16304,16304,0
Education,25000.0,USA,1,1,0,16222,16222,0
Internet|Restaurants|Software,322068.0,ARG,4,6,731,14914,15645,0
Beauty|Internet|Marketplaces|Online Reservations|Service Providers,25000.0,ESP,1,1,0,16588,16588,0
Mobile Payments|Online Reservations|Restaurants|Technology,15000000.0,USA,2,16,321,16156,16477,0
Curated Web|Online Reservations|Recreation|Restaurants,1300000.0,JOR,2,2,1197,15400,16597,0
Computers|Software|Technology,24000000.0,USA,2,4,912,11688,12600,0
Health Care,100250000.0,USA,8,16,2917,13756,16673,0
Security,10000000.0,USA,1,2,0,13262,13262,0
Web Hosting,9875231.0,USA,2,1,414,14705,15119,0
Logistics|Risk Management|SaaS|Supply Chain Management,8000000.0,USA,1,3,0,16103,16103,0
Internet,5540002.0,GBR,2,3,243,16296,16539,0
Manufacturing,4500000.0,USA,1,1,0,11589,11589,0
Biotechnology,13960000.0,SWE,1,5,0,13417,13417,0
Web Hosting,15000000.0,ISR,2,12,612,12825,13437,0
Business Services|Consulting|Technology,7600000.0,USA,1,1,0,13811,13811,0
Game,6000000.0,SWE,1,5,0,16672,16672,0
Field Support Services|Mobile|Tech Field Support,2018000.0,USA,3,8,136,15922,16058,0
Biotechnology,8883334.0,USA,3,5,534,15111,15645,0
Biotechnology,20700000.0,USA,3,3,1803,13119,14922,0
Mobile,7129238.0,USA,4,2,964,15340,16304,1
Curated Web,350000.0,USA,1,1,0,14208,14208,0
Advertising|Brand Marketing|Business Analytics|Internet Marketing|Marketing Automation|Market Research|Politics|Predictive Analytics,29000000.0,USA,4,8,1881,14370,16251,0
Consumers|Hotels|Travel,1100000.0,USA,2,2,91,14853,14944,0
Hardware + Software,1210000.0,FRA,1,1,0,13164,13164,0
Apps|Career Planning|Collaboration|Employment|Events|Online Scheduling|Productivity Software|Project Management|SaaS|Software|Systems|Task Management,1142000.0,GBR,2,1,769,15320,16089,0
Clean Energy|Clean Technology,813000.0,IRL,1,2,0,14700,14700,0
Business Services|Human Resources|Services,3650000.0,USA,1,1,0,16109,16109,0
E-Commerce,15665911.393234301,CAN,9,4,1596,15138,16734,1
Social Media,1750000.0,USA,2,3,53,13665,13718,0
Hardware|Health and Wellness,90000.0,USA,2,2,18,16204,16222,0
Health Care|Health Care Information Technology|Medical Devices,32004000.0,USA,3,1,413,15952,16365,0
Healthcare Services|Medical|Therapeutics,5100000.0,USA,4,7,1582,14883,16465,0
Health Care,6581289.0,USA,10,15,1308,15187,16495,0
Biotechnology,4247540.0,USA,4,2,1795,13053,14848,0
Messaging,1784500.0,USA,1,3,0,16286,16286,0
Curated Web,373275.0,ITA,1,1,0,15034,15034,0
Finance|FinTech,4250000.0,USA,1,2,0,13536,13536,0
Biotechnology,21665600.0,CAN,6,1,1720,14393,16113,1
Customer Service|Market Research|Software|Surveys,6000000.0,CAN,1,2,0,16084,16084,0
Advertising,270000.0,USA,1,2,0,16040,16040,0
Search Marketing|Software,51900000.0,USA,3,13,1142,11002,12144,1
Software,679000.0,SWE,1,2,0,14664,14664,0
Agriculture,2701849.0,CAN,1,4,0,16356,16356,0
Apps,400000.0,IND,1,6,0,16649,16649,0
Hospitality|Internet|Restaurants,11446000.0,ESP,2,3,838,15127,15965,0
Delivery|Hospitality,3665400.0,USA,3,1,1198,14732,15930,0
Oil|Restaurants|Training,25000000.0,USA,1,2,0,12480,12480,1
Android|Developer APIs|PaaS|Software,4000000.0,USA,2,2,372,16023,16395,0
E-Commerce|Internet|Real Time|Restaurants,237401.0,FRA,1,1,0,14791,14791,0
Curated Web,24000003.0,ARG,3,9,1239,15392,16631,0
Biotechnology|Health Care,112999999.0,USA,4,11,2646,13738,16384,0
Medical,26500000.0,USA,1,9,0,12499,12499,1
Health and Wellness|Health Care|Hospitals|Medical|Medical Devices,4150000.0,USA,5,8,1133,15492,16625,0
Hospitality|Mobile|Recipes|Social Media Marketing,40000.0,CHL,1,1,0,16028,16028,0
Enterprise Software|SaaS|Sales and Marketing,7017479.0,BRA,2,5,743,15887,16630,0
Mobile,2700000.0,USA,4,1,1096,15095,16191,0
Consulting,5000.0,GBR,1,1,0,15966,15966,0
Curated Web|Employment,500000.0,CZE,1,1,0,15202,15202,0
Biotechnology,60741995.0,CAN,5,2,1557,14697,16254,1
Apps|Restaurants,2000000.0,USA,1,6,0,16282,16282,0
E-Commerce,25000000.0,USA,1,4,0,13993,13993,1
Curated Web,247000.0,CZE,1,1,0,13340,13340,0
Analytics,2844942.0,USA,3,3,1148,13629,14777,1
Analytics|Business Intelligence|SaaS,40000.0,CHL,1,1,0,15539,15539,0
E-Commerce,14308892.0,USA,4,3,750,15057,15807,0
Big Data|E-Commerce|Reviews and Recommendations|SaaS,450000.0,RUS,1,1,0,16006,16006,0
Analytics|Enterprise Software|Retail,33400000.0,USA,3,4,2179,12701,14880,0
E-Commerce|Group Buying,960060.0,GBR,3,9,699,15706,16405,0
Advertising|Developer APIs|Local Search,13000000.0,USA,5,22,967,14802,15769,0
Big Data|Commercial Real Estate|Real Estate|Retail|SaaS,1945000.0,USA,2,2,122,15218,15340,0
Data Visualization|Manufacturing|Retail,140000000.0,USA,2,12,350,16190,16540,0
E-Commerce|Software,100000.0,GHA,1,1,0,14800,14800,0
Location Based Services|Mobile|Retail|Shopping,45000000.0,USA,2,4,553,16006,16559,0
Software,450310.0,ITA,1,3,0,15987,15987,0
Advertising|Displays|Internet Marketing|Sales and Marketing|Semantic Search|SEO,1500000.0,USA,2,3,16,15949,15965,1
Advertising|Big Data|Data Centers,25000.0,ARG,1,1,0,16130,16130,0
Analytics|Finance|FinTech,1000000.0,USA,2,9,118,14462,14580,1
Communities|Real Estate|SaaS,440000.0,USA,2,1,396,15737,16133,0
CRM|Marketing Automation|Predictive Analytics,9500000.0,USA,2,10,341,15946,16287,0
Analytics|Beauty|Consulting|Local Search|Parenting|Social Media Agent|Social Search|Teachers|Training,20000000.0,USA,3,5,1235,15065,16300,0
Content|Publishing|Software|Textbooks|Writers,9000000.0,USA,4,3,1100,14720,15820,0
Manufacturing|Robotics,113500350.0,USA,7,29,2429,14112,16541,0
Databases|Enterprise Software,12200000.0,USA,4,23,1659,14396,16055,0
Curated Web|News|Social Media,1550000.0,USA,2,2,328,15065,15393,0
Health and Wellness,40000.0,CHL,1,1,0,15911,15911,0
Databases|Data Security|Internet|Software,40047.0,BGR,1,1,0,15729,15729,0
Analytics|Virtualization,500000.0,CAN,2,6,119,16575,16694,0
Mobile,100000.0,USA,1,3,0,15796,15796,0
Blogging Platforms|Consumer Electronics|Electronics|Gadget|Hardware + Software|Reviews and Recommendations|Search|Semantic Web|Shopping|Tech Field Support,15100000.0,USA,4,7,778,13180,13958,1
Clean Technology|Energy Efficiency,7340000.0,USA,1,1,0,15308,15308,1
Health and Wellness|Personal Health,15700000.0,USA,3,31,645,15414,16059,0
Digital Media|Photo Sharing|Social Media,568292.0,USA,1,2,0,15461,15461,0
Biotechnology|Health Care,116000000.0,USA,3,1,319,15933,16252,1
Biotechnology,12075000.0,USA,4,11,1714,15037,16751,0
Biotechnology,3000000.0,USA,1,1,0,16506,16506,0
Business Intelligence|Enterprise Software|Retail Technology|SaaS|Software,40000.0,USA,1,1,0,16076,16076,0
Property Management|Real Estate,540315.0,CAN,3,4,230,15929,16159,1
Hospitality,12599999.0,JPN,4,7,1293,15217,16510,0
Email|Messaging|Sales and Marketing|Security,97299962.0,USA,7,15,2220,14186,16406,0
E-Commerce|Logistics|Retail Technology|Supply Chain Management,225000.0,USA,1,2,0,16161,16161,0
Social Media,25000000.0,USA,1,2,0,13619,13619,0
Translation,4500000.0,USA,1,3,0,15790,15790,0
E-Commerce|Mobile,10015940.0,USA,3,1,325,15737,16062,0
Hardware + Software,67000000.0,USA,3,7,3635,12739,16374,0
Hardware + Software,39000000.0,USA,3,8,925,13423,14348,1
Software,86922153.0,USA,4,5,1939,13717,15656,0
Consulting|E-Commerce|Trading,4700000.0,JPN,1,1,0,14810,14810,0
Biotechnology|Health Care,156820000.0,USA,5,16,2143,13859,16002,1
Image Recognition,150000.0,IND,1,1,0,15531,15531,0
Chat|Private Social Networking|Social Media,1000000.0,USA,2,2,338,15721,16059,1
Apps,1500000.0,USA,1,5,0,16602,16602,0
Apps|Media|Mobile,2000000.0,USA,2,5,13,16623,16636,0
Security,37600000.0,USA,4,7,1631,12335,13966,1
Software,230000.0,USA,1,1,0,13361,13361,0
Internet|Software,1000000.0,USA,1,1,0,16238,16238,0
Business Services|SaaS|Sales and Marketing,350000.0,USA,1,1,0,16442,16442,0
Enterprise Software|Sales and Marketing|Visualization,3840934.0,USA,2,1,1393,15309,16702,0
Content Creators|Content Discovery|Mobile Commerce|Social Commerce,1500000.0,USA,1,1,0,16436,16436,0
Analytics|Mobile|Mobile Payments|Point of Sale,128500000.0,USA,6,8,1547,15118,16665,0
E-Commerce,10000000.0,USA,2,6,386,15187,15573,1
Analytics|Customer Service|Market Research|Software,2370000.0,USA,2,1,653,14065,14718,0
Analytics|Business Intelligence|Enterprise Software|Mobile|Music|SaaS,650000.0,ISR,1,1,0,16505,16505,0
Enterprise Software|Marketing Automation|SaaS|Sales and Marketing,7638575.0,USA,2,7,398,16008,16406,0
Mobile,200000.0,USA,1,1,0,15269,15269,0
Fraud Detection|Software,46000000.0,USA,7,18,3259,11747,15006,0
Semiconductors,11200000.0,USA,1,2,0,12867,12867,1
Auctions|E-Commerce|Marketplaces|Music,32000000.0,USA,4,10,898,15874,16772,0
Software,7000000.0,USA,1,1,0,15315,15315,0
B2B|Business Analytics|Content Discovery|Curated Web,12789996.0,USA,5,12,1917,13879,15796,1
Internet|Software|Translation,40000.0,CHL,2,2,356,15584,15940,0
Music|New Product Development|SaaS|Sales and Marketing|Software|Technology,8600020.0,USA,3,3,2126,13377,15503,0
Internet|Technology,4000000.0,IND,1,2,0,16678,16678,0
Biotechnology,15500000.0,USA,2,6,280,14426,14706,1
Cyber Security|Data Security|SaaS,1560000.0,NZL,2,6,368,16173,16541,0
Brand Marketing|Content Syndication|Curated Web|Software,20000.0,USA,1,1,0,14365,14365,0
Enterprise Software|Reputation|Reviews and Recommendations,2060000.0,USA,3,7,677,15561,16238,0
Networking|Reputation|Reviews and Recommendations|SaaS|Social Media Management|Social Media Marketing|Software,6679800.0,ESP,4,1,1743,14160,15903,0
Curated Web|Reviews and Recommendations,5000000.0,IND,1,3,0,16258,16258,0
Enterprise Software|Hospitality|Hotels|Social Media|Social Media Marketing,30540000.0,USA,4,8,1930,14538,16468,0
Hardware + Software,140000.0,USA,2,4,522,16073,16595,0
Software,48200000.0,USA,4,3,2609,13803,16412,0
Hardware + Software,12000000.0,USA,1,1,0,15849,15849,0
Biotechnology,129999998.0,USA,4,16,2282,13633,15915,0
Games|Social Bookmarking|Video,9000000.0,USA,2,4,297,13392,13689,1
Content|Games,1960000.0,ESP,1,1,0,12801,12801,0
Software,18000.0,USA,1,1,0,15359,15359,0
Business Development|Optimization|Price Comparison|Public Relations|Software,55000000.0,USA,1,1,0,14420,14420,0
Software,25000000.0,USA,1,7,0,12801,12801,0
Curated Web,20000000.0,ISR,1,1,0,15946,15946,0
Analytics|CRM|Marketing Automation|SaaS,2200000.0,USA,1,7,0,16485,16485,0
Information Technology,40000.0,ECU,2,2,304,15180,15484,0
Hardware + Software,1000000.0,USA,1,1,0,16199,16199,0
Hardware + Software,16033882.1642302,USA,2,7,845,14259,15104,0
Apps|Software,94000100.0,USA,3,2,188,15553,15741,0
Customer Service|Financial Services|Information Technology,2838719.0,GBR,2,2,387,16249,16636,0
Analytics|Big Data|Insurance,38695399.0,USA,5,5,1807,13900,15707,1
Health and Wellness,62750000.0,USA,3,4,1258,14967,16225,0
Healthcare Services|Medical|Pharmaceuticals,45000000.0,USA,1,1,0,16470,16470,0
Certification Test|Colleges|EdTech|Education|Technology|Testing,15000000.0,USA,1,1,0,14879,14879,0
Finance,5697475.0,USA,6,4,584,15958,16542,0
Finance,107225000.0,USA,3,13,639,13757,14396,1
Home Automation|Internet of Things|Software,7318000.0,USA,3,12,557,15477,16034,1
Consumer Electronics|Hardware + Software|Mobile|Robotics|Tablets|Video Chat|Video Conferencing,615000.0,USA,3,4,611,15598,16209,0
Games,500000.0,ISR,1,1,0,12969,12969,0
Social Media,1674002.03075489,JPN,3,5,307,15702,16009,0
Manufacturing,48619829.0,GBR,2,2,458,15079,15537,0
Exercise|Health and Wellness|Health Care|Video,12000.0,USA,1,1,0,15474,15474,0
Advertising,20000000.0,USA,1,2,0,13848,13848,0
Aerospace,6000000.0,USA,1,1,0,14712,14712,0
Crowdfunding|Nonprofits|Social Media|Startups|Teachers,40000.0,FRA,1,1,0,16052,16052,0
E-Commerce,550000.0,ISR,1,1,0,15979,15979,0
Content|Games|Video|Video Streaming,12700000.0,USA,2,7,151,13088,13239,1
Mobile Advertising,4000000.0,IND,1,5,0,16672,16672,0
Advertising|Business Services|Corporate Training|E-Commerce,499859.0,LTU,3,4,483,15712,16195,0
Cloud Computing|E-Commerce|Employer Benefits Programs|Human Resources|SaaS,257944298.0,GBR,2,2,1700,14945,16645,1
E-Commerce|Marketplaces|Q&A,7000000.0,USA,1,6,0,15553,15553,0
Advertising|Apps|Local|Loyalty Programs,1561337.12911738,GBR,3,2,1034,15614,16648,0
E-Commerce|Group Buying|Network Security|Social Commerce,765000.0,USA,3,4,350,14989,15339,0
Incentives|Loyalty Programs|Mobile|Wireless,1250000.0,CAN,2,2,348,15121,15469,0
Advertising|Incentives|Loyalty Programs|Mobile|Tablets,1100000.0,USA,1,2,0,15095,15095,0
Mobile Commerce|Mobile Payments,3400000.0,USA,3,1,989,15082,16071,0
Advertising|CRM|Finance|Loyalty Programs|Sales and Marketing,218000.0,USA,2,2,61,14914,14975,0
E-Commerce,250000.0,USA,1,1,0,15126,15126,0
Professional Services|Technology|Web Hosting,10800000.0,USA,1,2,0,12802,12802,0
Information Technology|Travel|Web Tools,350000.0,USA,1,1,0,16723,16723,0
Advertising,15000000.0,USA,1,1,0,16616,16616,0
Finance|Mobile,800000.0,USA,2,13,105,15400,15505,0
Computers,1400000.0,USA,2,1,50,16587,16637,0
Health and Wellness|Marketplaces|Medical|Pets|Veterinary,145000.0,USA,2,2,222,16273,16495,0
Finance|FinTech,560000.0,USA,3,1,804,14995,15799,0
Contact Management|CRM|Enterprise Software|Internet|Mobile|Networking,1400000.0,USA,3,10,1520,14975,16495,0
Internet|Online Reservations|Software|Travel|Travel & Tourism,4500000.0,AUS,2,4,682,16055,16737,0
Hospitality,5000000.0,IND,1,1,0,16412,16412,0
Advertising|Direct Sales|Email Marketing|Financial Services|Marketing Automation|Real Estate,18000.0,USA,1,1,0,14462,14462,0
Health and Wellness,10000000.0,USA,1,1,0,15141,15141,0
IT Management|RFID|Software,62540000.0,USA,6,8,2158,12955,15113,0
Software,4890000.0,AUT,1,2,0,13174,13174,1
Consumer Electronics|Semiconductors|Technology,24000000.0,USA,1,11,0,12349,12349,0
Nanotechnology,9500000.0,USA,2,3,644,13459,14103,0
Health Care,29620000.0,USA,4,4,1430,14750,16180,1
Enterprise Software|SaaS|Sales Automation,4900000.0,USA,2,1,489,15248,15737,0
Business Intelligence|Enterprises|Technology,40000.0,USA,1,1,0,15376,15376,0
Consulting,3477548.0,GBR,1,1,0,13192,13192,0
Health Diagnostics|Software,720000.0,FRA,1,1,0,13136,13136,0
Software,5795000.0,USA,3,1,1623,14426,16049,0
Mobile|Mobile Payments|NFC,4000000.0,USA,1,1,0,15006,15006,0
Games|Logistics|Video Streaming,72000001.0,USA,4,14,2109,12794,14903,0
Advertising,21000000.0,USA,1,1,0,15602,15602,0
Software,10963000.0,FRA,3,5,1203,13180,14383,0
Music,10000000.0,USA,3,3,598,15965,16563,0
Biotechnology|Health Diagnostics,88724758.0,USA,8,13,2105,14623,16728,0
Android|Application Platforms|Apps|Development Platforms|DIY|Mobile,154000.0,USA,3,2,530,15510,16040,0
Software,6282049.0,GBR,1,4,0,11631,11631,0
Biotechnology,4699721.0,USA,6,3,3348,13367,16715,0
Analytics|Enterprise Software|Maps|Visualization,4500000.0,USA,2,3,408,16238,16646,0
Hospitality,50000.0,USA,1,1,0,16251,16251,0
iPad|Restaurants|Wine And Spirits,25000.0,USA,1,1,0,15106,15106,0
Electronics,2800000.0,USA,1,1,0,16519,16519,0
E-Commerce|Online Shopping|Retail,13479517.0,USA,3,5,488,16211,16699,0
Analytics|Construction|Enterprise Software|Mobile,7134517.0,USA,2,13,399,16283,16682,0
Health and Wellness|Healthcare Services|Medical Devices,15278449.7466324,USA,1,2,0,12753,12753,0
Services|Telecommunications,7850000.0,USA,1,3,0,13000,13000,0
Advertising|App Marketing|Mobile Video,28932322.0,USA,4,8,671,14923,15594,1
Biotechnology,135900000.0,USA,9,20,2019,14683,16702,0
Clean Technology|Energy|New Product Development,175000.0,USA,1,1,0,15623,15623,0
Health Care,14700000.0,USA,3,1,1326,13550,14876,1
Boating Industry|Leisure|Service Providers,262317.0,GBR,1,1,0,16161,16161,0
Software,10000000.0,DEU,2,4,344,14630,14974,1
Audio|Mobile|VoIP,21000000.0,USA,3,5,502,13422,13924,1
E-Commerce|Mobile Commerce|Payments|Social Commerce,1750000.0,USA,2,9,523,15218,15741,0
Biotechnology,1184422.0,DEU,4,3,1858,14589,16447,0
Mobile|Software,7000000.0,CHN,1,2,0,16160,16160,0
Advertising,33000000.0,USA,1,6,0,11275,11275,1
Advertising|Analytics|Big Data|E-Commerce|Internet|Retail,81832065.0,USA,8,27,2353,13683,16036,0
Real Estate,3000000.0,USA,1,1,0,16611,16611,0
Home Automation|Security,148000.0,USA,2,1,729,15645,16374,0
Android|iPhone|Mobile|Transportation|Travel,10700000.0,USA,3,1,2403,13898,16301,1
Bridging Online and Offline|Collaborative Consumption|Social Media|Transportation|Travel,1300000.0,USA,1,7,0,15364,15364,0
Cars|E-Commerce|Toys|Virtual Worlds,23000000.0,USA,3,6,639,13300,13939,0
Career Management|Clean Technology|Human Resources|Public Transportation|Transportation,3700000.0,USA,2,7,381,15593,15974,0
Apps|Cloud Computing|Consumer Internet|Mobile|Sports|Web Tools,270000.0,USA,1,1,0,15751,15751,0
Apps|Public Transportation,2600000.0,USA,2,4,577,15570,16147,1
Biotechnology|Health Diagnostics,927000.0,USA,3,1,1042,14771,15813,0
Apps|Digital Entertainment|E-Books|E-Commerce,8000000.0,KOR,1,4,0,16422,16422,0
Advertising|Big Data|Home Automation|Security,100000.0,USA,1,1,0,16266,16266,0
Messaging|Social Media|Video,13500000.0,USA,3,9,630,16021,16651,0
Games,5000000.0,USA,1,2,0,14133,14133,0
B2B|Real Estate|SaaS|Software|Web Development,2266000.0,USA,1,6,0,16136,16136,0
Innovation Management|Startups|Technology,24000000.0,USA,2,1,602,16058,16660,0
Biotechnology,176000000.0,USA,2,4,2891,12230,15121,1
Big Data|Computers|Hardware|Software,3000000.0,USA,2,18,136,16175,16311,0
Enterprise Software,21999969.0,USA,3,4,1398,12944,14342,1
Advertising,45000000.0,USA,1,1,0,13438,13438,1
Big Data|Curated Web|Machine Learning|Social Search,730000.0,USA,1,2,0,16130,16130,0
Consumer Goods,63345.0,CHE,1,1,0,16356,16356,0
Sales and Marketing|Software,22000000.0,USA,3,8,1303,12842,14145,1
Software,2300000.0,USA,1,1,0,13073,13073,0
Software,10750000.0,USA,3,5,706,15623,16329,0
Food Processing,355131.0,GBR,2,2,366,15371,15737,0
CRM|Customer Service|SaaS|Software,15000000.0,USA,2,5,408,10938,11346,1
Software,500000.0,USA,1,1,0,13312,13312,0
Consulting,55000000.0,USA,1,1,0,16576,16576,0
Cloud Computing|Cloud Management|Enterprise Software|IaaS,62100000.0,USA,5,8,2556,13192,15748,0
Accounting|Legal|Licensing|Music|Publishing|Transaction Processing,1500000.0,USA,1,1,0,14482,14482,1
B2B|E-Commerce|Messaging|Music|Weddings,600000.0,ISR,1,1,0,15706,15706,0
Mobile,9491200.0,FIN,2,3,1223,14616,15839,0
Public Relations|Telecommunications,6000000.0,USA,1,2,0,12969,12969,1
Energy|Software,3000000.0,USA,1,3,0,16225,16225,0
Health and Wellness|Health Care Information Technology|Hospitals,1425700.0,USA,3,2,986,15568,16554,0
Enterprise Software,25000003.0,USA,2,1,1420,14425,15845,0
Biotechnology|Technology,57500000.0,USA,2,5,961,11323,12284,0
Biotechnology,4700000.0,USA,1,1,0,13102,13102,0
Developer APIs|Developer Tools|Mobile|SaaS,35000.0,GBR,3,2,1036,15400,16436,0
Software,1900000.0,USA,3,12,343,15498,15841,1
Business Travelers|Logistics|Telecommunications|Travel,58653.0,LVA,1,1,0,16450,16450,0
Communications Hardware|Messaging|Mobile|Office Space|Technology|VoIP,50250000.0,USA,6,18,2136,13529,15665,1
Apps|Mobile|Tablets|Telecommunications|VoIP,3000000.0,NLD,2,3,130,15910,16040,0
Software,46667457.0,USA,5,5,1539,13412,14951,1
Communications Hardware|CRM|Customer Service|Network Security|SaaS|Small and Medium Businesses|Software,300000.0,USA,2,2,0,15309,15309,0
Fashion|Jewelry|Wearables,6100000.0,USA,2,14,517,15939,16456,0
Internet,55000.0,GBR,1,3,0,16191,16191,0
Apps,200000.0,USA,3,4,335,16289,16624,0
Software,4000000.0,USA,1,1,0,13216,13216,0
Cloud Computing|Communications Hardware,577797.0,ITA,3,3,335,15675,16010,0
Consumer Electronics|Enterprise Software|Guides|Video|Video Streaming,1040000.0,USA,2,1,391,14944,15335,0
Hardware + Software,14000000.0,USA,3,3,660,15986,16646,0
Consumer Internet|Marketplaces,3500000.0,USA,1,19,0,16595,16595,0
Games,15000000.0,USA,2,6,426,14070,14496,1
Automotive|Bicycles|Price Comparison,66047.0,ITA,1,1,0,15911,15911,0
Software,36500000.0,USA,5,15,1316,13472,14788,0
Creative|Creative Industries|Digital Media,78500.0,USA,2,1,313,15561,15874,0
Bitcoin|E-Commerce|Finance Technology|Financial Exchanges|Financial Services|FinTech|Payments|Virtual Currency,38600000.0,USA,6,28,1099,15615,16714,0
Software,540000.0,USA,1,1,0,11473,11473,1
Advertising|News,26000000.0,USA,4,7,814,13514,14328,1
Advertising,20000.0,USA,1,1,0,14730,14730,0
Distribution|Games|Publishing,1016395.0,GBR,1,1,0,15328,15328,0
Defense|Design|Security,23000000.0,USA,1,2,0,11253,11253,1
Analytics|Big Data,3200000.0,USA,2,1,491,16279,16770,0
Banking|Cryptocurrency|E-Commerce|Payments,50000.0,GBR,2,1,142,16365,16507,0
Marketplaces|Mobile|Personal Health,2300000.0,USA,1,8,0,15994,15994,0
Clean Technology,19024390.0,CHN,1,1,0,14092,14092,0
Enterprise Software,23600000.0,USA,5,8,1892,14222,16114,1
Social Network Media,30000.0,ARE,1,1,0,16467,16467,0
Minerals,150000.0,IND,1,1,0,16161,16161,0
Security,1000000.0,CHN,2,2,3957,10957,14914,0
SaaS|Security|Software,10250000.0,USA,3,10,1348,15009,16357,0
Software,8200000.0,USA,1,3,0,12926,12926,0
E-Commerce|Fraud Detection,5650000.0,ISR,2,9,208,15894,16102,0
Cyber Security|Mobile Security|Reputation,35000000.0,USA,2,3,315,15904,16219,0
Enterprise Software,10000000.0,USA,1,1,0,15860,15860,0
Big Data|Risk Management|SaaS|Supply Chain Management,2527500.0,USA,4,10,2458,13726,16184,0
E-Commerce,3516137.0,ITA,4,6,1145,15250,16395,0
Health Care Information Technology|Medical|Medical Devices,9000000.0,USA,1,1,0,12080,12080,1
E-Commerce|Jewelry,15000000.0,USA,1,1,0,15624,15624,0
Broadcasting|Data Visualization|Quantitative Marketing|SaaS|Search|SEO|Social Media|Social Media Management|Social Media Marketing|Social Media Monitoring|Startups,3000.0,CZE,1,2,0,15371,15371,0
Sensors|Wearables,3650000.0,USA,2,16,278,16338,16616,0
Audio,10000000.0,USA,1,2,0,16630,16630,0
Games,595672.0,GBR,1,1,0,13656,13656,0
Analytics|Internet Marketing|Software,1930000.0,USA,4,9,667,15720,16387,0
Health and Wellness,3130000.0,USA,2,1,1374,14559,15933,0
B2B|Internet|SaaS|Sales Automation,550000.0,USA,1,2,0,16262,16262,0
Health Care,50000.0,USA,1,2,0,15348,15348,0
Clean Technology,84438187.0,USA,5,15,3010,13741,16751,0
Education,650000.0,USA,1,4,0,14766,14766,0
Specialty Foods,1675621.0,GBR,1,1,0,16222,16222,0
Software,28300000.0,USA,3,3,782,15686,16468,0
Communications Hardware|Software|Technology,28400000.0,USA,4,12,2272,10877,13149,1
Health Care,33620000.0,USA,1,1,0,15712,15712,0
Software,6400000.0,USA,2,7,350,13549,13899,0
Cloud Computing|Data Center Automation|SaaS|Virtualization,34300000.0,USA,4,2,883,15414,16297,0
Software,23700000.0,USA,3,11,1337,12934,14271,1
Software,6000000.0,USA,1,2,0,12989,12989,0
Energy|Energy Management|Oil & Gas,125000000.0,USA,1,1,0,16182,16182,0
Hardware + Software|Telecommunications|Video,1500000.0,IND,1,1,0,16405,16405,0
Clean Technology,28160000.0,USA,3,3,1975,14194,16169,0
Apps,3600000.0,USA,2,7,287,16302,16589,0
E-Commerce,2350000.0,USA,2,4,575,15162,15737,0
Apps|Career Management|Cloud Computing|Enterprise Software|Human Resources|Recruiting|SaaS|Software,4000000.0,USA,2,2,91,15923,16014,0
Enterprise Software|Video,33076264.0,USA,3,8,941,13577,14518,1
Games,1265000.0,USA,2,8,234,14396,14630,0
Software,5085000.0,USA,4,2,1079,15109,16188,0
Analytics|Business Intelligence|SaaS|Software,23950000.0,USA,3,12,986,15342,16328,0
Software,10000000.0,CHN,1,1,0,15584,15584,0
Hardware + Software,21100000.0,USA,2,13,301,12556,12857,1
Infrastructure|Semiconductors|Wireless,20000000.0,USA,1,5,0,13243,13243,1
E-Commerce,7000000.0,USA,1,2,0,14278,14278,1
Design|Networking|Telecommunications,4750000.0,USA,1,1,0,13908,13908,0
Crowdsourcing|Internet|Shipping|Software,10000000.0,USA,2,5,564,15898,16462,0
Delivery,21000000.0,IND,3,6,127,16607,16734,0
Cars|Online Shopping,1800000.0,USA,3,5,207,16283,16490,0
Travel,3170000.0,USA,4,11,773,15156,15929,0
Big Data Analytics|Business Intelligence|Life Sciences|Machine Learning|Startups,11339998.0,USA,2,12,552,16065,16617,0
Consumers|Games,1000000.0,TWN,2,6,361,15712,16073,0
Mobile,41500000.0,USA,2,3,827,14571,15398,0
Android|Apps|E-Commerce|iOS|iPhone|Mobile|Startups|Telecommunications|Tourism|Travel|Travel & Tourism|VoIP,2850000.0,LVA,3,1,221,16059,16280,0
Artificial Intelligence|Robotics|Smart Building,4139999.0,AUT,1,3,0,16182,16182,0
Hardware|Hardware + Software|Health Care|Medical|Robotics,50000.0,USA,1,1,0,15887,15887,0
Hospitality|Manufacturing|Retail,50000.0,USA,1,2,0,16460,16460,0
Customer Service|E-Commerce|Email|Social Media|Tech Field Support|Twitter Applications,2500000.0,NLD,2,2,797,15279,16076,0
Software,740000.0,USA,2,4,745,15138,15883,0
Big Data Analytics|Enterprise Software|Startups,21700000.0,USA,3,7,644,16070,16714,0
Educational Games|Games|Online Gaming,7235000.0,USA,2,4,669,14470,15139,0
Kids,246000.0,AUT,2,2,434,16265,16699,0
Information Technology|Software,3670000.0,RUS,3,7,1143,15340,16483,0
Education|Electronics|Robotics,20000.0,RUS,1,1,0,15414,15414,0
Curated Web|Stock Exchanges|Trading,125000.0,USA,1,3,0,15631,15631,0
Online Education,10000000.0,CHN,1,1,0,16546,16546,0
Apps|Mobile|Software,250000.0,USA,1,1,0,15685,15685,0
Artificial Intelligence|Robotics,250000.0,USA,1,8,0,16071,16071,0
Hardware + Software|Robotics,25224241.0,USA,4,1,1164,14622,15786,0
Games,12000000.0,USA,2,2,624,13514,14138,0
Education|Machine Learning|Robotics,155000.0,RUS,1,1,0,15918,15918,0
Mobile,2000000.0,USA,1,1,0,14217,14217,0
Big Data|Databases|Information Technology,19400000.0,USA,2,7,322,16233,16555,0
Biotechnology,12750000.0,USA,1,4,0,12724,12724,0
Advertising|Internet Marketing|Media,1375000.0,BRA,4,9,291,15535,15826,0
Entertainment|Games|Music|Television|Video,29833.0,GBR,1,1,0,14669,14669,0
Software,2000000.0,RUS,1,1,0,14933,14933,0
Apps|Health and Wellness|Health Care|Mobile|Startups|Venture Capital,5000000.0,USA,3,10,514,14978,15492,0
Algorithms|Apps|Fitness|Music|Sensors|Sports|Technology,1390000.0,USA,5,5,761,15826,16587,0
Games|Mobile|Publishing|Soccer|Sports,25000.0,ARG,2,2,92,15461,15553,0
Education|Publishing,60385.0,EST,2,2,479,15561,16040,0
Advertising Platforms|Content|Video,10243467.0,GBR,2,9,681,16007,16688,0
Curated Web|Event Management|Events|Promotional|Sales and Marketing|Ticketing,100793.0,BRA,2,1,152,15309,15461,0
Advertising,540000.0,USA,2,9,271,15859,16130,0
Big Data|Big Data Analytics|Credit|Credit Cards|Disruptive Models|Finance|Finance Technology|FinTech|Lead Generation|Machine Learning|Personal Finance|Wealth Management,800000.0,MEX,2,7,151,15979,16130,0
Ad Targeting|Advertising|Software,76600000.0,USA,5,22,1427,14092,15519,1
Internet|Software,1119500000.0,DEU,4,4,377,16102,16479,1
Internet|Music|Wireless,10300000.0,USA,1,6,0,11323,11323,0
Brand Marketing|Cause Marketing|Mobile Advertising|SMS,15000.0,USA,1,2,0,15924,15924,0
Legal,40000.0,USA,1,1,0,14933,14933,0
Games,65084.0,JPN,1,1,0,15267,15267,0
Banking|Finance|Mobile,2000000.0,RUS,2,2,429,15980,16409,0
Sales and Marketing,50000.0,USA,1,1,0,15945,15945,0
News,1500000.0,USA,1,1,0,14610,14610,0
Analytics|Big Data|Cloud Data Services|Data Visualization,500000.0,GRC,1,1,0,16420,16420,0
Hardware + Software,5500000.0,ISR,2,3,876,15124,16000,0
Legal,46150818.0,USA,4,11,1586,14252,15838,0
E-Commerce|Hotels|Online Travel|Travel,8500000.0,USA,2,8,275,15824,16099,1
Software,6300000.0,USA,2,3,154,13756,13910,0
Facebook Applications|Games|Social Games,1521084.0,KOR,3,3,672,14944,15616,0
Enterprise Software|Internet|Online Travel|SaaS,8175000.0,USA,4,9,799,15889,16688,0
Education,3300000.0,USA,4,3,731,14958,15689,0
Logistics|Supply Chain Management,75116.2423850909,SGP,1,1,0,16566,16566,0
Audio|Consumer Electronics|Music|Music Services,915000.0,USA,3,2,392,16034,16426,0
Education|Tutoring,500000.0,VNM,1,4,0,16331,16331,0
Browser Extensions|Facebook Applications|Social Media,39875000.0,USA,3,16,860,14294,15154,1
News,2037750.0,ESP,1,2,0,14711,14711,0
Photography,2000000.0,GBR,1,7,0,15584,15584,0
Fashion,1500000.0,USA,2,5,396,15721,16117,0
Mobile,6700000.0,SWE,1,3,0,12794,12794,1
Biotechnology,35000000.0,USA,2,1,484,15874,16358,1
Facebook Applications|Games|Messaging|Mobile|Online Gaming|Online Video Advertising|Web Tools,172725336.0,USA,12,19,3227,13269,16496,0
Software|Wireless,2800000.0,IRL,2,2,2708,11537,14245,0
Advertising|Advertising Platforms|Analytics|Automotive,1000000.0,BRA,1,3,0,16222,16222,0
Hospitality|Online Reservations,720480.0,NLD,1,1,0,13088,13088,0
Biotechnology,12900000.0,USA,2,4,336,15883,16219,0
Biotechnology,3413540.0,DEU,2,4,1441,14371,15812,0
Civil Engineers|Consulting|Engineering Firms|Innovation Engineering,415013.0,GBR,1,1,0,16315,16315,0
Software,23000000.0,USA,2,4,504,13577,14081,1
Biotechnology,1000000.0,USA,2,2,363,14786,15149,0
Professional Services|Recruiting|Social Recruiting|Software,3100000.0,USA,2,6,578,16143,16721,0
Biotechnology,109496656.0,USA,4,8,861,15183,16044,1
Startups|Venture Capital,5000000.0,USA,1,4,0,16630,16630,0
Advertising|Advertising Platforms|B2B|E-Commerce,8000000.0,SGP,1,4,0,16035,16035,0
Consumer Electronics|Entertainment|Hardware + Software,153100000.0,USA,8,16,2486,13879,16365,0
Software,5000000.0,USA,1,25,0,15706,15706,0
Content Creators|Hardware|Hardware + Software|Music,16500000.0,GBR,2,9,140,16212,16352,0
Nanotechnology|Solar,5700000.0,USA,2,2,613,14822,15435,0
Software,18000.0,NZL,1,1,0,15765,15765,0
Manufacturing,520000.0,USA,1,3,0,16282,16282,0
Restaurants,151000.0,IND,1,6,0,16675,16675,0
SaaS|Software,1350000.0,USA,2,3,700,15187,15887,0
Retail,446534.0,GBR,1,1,0,16314,16314,0
Analytics|Developer Tools|SaaS,435000.0,USA,2,4,212,15584,15796,0
Mobile|Networking,1000000.0,USA,1,2,0,14610,14610,1
Design|Mobility|Technology,336055.0,GBR,1,1,0,16230,16230,0
Moneymaking|Online Travel|Travel,40000.0,USA,1,1,0,16440,16440,0
Information Technology,670000.0,USA,1,2,0,16495,16495,0
Apps|Internet|Mobile,2000000.0,ISR,1,3,0,16720,16720,0
Automotive|B2B|Enterprises|Finance|Mobile|Social Media|Wholesale,150000.0,USA,2,1,290,15187,15477,0
Enterprises|Enterprise Software,7500000.0,USA,3,4,1078,13123,14201,1
Entertainment|Mobile|Social Games|Sports|Startups,3100000.0,USA,2,2,888,15636,16524,0
Advertising,1400000.0,GBR,1,2,0,15539,15539,0
Software,14000000.0,USA,1,2,0,13230,13230,1
Maps|Search|Travel,2732790.0,AUS,4,10,766,15488,16254,0
Innovation Engineering|Optimization|Services,5.0,DEU,1,1,0,15821,15821,0
Electronics|Hardware + Software|iPhone|Robotics|Software|Toys,12114796.0,USA,6,15,820,15279,16099,0
Finance,260000000.0,CHN,5,14,1380,15340,16720,0
E-Commerce,3000000.0,USA,1,5,0,16624,16624,0
Security,3500000.0,ISR,1,1,0,13738,13738,1
Audio|Content|Content Syndication|Distribution|Entertainment|Licensing|Media|Music|News|Product Development Services|Video,2500000.0,USA,1,1,0,13634,13634,1
Advertising|Internet Marketing|Software,600000.0,ISR,1,2,0,16133,16133,0
Analytics|Lead Management|Real Estate,999100.0,USA,2,1,402,16166,16568,0
Hospitality|Internet|Search,1100000.0,USA,1,2,0,16631,16631,0
Peer-to-Peer|Travel,166396.0,IND,1,1,0,16267,16267,0
Hospitality|Hotels|Travel,43800000.0,USA,3,19,1098,14610,15708,0
Interior Design|Online Shopping,25000.0,USA,1,1,0,16363,16363,0
Information Technology,2000000.0,IND,1,0,0,16683,16683,0
Photography,1100000.0,JPN,2,3,689,15279,15968,0
All Markets|E-Commerce|Hotels|Marketplaces|Travel,7000000.0,USA,2,1,634,15765,16399,0
Apps|iOS|Location Based Services|Marketplaces|Mobile|Online Rental|Real Estate,2660000.0,USA,2,12,160,16435,16595,0
Consumer Goods|Educational Games|Kids|Toys,3000000.0,USA,2,8,379,16314,16693,0
Travel,30000.0,CAN,1,1,0,15614,15614,0
3D|Advertising|Architecture|Augmented Reality|E-Commerce|Furniture|Interior Design|Online Shopping|Real Estate,1340440.0,AUT,1,2,0,16283,16283,0
Marketplaces|Retail|Search,25000.0,USA,1,1,0,15380,15380,0
Hotels|Online Rental|Peer-to-Peer|Travel,2300000.0,USA,3,5,426,15006,15432,0
Local Based Services|Real Estate|Storage,13500000.0,USA,2,7,708,13514,14222,1
Storage,212000.0,USA,1,2,0,16617,16617,0
Technology,500000.0,USA,1,3,0,16723,16723,0
Crowdsourcing|Mobile|Wireless,5893063.0,USA,4,4,882,14286,15168,0
Information Technology|Predictive Analytics|Services|Software,1000000.0,USA,2,5,33,15780,15813,0
Software|Transportation,50000.0,USA,1,1,0,15706,15706,0
Apps|Big Data|Curated Web|Media|Mobile|Retail|SaaS|Social Media,2965000.0,USA,3,2,741,16010,16751,0
Software,8534999.0,GBR,5,2,1666,14679,16345,0
Fashion,3400000.0,USA,1,2,0,16682,16682,0
Cloud Computing|Games|Home & Garden|SaaS|Software,1397531.0,DNK,3,4,743,14858,15601,0
E-Commerce|Fashion,21000000.0,IND,3,4,405,16259,16664,0
Advertising|Mobile|Music|SaaS|Small and Medium Businesses,2400000.0,USA,3,15,1214,15095,16309,0
E-Commerce|Entertainment|Media|Online Shopping,1100000.0,USA,1,2,0,15614,15614,0
Entertainment|Mobile|Music|Video Streaming,350000.0,GBR,1,3,0,16149,16149,0
Technology,50000.0,USA,1,1,0,16328,16328,0
E-Commerce|Online Shopping|Retail|Shopping,10000.0,IND,1,1,0,16013,16013,0
Clean Technology,1040000.0,IND,1,1,0,13979,13979,0
Analytics|Business Intelligence|Cloud Computing|Data Visualization|Enterprise Software|SaaS,4782028.0,USA,3,2,1410,14640,16050,0
Mobile,237000000.0,RUS,1,2,0,15989,15989,0
Games|Health and Wellness|Online Scheduling|Sports,1000000.0,CAN,1,2,0,16197,16197,0
Software,12032658.1910449,GBR,15,23,3528,12804,16332,0
Health and Wellness|Mobile|Software|Sports|Technology,50000.0,USA,1,2,0,15946,15946,0
Gps|Navigation|Public Transportation,31000000.0,USA,4,11,1796,12188,13984,0
Education,26720000.0,USA,4,1,517,15985,16502,0
Hardware + Software,46580744.0,USA,4,3,1567,14686,16253,0
Sports,8000000.0,USA,2,7,587,13726,14313,0
Games,1010000.0,USA,1,2,0,11048,11048,0
Beauty|Cosmetics|E-Commerce|Video on Demand,182000.0,IRL,2,5,249,16164,16413,0
Human Resources|Recruiting,1000000.0,IND,1,2,0,16514,16514,0
Internet|Software,10000000.0,USA,1,2,0,11086,11086,1
Mobile|Software,43000000.0,USA,3,11,1201,13027,14228,0
Photography,3000000.0,USA,1,1,0,16486,16486,0
Advertising|Brand Marketing|Celebrity|Reviews and Recommendations|Social Network Media,40000.0,USA,1,1,0,15380,15380,0
Chat|Entertainment|Video Chat,17000000.0,ISR,5,11,2539,13910,16449,0
Fashion|Lifestyle|Mobile,343500.0,USA,2,2,192,16183,16375,0
Computers|Networking,30500000.0,USA,1,1,0,11666,11666,0
Enterprise Software,25000.0,CAN,1,1,0,16083,16083,0
Delivery|Services,118000.0,CAN,1,1,0,16622,16622,0
Cooking|Curated Web|Recipes|Video,5835015.0,CAN,5,3,2357,13149,15506,0
Local Businesses|Location Based Services|Retail|Shopping|Sports Stadiums,1000000.0,CAN,4,1,368,16116,16484,0
Marketplaces|Peer-to-Peer|Pets|Startups,50900000.0,USA,6,21,1074,15439,16513,0
Advertising|Colleges|Coupons|Discounts|Loyalty Programs|Mobile|Universities,1575000.0,USA,6,13,799,15706,16505,0
Web Hosting,15500000.0,USA,2,10,371,12423,12794,1
Games|Mobile Games,76075497.0,FIN,2,4,1184,15043,16227,0
Manufacturing,15750759.0,GBR,2,2,1013,15558,16571,0
Apps|Software|Software Compliance,12000000.0,HKG,2,1,76,16149,16225,0
Web Hosting,103000000.0,USA,3,4,1483,14019,15502,0
Education,1750000.0,USA,1,1,0,16633,16633,0
Health Care,10000000.0,USA,2,2,412,15177,15589,0
Finance|Location Based Services|Mobile,2590899.0,USA,6,3,930,15477,16407,0
Biotechnology,42700000.0,USA,1,3,0,13676,13676,0
Health Care|Health Services Industry|Tourism|Travel & Tourism,68856.0,ARE,2,2,424,15706,16130,0
Games|Mobile Games|Social Games,658585.0,FRA,1,1,0,15418,15418,0
Games,11500000.0,USA,4,5,743,13360,14103,0
Career Management|Employment,6500000.0,PAK,1,2,0,16576,16576,0
Information Technology|SaaS|Services,854551.2995283691,FRA,1,2,0,16427,16427,0
Cloud Computing|Enterprise Software|SaaS|Virtualization,32500000.0,USA,4,11,1732,13172,14904,0
Hardware + Software,44000000.0,USA,3,9,1693,13172,14865,0
Legal|Software,5829035.0,USA,3,1,2122,14245,16367,0
Biotechnology,7000000.0,USA,1,2,0,15006,15006,0
Enterprise Software|Telecommunications,37400000.0,ISR,2,8,368,15802,16170,1
Computers|Risk Management|Software,32000000.0,USA,1,1,0,16518,16518,0
Software,2300000.0,USA,2,2,776,14014,14790,0
Security|Video|Wireless,9453766.0,USA,1,3,0,13917,13917,0
Hardware + Software,1030000.0,DEU,1,1,0,13390,13390,0
Education|Open Source|SaaS|Software,14272148.0,USA,2,2,321,15247,15568,0
Software,120000.0,USA,2,1,215,15652,15867,0
Assisted Living|Elder Care|Health and Wellness|Information Services,100000.0,USA,2,2,44,16104,16148,0
Analytics|Cloud Computing|Internet of Things|SaaS|Software,3750000.0,CAN,2,2,1029,15461,16490,0
E-Commerce|Education|Health and Wellness|Humanitarian|SexTech,25000.0,MEX,1,1,0,15623,15623,0
Biotechnology,5500000.0,USA,2,5,4670,11961,16631,0
Technology,85000000.0,USA,3,24,1145,15551,16696,0
Network Security|Software,11000000.0,USA,4,5,1006,15527,16533,0
Health Care|Health Care Information Technology|Mobile Health,1300000.0,USA,1,2,0,16426,16426,0
Advertising|Media|Optimization|Software,60000000.0,USA,7,20,1127,13787,14914,1
Human Resources|Recruiting|Services,595495.0,AUS,1,1,0,16510,16510,0
Health Care|Medical|Medical Devices,10000000.0,USA,1,3,0,13753,13753,0
Analytics|Big Data|Big Data Analytics|Cloud Data Services|Retail Technology,8500000.0,CAN,2,5,427,16027,16454,0
Software,51000000.0,USA,2,3,63,16518,16581,0
Public Relations,38800000.0,USA,1,2,0,16441,16441,0
Fashion,19000000.0,USA,3,7,1300,15461,16761,0
Health and Wellness,150000.0,USA,1,2,0,15664,15664,0
EdTech|Education|Games|Mobile|Textbooks,3500000.0,USA,1,1,0,15036,15036,0
Communications Hardware|Mobile|Wireless,70946214.0,USA,5,24,1963,13434,15397,1
Finance,2000000.0,USA,1,1,0,13893,13893,0
News,2720070.0,FRA,2,3,613,14055,14668,0
Consulting,55000000.0,USA,2,3,1409,14447,15856,0
Hospitality,1600000.0,GBR,1,3,0,16001,16001,0
Biotechnology,19000000.0,USA,2,8,76,16156,16232,0
CRM|Enterprise Software|Project Management|SaaS,500000.0,USA,1,1,0,15082,15082,0
Biotechnology,25000000.0,USA,1,3,0,13801,13801,1
Games,45500000.0,USA,4,8,1538,15126,16664,0
E-Commerce|Marketplaces|Mobile|Social Media,500000.0,USA,1,4,0,15371,15371,1
Algorithms|Big Data|Consumers|Curated Web|E-Commerce|Mobile|Predictive Analytics|Reviews and Recommendations|Tracking,800000.0,GBR,1,1,0,14763,14763,0
Chat|Identity|Messaging,2580000.0,USA,2,2,689,16010,16699,0
Advertising|Auctions,1500000.0,USA,1,1,0,15918,15918,0
Fitness|Games|Health and Wellness|Mobile Games|Social Games,100000.0,GBR,1,1,0,16420,16420,0
Health Services Industry|Medical Devices|Personal Health,200011.0,USA,2,2,365,15692,16057,0
Advertising,10200000.0,USA,2,4,809,14837,15646,1
Food Processing,5750000.0,USA,1,1,0,16357,16357,0
Advertising|Analytics|Big Data|Predictive Analytics|SaaS|Social Media,200000.0,USA,1,2,0,15901,15901,0
Android|Mobile|Video,300000.0,UKR,1,1,0,15531,15531,0
Games,7000000.0,USA,2,2,226,14544,14770,0
Business Development|Cloud Computing|Enterprise Software|Google Apps|PaaS|SaaS,2200000.0,FRA,1,1,0,14802,14802,1
Software,2000000.0,USA,2,7,212,15796,16008,0
Crowdsourcing|Postal and Courier Services|Software,50000.0,USA,1,1,0,15934,15934,0
Advertising|Fitness|Social Network Media|Sports,13700.0,ESP,1,1,0,16209,16209,0
Health and Wellness,28433.0,GBR,1,1,0,16130,16130,0
Collaboration|Productivity Software|Project Management|Software|Task Management,1500000.0,BRA,2,2,156,15553,15709,0
Application Performance Monitoring|Cloud Infrastructure|Developer APIs|Developer Tools|Enterprise Software,7100000.0,USA,2,11,323,15847,16170,0
Events|Promotional|Racing,300000.0,USA,2,2,730,14610,15340,0
Android|Exercise|Fitness|Gps|Health and Wellness|iPhone|Mobile|Nutrition|Social Network Media|Sports|Startups|Technology|Tracking,214185.0,AUT,3,2,833,14628,15461,1
Big Data Analytics|Fitness|Health and Wellness|Internet of Things|Sports|Training,364214.0,FIN,5,3,975,15430,16405,0
Curated Web,12000000.0,USA,3,5,953,15757,16710,0
Games|Social Network Media,3000000.0,USA,1,6,0,13695,13695,1
Cloud Computing|Cloud Data Services|Domains|Internet|Networking|Services|Web Design|Web Development|Web Hosting,569.0,IND,1,1,0,15995,15995,0
Real Estate,2300000.0,CAN,3,2,603,16076,16679,0
B2B|Blogging Platforms|Business Services|Consulting|Curated Web|Databases|Entrepreneur|Event Management|Guides|Investment Management|Media|Service Providers|Startups|Venture Capital,400000.0,RUS,2,2,975,15400,16375,0
Music,2706060.0,GBR,4,4,638,15584,16222,0
Education|Innovation Management|New Technologies,6700000.0,RUS,1,1,0,15490,15490,0
Financial Services|Infrastructure|Investment Management|Telecommunications,100000000.0,RUS,1,2,0,15399,15399,0
Food Processing|Organic Food,1500000.0,USA,1,1,0,13781,13781,0
Public Transportation,126619.0,MEX,3,3,106,15340,15446,0
E-Commerce,4242704.0,GBR,1,1,0,16146,16146,0
Biotechnology|Medical|Pharmaceuticals,5200000.0,USA,1,1,0,12626,12626,0
EdTech|Education,50000.0,USA,1,1,0,15418,15418,0
Clean Technology,997917.0,PRT,2,6,305,14882,15187,0
Fitness|Health and Wellness|Health Care Information Technology|Internet,1000000.0,USA,1,1,0,13787,13787,0
Software,2530000.0,FRA,1,1,0,13270,13270,0
Clean Technology,2280000.0,FRA,1,1,0,13937,13937,0
Education|Training,540000.0,SAU,1,2,0,15796,15796,0
Software,5944350.0,CAN,3,5,1187,13636,14823,0
Health Care,4612000.0,USA,2,2,0,15595,15595,0
Health and Wellness,20000.0,USA,1,1,0,15492,15492,0
Health and Wellness,500000.0,USA,1,1,0,16611,16611,0
Digital Media|Medical|Therapeutics,5000000.0,USA,1,4,0,11527,11527,0
Biotechnology,20300000.0,USA,2,1,566,15618,16184,1
Biotechnology,4150000.0,USA,2,2,1630,14687,16317,0
Health and Wellness,1760000.0,USA,4,2,404,16130,16534,0
Enterprise Software|Pharmaceuticals,2750000.0,USA,2,3,1460,13879,15339,0
Health and Wellness|Health Care|Mobile|Mobile Health,10000.0,IND,1,1,0,15887,15887,0
Consulting,370000000.0,USA,2,3,951,15712,16663,0
Oil and Gas|Service Providers|Storage,110000000.0,USA,1,2,0,16387,16387,0
Health Care|Services,3738338.0,GBR,1,1,0,16240,16240,0
E-Commerce,9120018.0,USA,2,1,841,13628,14469,1
Business Services|Software,10000000.0,CAN,2,3,1017,13089,14106,0
Clean Technology,11150000.0,USA,2,1,507,14547,15054,0
Collaboration|Human Resources|Lead Management|Productivity Software|Reviews and Recommendations|Software|Teachers|Weddings,13000000.0,CAN,3,6,881,14000,14881,1
Facebook Applications|Gambling|Game|Games|Social Media,4678000.0,USA,4,1,955,14547,15502,0
Biotechnology,143500000.0,SGP,3,8,703,14172,14875,0
Education,27000000.0,IND,1,2,0,16763,16763,0
Industrial Automation|Services|Software,1000000.0,IND,1,1,0,16725,16725,0
Software,41475.0,CYP,1,1,0,15034,15034,0
Health Care,3000000.0,USA,1,1,0,15364,15364,0
Clean Technology,1600000.0,USA,1,1,0,14984,14984,0
Android|Apps|iOS|Software,150000.0,AUS,1,1,0,15835,15835,0
Medical Devices,375000.0,USA,1,2,0,15492,15492,0
Data Integration|Hardware,4600000.0,USA,1,2,0,16357,16357,0
Mining Technologies|Natural Resources|Renewable Energies,1875000.0,USA,1,1,0,16105,16105,0
Clean Technology,250000.0,USA,1,1,0,15562,15562,0
Advertising|Mobile,8000000.0,FRA,1,2,0,16590,16590,0
Semiconductors,14000000.0,USA,2,3,573,12832,13405,1
Analytics|Big Data|Business Intelligence|Consulting,35000000.0,USA,1,1,0,16588,16588,0
Business Services|SaaS|Security|Software,121372.0,GBR,2,2,457,15826,16283,0
Enterprise Software,2010000.0,GBR,2,2,652,14535,15187,1
Curated Web,11150004.0,USA,3,3,998,14813,15811,1
Entertainment Industry|Internet|Mobile|Music|Video Streaming,110000000.0,USA,3,8,2378,14245,16623,0
Health Care,500000.0,USA,2,4,777,14074,14851,1
Business Productivity|EdTech|Enterprise Software|Knowledge Management|Online Education|SaaS,626418.520199728,PRT,1,2,0,16224,16224,0
Consulting|Human Resources|Predictive Analytics|Recruiting,1200000.0,GBR,2,1,304,15954,16258,0
Social Network Media|Software,133637.0,BRA,2,2,6,16155,16161,0
Analytics,380000.0,USA,2,1,44,15573,15617,0
Biotechnology|Health Diagnostics,6539000.0,ESP,1,2,0,14868,14868,0
Software,1307485.0,DEU,2,4,391,15861,16252,0
Enterprise Software,27200000.0,USA,3,7,1628,12006,13634,1
Biotechnology|Environmental Innovation|Oil|Waste Management,515223.0,CAN,2,4,891,15584,16475,0
Real Estate,31000000.0,IND,1,6,0,16678,16678,1
Curated Web|E-Commerce|Transportation,20323.0,NLD,1,1,0,15991,15991,0
Health Care,62000000.0,USA,4,15,2287,12586,14873,1
Health and Wellness|Health Care|Medical|Pharmaceuticals,30000000.0,USA,1,6,0,12373,12373,0
Travel,25000.0,KEN,1,1,0,15675,15675,0
Moneymaking,1200000.0,USA,1,5,0,16707,16707,0
Diagnostics|Water|Water Purification,700000.0,USA,1,3,0,16071,16071,0
Security,9100000.0,DEU,1,2,0,12816,12816,0
Curated Web,629000.0,USA,2,6,523,15273,15796,0
Enterprise Software,5000000.0,USA,1,1,0,14844,14844,0
Network Security,4000000.0,USA,1,2,0,16624,16624,0
Non Profit|Service Providers|Training,25000.0,USA,1,1,0,15449,15449,0
Apps|Internet|Real Time|Security,2250000.0,ISR,1,1,0,16756,16756,0
Software,9500000.0,USA,2,5,1886,10917,12803,0
Health and Wellness|Health Care|Hospitals,40000.0,CHL,1,1,0,16222,16222,0
Finance,968000.0,SWE,3,5,399,16118,16517,0
Apps,131000.0,RWA,2,2,304,16420,16724,0
Enterprise Software,16400000.0,ISR,3,7,1076,12852,13928,1
Mobile,6240000.0,ARG,4,9,537,15218,15755,0
Delivery|Internet|Storage,40000.0,CHL,1,1,0,16222,16222,0
Business Services|Data Security|Enterprises|Information Security|Productivity Software|Security|Software,2500000.0,CZE,1,1,0,16415,16415,0
Security,4660000.0,SWE,1,1,0,14120,14120,0
Chemicals|Construction|Infrastructure|Oil & Gas|Utilities|Water,38126.0,AUS,1,2,0,16526,16526,0
Education|Training,260000.0,USA,1,1,0,14488,14488,1
E-Commerce|SaaS,11200000.0,AUS,3,4,664,16036,16700,0
E-Commerce|Payments,14100661.0,USA,3,2,1803,14098,15901,0
Enterprise Software|Privacy|Security,8750000.0,USA,2,3,289,14488,14777,1
Security|Services|Startups,16000000.0,USA,1,5,0,12619,12619,1
Mobile Security|SaaS,88632.0,GBR,2,2,80,15979,16059,0
Innovation Management|Software|Wearables,11143.0,PHL,1,1,0,16591,16591,0
Software,7540888.0,USA,2,1,1388,14761,16149,1
Internet|Mobile|Telecommunications,30000000.0,USA,1,1,0,11991,11991,0
Biotechnology,93000000.0,GBR,3,8,877,15265,16142,1
Enterprise Software,13201789.0,USA,2,2,313,15554,15867,0
Education|Social Media|Training,850000.0,CAN,1,2,0,16100,16100,0
Business Intelligence,12000000.0,NGA,2,5,773,11046,11819,0
Biotechnology|Health Care,153000000.0,USA,4,3,924,13783,14707,1
Gps|Software,7720000.0,USA,3,5,863,13136,13999,0
Biotechnology,2000000.0,ESP,1,1,0,15177,15177,0
Security,580000.0,FRA,1,1,0,12821,12821,0
Manufacturing,315000000.0,CAN,1,2,0,15973,15973,0
Mobile,3200000.0,ISR,1,3,0,16481,16481,0
Food Processing,1600000.0,IND,1,1,0,16685,16685,0
Security,22000000.0,USA,1,1,0,14865,14865,1
Leisure|Tourism|Travel,1550000.0,CHE,2,2,795,15340,16135,0
Identity Management|Risk Management|Software,26078810.0,USA,6,13,3280,13149,16429,0
Adventure Travel|Boating Industry|Collaborative Consumption|Online Travel|Sailing Community|Social Travel|Tourism|Travel|Travel & Tourism|Vacation Rentals,804159.0,ITA,2,1,559,16060,16619,0
Ad Targeting|Analytics|Big Data|E-Commerce|Email|Email Marketing|Personalization|Public Relations,48000000.0,USA,4,23,1240,14816,16056,0
Software,14253858.0,USA,4,1,1009,15706,16715,0
Cloud Infrastructure|SaaS,20000.0,IND,1,1,0,16509,16509,0
Hardware + Software,50200000.0,USA,6,9,2264,14245,16509,1
Celebrity|Entertainment|Games|Interest Graph|Media|Politics|Social Media|Social Network Media|Sports|Virtual Currency,825000.0,USA,1,1,0,15901,15901,0
Biotechnology,47723399.0,USA,4,6,1250,14519,15769,0
Financial Services,6100000.0,GBR,1,1,0,16758,16758,0
Analytics|SaaS|Sales and Marketing|Software,5125000.0,USA,2,2,1130,15495,16625,0
Cloud Computing|Enterprise Software|WebOS,1445300.0,ESP,1,1,0,15155,15155,1
CRM,250000.0,SWE,1,1,0,16467,16467,0
Analytics,1400000.0,USA,1,6,0,14986,14986,1
Cloud Computing|Enterprises|Hardware + Software|Software,67910000.0,USA,3,9,644,10592,11236,1
Commercial Real Estate|CRM|Enterprise Software|Sales and Marketing|Software,31950000.0,USA,6,16,984,15771,16755,0
Advertising|Retail|Sales and Marketing|Shopping,1296406.0,GBR,2,2,772,15340,16112,0
B2B|Lead Generation|SaaS|Sales and Marketing|Sales Automation|Software,11218000.0,USA,4,7,1049,15477,16526,0
Software,16100000.0,USA,2,6,1099,11386,12485,0
E-Commerce,56479.0,ITA,1,2,0,16467,16467,0
B2B|Lead Generation|Lead Management|Online Shopping|Optimization|Sales and Marketing,55957.0,IRL,1,1,0,16495,16495,0
Enterprise Software,2195029.0,USA,3,4,1823,14761,16584,0
Enterprise Software,4935000.0,USA,2,4,273,14883,15156,0
Analytics|Predictive Analytics|SaaS,5099999.0,USA,2,7,264,15938,16202,0
Automotive|CRM|Enterprise Software|SaaS,290000.0,GBR,2,1,67,13939,14006,0
Business Development|Internet,100000.0,DNK,1,2,0,16648,16648,0
Finance|Financial Services|Internet,11200000.0,USA,2,2,361,11047,11408,0
Software,3000000.0,USA,1,1,0,16182,16182,0
Software,4800000.0,USA,5,6,1245,15371,16616,0
Sales and Marketing|Salesforce Killers,2500000.0,USA,1,2,0,16633,16633,0
Big Data|Business Intelligence|Cloud Computing|Crowdsourcing|Enterprise Software|Lead Generation|Predictive Analytics|SaaS|Sales and Marketing|Software,1929900.0,FRA,1,1,0,16121,16121,0
Big Data|Hospitality|Mobile,2000000.0,USA,1,6,0,16757,16757,0
Biotechnology,2000000.0,USA,2,2,566,14638,15204,0
Health Care,45000000.0,USA,2,14,2281,12335,14616,1
Curated Web,3377360.0,ESP,2,2,451,13802,14253,0
Networking,7000000.0,USA,1,4,0,11745,11745,0
E-Commerce|Online Shopping,50000.0,JOR,1,1,0,15384,15384,0
Beauty|Location Based Services|Online Reservations|SaaS|Software,407902.0,DEU,2,8,303,15737,16040,1
Advertising,3502000.0,USA,2,2,824,14468,15292,0
CRM|Nonprofits|Politics|SaaS|Software,12000000.0,USA,3,4,1033,15186,16219,0
Software,24600000.0,USA,2,5,662,15960,16622,0
Chat|Messaging|Services,3000000.0,GBR,1,2,0,16455,16455,0
Android|iPhone|Mobile,15000.0,USA,1,1,0,14092,14092,0
Online Shopping,65000000.0,SWE,2,4,218,16240,16458,0
Health and Wellness|Health Care|Medical|Medical Devices,10000000.0,AUS,1,1,0,16486,16486,0
Clean Technology,1586185.0,GBR,1,1,0,16384,16384,0
Health and Wellness|Physicians,1470436.0,ESP,2,4,213,15536,15749,1
Big Data|Big Data Analytics|Fraud Detection,7167668.0,GBR,1,1,0,16624,16624,0
Beauty|Internet|Online Scheduling,81462.0,BRA,1,1,0,16344,16344,0
Corporate IT|Customer Service|Enterprise Software|IT Management|SaaS|Software,24000000.0,USA,3,9,967,15608,16575,0
Fashion|Lifestyle|Shopping,100000.0,USA,1,1,0,14903,14903,0
Clean Technology,2715200.0,ITA,1,1,0,15296,15296,0
Crowdsourcing|Enterprises|Enterprise Software|Nonprofits|Outsourcing|Social Business|Startups,1507200.0,USA,12,12,1642,14123,15765,0
Advertising|Content Syndication|Technology|Video,1500000.0,BRA,2,8,791,15757,16548,0
Apps|Chat|Messaging|Mobile|Mobile Video|Social Media,1806000.0,GBR,3,7,1164,15279,16443,0
Advertising|Audio|Content Syndication|Digital Rights Management|Enterprise Software|Image Recognition|SaaS|Video|Video Streaming,3000000.0,BRA,1,2,0,14031,14031,0
Public Safety|Risk Management|SaaS|Software,16399999.0,USA,1,1,0,16351,16351,0
Advertising|Consumer Electronics|Social Television|Television|Video,8163000.0,USA,3,7,85,15377,15462,0
E-Commerce,24711702.0,USA,5,1,2176,14274,16450,0
Software,20000000.0,USA,1,4,0,11338,11338,0
Apps|Curated Web|Mobile|Social Media|Social + Mobile + Local|Social Search,1125000.0,USA,3,2,518,15614,16132,0
Browser Extensions|Search|Social Media|Software|Web Browsers,125000.0,USA,1,1,0,14457,14457,0
Finance,75000000.0,IND,1,1,0,15282,15282,0
Price Comparison,200000.0,DNK,1,1,0,16714,16714,0
Curated Web,1310000.0,USA,2,1,245,13726,13971,0
Mobile,250000.0,USA,1,1,0,15047,15047,0
Semiconductors,23000000.0,USA,6,7,1891,13149,15040,0
Biotechnology,2000000.0,CAN,1,1,0,14627,14627,0
Distribution|Green Consumer Goods|Innovation Management|Organic Food,98142.0,KOR,1,1,0,16307,16307,0
Sensors,25000000.0,USA,1,1,0,16574,16574,0
Security,22000000.0,USA,2,6,1174,12431,13605,1
Digital Media|EdTech|Education|Language Learning|Software,7800000.0,FIN,1,1,0,13885,13885,0
Health Care,47920000.0,USA,3,17,2037,11527,13564,0
Technology,20000000.0,USA,1,3,0,11196,11196,0
Mobile|Wireless,116568047.0,USA,11,27,2142,14004,16146,0
Gift Card|Messaging|Startups,25000.0,BRA,1,3,0,15309,15309,0
Industrial|Semiconductor Manufacturing Equipment|Semiconductors|Technology,42000000.0,USA,2,7,47,12186,12233,0
Data Integration|Manufacturing|Semiconductors,47000000.0,USA,2,9,757,11666,12423,1
Enterprise Software|Storage,46000000.0,USA,4,13,1322,13544,14866,1
Finance|Productivity Software|Software|Task Management,600000.0,CAN,2,1,133,15553,15686,0
Public Relations,5000000.0,USA,1,3,0,13164,13164,0
Software,23300000.0,USA,1,1,0,16321,16321,0
Diagnostics|Fertility|Health and Wellness,2605000.0,USA,4,8,507,15739,16246,0
Apps|Mobile|Security,1300000.0,USA,1,1,0,16450,16450,0
Nonprofits,6515581.0,GBR,1,1,0,15930,15930,0
Networking|Service Providers|Storage,100800000.0,USA,4,19,1035,11201,12236,1
Clean Energy|Clean Technology|Environmental Innovation|Renewable Energies,300000.0,KEN,3,3,951,15271,16222,0
Biotechnology,365872959.0,USA,6,3,1877,13607,15484,0
Real Estate,10000000.0,IND,1,1,0,16139,16139,0
Biotechnology,6200000.0,CHN,1,1,0,14791,14791,0
Biotechnology|Clinical Trials|Health Care|Life Sciences,6000000.0,USA,3,7,828,15759,16587,0
Biotechnology|Life Sciences|Medical,40834314.0,ESP,1,7,0,16686,16686,0
Clean Technology,40000.0,KEN,1,1,0,15187,15187,0
Manufacturing,21214500.0,BRA,1,1,0,15197,15197,0
Mobile,30214.0,CHN,1,1,0,12723,12723,0
Analytics|Health and Wellness,10270000.0,USA,3,16,1265,15340,16605,0
E-Commerce,10501285.0,THA,1,1,0,14851,14851,0
Software,6100000.0,USA,1,1,0,13361,13361,0
Software,17100000.0,USA,4,7,1791,12955,14746,1
Web Hosting,8069952.0,USA,2,1,856,14518,15374,0
Web Hosting,21000000.0,USA,3,4,1999,12632,14631,1
Security,10000000.0,ISR,1,7,0,13523,13523,1
Business Services|Contact Management|CRM|Enterprise Software|Networking|Small and Medium Businesses,20100000.0,JPN,5,11,2453,13756,16209,0
Hardware + Software,1225000.0,USA,2,1,428,14579,15007,1
Biotechnology,42000735.31214,DNK,2,14,1635,13877,15512,1
Biotechnology,51400000.0,USA,1,10,0,12194,12194,1
Health and Insurance|Health and Wellness|Pets|Veterinary,12327835.0,FRA,1,2,0,15065,15065,0
Biotechnology,44566724.0,CHE,3,3,3528,12769,16297,1
Biotechnology,12500000.0,NOR,2,8,816,13824,14640,0
Hardware + Software,56100000.0,USA,3,13,1515,12937,14452,1
E-Commerce,20000000.0,RUS,3,6,524,14610,15134,1
Clean Technology,5647230.0,DEU,2,4,764,15013,15777,0
Health Care,35771750.0,USA,6,1,1850,14180,16030,1
Manufacturing,200000.0,USA,1,1,0,16640,16640,0
App Marketing|Apps|App Stores,3000000.0,USA,2,8,167,16246,16413,0
Human Resources|Task Management,8148255.0,IND,2,1,1048,15308,16356,0
Health Care|Life Sciences|Medical|Medical Devices,55004618.0,DEU,3,5,911,15126,16037,1
Software,22114147.0,ISR,2,2,3905,11318,15223,1
Software,1040000.0,DNK,2,2,42,13774,13816,0
EdTech|Education,2500000.0,USA,1,1,0,14865,14865,0
Analytics|Big Data Analytics|Journalism|Media|News|Opinions|Psychology|Reputation|Semantic Search|Startups|Text Analytics,840000.0,SWE,3,3,1091,14400,15491,1
Clean Technology,283500000.0,USA,4,5,1405,14027,15432,0
Consulting|Customer Service|Services,2469311.0,CHE,1,2,0,16071,16071,0
Delivery|Hospitality,1600000.0,IND,1,1,0,16098,16098,0
Health Care,7000000.0,USA,5,6,1191,15418,16609,0
Wireless,4878762.0,GBR,1,3,0,12094,12094,0
Biotechnology,98000000.0,USA,3,8,1690,13483,15173,1
Brand Marketing|E-Commerce|Fashion|Shoes,100617300.0,FRA,1,1,0,16244,16244,0
Fashion|Lifestyle|Shopping,205197.0,COL,2,2,335,15887,16222,0
Email|Messaging,250000.0,USA,1,1,0,14046,14046,0
Medical Devices,6000000.0,USA,1,3,0,16659,16659,0
Clean Energy|Clean Technology|Design|Hardware + Software|Social Media,25000.0,JPN,3,3,1177,14884,16061,0
Accounting|Enterprise Software|Freelancers|Small and Medium Businesses,1046553.0,GBR,2,7,864,15340,16204,0
Health Care,62800000.0,USA,3,7,804,13713,14517,0
Nonprofits,22800000.0,IND,3,3,441,16167,16608,0
Software,322000.0,USA,1,2,0,14832,14832,0
Curated Web|Customer Service|Forums|Reviews and Recommendations|Social CRM,20850000.0,USA,5,17,1432,13757,15189,1
Mobile Payments|Payments|Software,11220000.0,ITA,4,4,839,15857,16696,0
Public Transportation,7000000.0,IND,1,1,0,14013,14013,0
Health Care,47315000.0,USA,5,12,2609,12784,15393,0
Biotechnology,5200000.0,USA,1,3,0,13963,13963,0
Bitcoin|Content|Payments,243575.388032866,GBR,2,3,329,16370,16699,0
Food Processing,320000.0,IND,1,2,0,16491,16491,0
All Markets,1823847.0,IND,2,2,115,16630,16745,0
Enterprise Software|SaaS|Software|Web Development,31000000.0,USA,4,7,2016,14455,16471,0
Content Delivery|Mobile Commerce|Wine And Spirits,4500000.0,USA,1,10,0,16679,16679,0
Social Games,3152231.0,CAN,1,2,0,15092,15092,0
Public Transportation,28000000.0,IND,2,3,388,15614,16002,0
Music|Navigation|Technology,7700000.0,USA,1,4,0,12767,12767,0
Software,101650000.0,USA,4,16,1605,12128,13733,1
Hardware + Software|Home Automation,90000000.0,USA,1,1,0,16316,16316,0
Databases|Technology|Virtualization,12000000.0,USA,1,3,0,12090,12090,0
Services,16700000.0,FRA,1,4,0,16685,16685,0
E-Commerce|Health Care,250000.0,USA,1,1,0,14975,14975,0
Advertising|Brand Marketing|Digital Media|E-Commerce|Online Shopping|Price Comparison,100000.0,SGP,1,1,0,15340,15340,0
Finance|FinTech,15000000.0,USA,1,3,0,11078,11078,0
Finance|Investment Management|Mobile|Personal Finance,250000.0,USA,2,2,427,15887,16314,0
Concerts|E-Commerce|Sports|Ticketing,500000.0,USA,1,1,0,15065,15065,1
Mobile,7700000.0,CHE,2,3,727,15034,15761,0
Audio|Enterprise Software|Meeting Software,160374.0,ESP,1,1,0,15308,15308,0
Finance,7000000.0,USA,2,6,313,15232,15545,0
Big Data Analytics|Consulting|E-Commerce|Health Care|IaaS|Information Technology|Internet of Things|Manufacturing|Mobile Enterprise|PaaS|SaaS,250000.0,USA,1,2,0,15779,15779,0
Coupons|Curated Web|Discounts,10000000.0,USA,4,3,1411,12784,14195,0
Advertising,32400000.0,USA,5,23,1728,14840,16568,0
Innovation Management|Robotics|Technology,2000000.0,USA,1,6,0,16169,16169,0
Software,79000000.0,USA,5,7,3198,13027,16225,0
Hospitality,3750000.0,USA,2,4,374,14610,14984,1
SaaS|Specialty Foods,28000.0,USA,1,1,0,16414,16414,0
Environmental Innovation,2458714.0,GBR,1,1,0,16318,16318,0
Advertising,2000000.0,USA,1,2,0,15565,15565,0
Kids|Parenting|Technology,22818.0,GBR,1,2,0,15887,15887,0
Business Development|Software,21700000.0,USA,1,3,0,11975,11975,1
E-Commerce|Hospitality|Retail,300000.0,USA,1,1,0,12784,12784,0
Software,2000000.0,USA,3,1,1033,15219,16252,0
Curated Web|Finance|Subscription Businesses,2000000.0,USA,1,2,0,14713,14713,0
Collaborative Consumption|Collectibles|Social Commerce|Trading,20000.0,USA,1,1,0,16191,16191,0
Hardware + Software,1383400.0,DEU,2,4,319,14714,15033,0
Marketplaces|Photography|Search,211000.0,SAU,1,2,0,16455,16455,0
Banking|Finance|Trading,127000000.0,DNK,1,1,0,12956,12956,0
Events|Franchises|Hotels|Restaurants|Surveys,35000.0,BRA,1,1,0,16086,16086,0
3D|Augmented Reality|Mobile|Mobile Commerce,1477282.0,FIN,4,10,967,15431,16398,0
Analytics|Audio|Enterprises|Surveys,2000000.0,USA,2,6,457,15113,15570,0
Analytics|Big Data|Payments|Software,2000000.0,USA,2,4,2793,13573,16366,0
Advertising|Media|Publishing|Video,54000000.0,USA,5,19,3258,13149,16407,0
Messaging,7510000.0,USA,2,3,2520,13754,16274,1
Electronics|Manufacturing|Semiconductors|Technology,29872425.0,USA,7,3,1619,14615,16234,0
Banking|Finance,5800000000.0,RUS,1,1,0,16258,16258,1
Health and Wellness,1670000.0,USA,1,1,0,15114,15114,0
Bridging Online and Offline|Developer APIs|Peer-to-Peer,450000.0,USA,2,1,396,14975,15371,0
Crowdsourcing|Software,12500000.0,USA,1,1,0,15635,15635,0
Software,656000.0,SWE,1,2,0,13024,13024,1
Enterprise Software,61000000.0,USA,7,25,2238,14393,16631,0
Analytics|Software,23710000.0,USA,3,5,387,15328,15715,0
Analytics,10500000.0,USA,1,3,0,15630,15630,0
Artificial Intelligence|Machine Learning|Software,13600000.0,USA,2,9,273,16071,16344,0
Cloud Computing|Infrastructure|Security,800000.0,USA,1,2,0,16566,16566,0
Software,12000000.0,USA,3,2,602,15076,15678,1
Software,8000000.0,USA,1,4,0,13977,13977,0
Cloud Computing|Software|Virtualization,26991390.0,USA,2,4,821,13535,14356,1
Advertising|Content|Digital Media|News,50000.0,GBR,1,1,0,15902,15902,0
Enterprise Software,13000000.0,USA,2,3,298,14848,15146,0
Software,9116657.0,USA,2,6,1293,12167,13460,1
Cloud Data Services|Software|Storage,80000000.0,USA,5,20,2062,14610,16672,0
Messaging,25200000.0,USA,3,6,985,12207,13192,0
Cyber Security|Security|Software|Virtualization,4000000.0,ISR,1,2,0,16715,16715,0
Collaboration|Email|Project Management|Software,10000000.0,USA,1,4,0,16728,16728,0
Analytics|Cloud Computing,2100000.0,USA,1,4,0,16547,16547,0
Software,15200000.0,USA,3,19,594,15393,15987,1
Health Care|Medical|Mobile Health,49660000.0,USA,4,16,1266,15286,16552,0
Analytics|Enterprises|Enterprise Software|Internet of Things,520000.0,USA,4,5,585,15709,16294,0
Advertising|Data Visualization|Enterprise Software|Mobile Coupons|QR Codes,31862082.0,USA,7,6,2428,13411,15839,0
Curated Web,4000000.0,USA,1,1,0,14104,14104,0
Biotechnology,4611176.0,GBR,2,7,393,12535,12928,0
Games,350000.0,USA,1,2,0,13573,13573,0
Android|Apps|Data Visualization|iPhone|Logistics|Manufacturing|Mobile|Mobile Commerce|Retail|Shopping|Software,5500000.0,CHE,1,1,0,16154,16154,0
Cars|Service Providers|Transportation,212289000.0,DEU,1,1,0,16014,16014,0
Enterprise Software,4820000.0,DNK,1,1,0,13031,13031,0
Semiconductors,2345180.0,FIN,2,2,336,14292,14628,0
Business Services|Consumer Electronics|Information Technology,10000000.0,URY,1,1,0,15320,15320,0
Mobile,14200000.0,USA,2,6,763,13594,14357,0
Information Security|SaaS|Security,28500000.0,JPN,2,5,740,13564,14304,1
Advertising,17500000.0,USA,5,15,1076,13469,14545,1
Internet of Things|SaaS|Security|Supply Chain Management,2500000.0,CHE,2,2,52,16507,16559,0
Intellectual Asset Management,5000000.0,USA,1,1,0,14021,14021,0
Consumer Goods,256458.0,GBR,1,1,0,16252,16252,0
Messaging,1020000.0,USA,4,1,769,15888,16657,0
Advertising,250000.0,USA,1,2,0,15191,15191,0
Enterprise Software|Law Enforcement|Mobile|Public Safety,5950000.0,CAN,3,6,455,16002,16457,0
Beauty|E-Commerce|Personalization|Subscription Businesses|Women,1040000.0,USA,2,7,436,16223,16659,0
Software,4200000.0,DEU,2,3,844,14140,14984,0
Banking|Insurance|Service Providers|Software,15000.0,USA,1,1,0,16495,16495,0
Curated Web,150000.0,USA,2,1,0,16083,16083,0
Curated Web|Events|Online Reservations|Online Scheduling,250000.0,USA,1,1,0,14061,14061,0
Enterprise Software,18687288.0,USA,3,7,1919,12800,14719,1
Games,5675000.0,USA,4,14,1218,14822,16040,1
Biotechnology|Medical|Therapeutics,20000000.0,USA,1,4,0,16328,16328,0
E-Commerce,40000.0,USA,1,1,0,15380,15380,0
Search|Startups,1065000.0,USA,3,3,579,14761,15340,0
Online Scheduling|Publishing|Web Hosting,510000.0,USA,1,1,0,16197,16197,0
Education,40000.0,USA,1,2,0,16486,16486,0
Education,50000.0,USA,1,1,0,15675,15675,0
Education,4420000.0,JPN,2,9,588,15888,16476,0
Education|High Schools|SaaS,50000.0,IND,1,2,0,15810,15810,0
Education,5000000.0,USA,1,1,0,15901,15901,0
Music,8500000.0,USA,2,2,366,15084,15450,0
Education|Testing,290000.0,USA,5,5,1027,15442,16469,0
All Students|Big Data Analytics|Education|Gamification|Mobile,176298.0,MEX,3,3,791,15614,16405,0
Education,1750000.0,USA,2,6,434,14944,15378,0
Communications Infrastructure|Communities|High Schools,8393326.0,USA,3,11,678,16084,16762,0
Education,44500000.0,USA,3,7,836,13409,14245,1
Education|Software|Systems,57100000.0,USA,6,15,2363,14386,16749,0
Analytics|Education,1500000.0,USA,1,1,0,16517,16517,0
Education,12000000.0,USA,1,1,0,14259,14259,1
Databases|Enterprise Software,35000000.0,USA,2,5,336,14113,14449,1
Education,40000.0,PRT,1,1,0,15138,15138,0
Biotechnology,52000000.0,USA,3,2,1877,14728,16605,0
Health Care|Hospitals|Medical,120000000.0,USA,1,1,0,16363,16363,0
Cosmetic Surgery|Health and Wellness|Health Care|Medical,12400000.0,USA,1,1,0,16450,16450,0
Software,12000000.0,TUR,1,1,0,14154,14154,0
Health Care|Mobility|SaaS|Software,1013000.0,USA,1,1,0,15340,15340,0
Hardware + Software,9100000.0,USA,4,9,776,15912,16688,0
Software,1190000.0,FRA,1,1,0,14537,14537,0
Analytics|Big Data|Business Intelligence|Life Sciences|Technology,250000.0,GBR,1,1,0,16184,16184,0
Finance,60000000.0,USA,3,4,1191,15294,16485,0
Technology,6500000.0,USA,1,2,0,16728,16728,0
Analytics|Big Data|Fitness|Machine Learning,50000.0,USA,1,1,0,15418,15418,0
Consulting|Life Sciences|Marketplaces|Outsourcing,5500000.0,USA,3,15,709,15126,15835,0
Education,265064.0,ESP,1,1,0,15867,15867,0
Education,1229840.40025715,IRL,1,1,0,16709,16709,0
Software,84000000.0,USA,4,8,1779,14706,16485,0
Artificial Intelligence|Knowledge Management|Life Sciences|Publishing|Startups,10000000.0,CAN,2,4,989,15765,16754,0
Clean Technology,74398208.0,USA,9,15,1775,14578,16353,0
Health Care|Life Sciences,5316630.0,USA,4,1,3429,13214,16643,0
Messaging,1200000.0,USA,1,2,0,14676,14676,0
Big Data|Games|Mobile|Mobile Commerce|Mobile Games|Monetization,2500000.0,USA,1,1,0,16189,16189,0
Clean Technology,26523862.0,USA,4,8,1111,14776,15887,0
Biotechnology,35000000.0,USA,2,4,1358,15188,16546,0
Biotechnology|Health Diagnostics,33127200.0,DEU,1,1,0,15007,15007,0
Hardware + Software,1633620.0,SWE,1,2,0,15099,15099,0
Semiconductors,25035451.0,USA,4,9,3456,12424,15880,1
Semiconductors,4290000.0,USA,3,1,395,16287,16682,1
Analytics,15929754.0,USA,2,2,524,14015,14539,0
Biotechnology,37000000.0,USA,3,3,633,15789,16422,1
Clean Technology,187000.0,IND,1,1,0,14532,14532,0
Biotechnology,13300000.0,USA,2,6,431,13241,13672,0
Finance|FinTech,59700000.0,USA,5,7,2797,13447,16244,0
Semiconductors,27000000.0,ISR,3,10,694,16048,16742,0
Big Data Analytics|Polling|Public Relations,5325912.0,GBR,1,2,0,13090,13090,0
Mobile,2150000.0,CAN,1,2,0,15251,15251,0
Developer APIs|Point of Sale|Retail Technology|SaaS,385375.0,ITA,2,3,450,15911,16361,0
Hardware + Software,19000000.0,ISR,2,4,173,15741,15914,0
Flash Sales,50000.0,ITA,1,2,0,15853,15853,0
Transportation,66991.0,DEU,1,1,0,16282,16282,0
EdTech|Education,1000000.0,FIN,1,1,0,16509,16509,0
Content Discovery|Curated Web|Internet Marketing|Social Media,11000000.0,USA,2,8,1517,14399,15916,0
Crowdsourcing|Journalism|Mobile|News|Photography,11037300.0,FIN,3,4,316,15706,16022,0
Marketplaces|Startups|Venture Capital,100000.0,IND,1,1,0,16174,16174,0
Publishing,4000000.0,IND,1,1,0,16757,16757,0
Education,2250000.0,USA,1,1,0,15771,15771,0
Public Transportation,4529658.0,USA,4,13,1125,14975,16100,0
Education,1600000.0,USA,2,6,344,15675,16019,0
Software,975000.0,USA,3,1,420,15338,15758,0
Software,1025000.0,USA,2,1,1247,14728,15975,0
Web Hosting,10980000.0,FRA,1,5,0,14762,14762,0
FreetoPlay Gaming|Mobile|Mobile Games|Publishing,43700000.0,USA,4,39,1306,15081,16387,0
Analytics|Retail|Software,5642292.0,USA,2,2,1,15522,15523,0
EdTech|Education|Mobile|SaaS|Technology|Test and Measurement,2800000.0,USA,1,3,0,16616,16616,0
Mobile|Sports,54338763.8005401,CAN,3,7,660,15818,16478,1
E-Commerce,56474999.0,USA,6,5,1872,14669,16541,0
Financial Services,570000.0,LUX,1,1,0,16720,16720,0
Sports,25000.0,USA,1,1,0,15422,15422,0
Games,2800000.0,DEU,2,4,115,14359,14474,1
B2B|Games,100000.0,ISR,3,3,767,15742,16509,0
Mobile,4051544.0,USA,3,8,1102,15429,16531,0
Manufacturing,12000000.0,GBR,1,1,0,15777,15777,0
Apps|Entertainment|Graphics|Music,100000.0,USA,1,1,0,15765,15765,1
Brewing,4200000.0,GBR,1,4,0,12335,12335,0
Discounts|Location Based Services|Mobile|Promotional|Social + Mobile + Local,2590393.0,NLD,2,2,694,15635,16329,0
Manufacturing,1048954.0,GBR,2,2,475,15191,15666,0
Security,915000.0,USA,3,2,496,16028,16524,0
Analytics|Business Intelligence|SaaS|Software,2991652.0,USA,3,1,2250,13483,15733,1
Games|Recruiting|Sports,5000000.0,USA,1,1,0,12430,12430,1
Enterprises|Procurement|SaaS|Software,2750000.0,USA,1,5,0,16462,16462,0
Brand Marketing|Enterprise Software|Search|Social Media|Tracking,4000000.0,USA,3,4,1096,13422,14518,1
Coupons|E-Commerce|Local Coupons,7755000.0,USA,4,9,1094,15076,16170,0
Curated Web|Ediscovery|Location Based Services|Mobile|Reviews and Recommendations,400000.0,GBR,1,3,0,14610,14610,1
Semiconductors,50000000.0,USA,1,2,0,12128,12128,0
Health and Wellness,16000000.0,USA,1,3,0,16155,16155,0
Trading,218423.0,NLD,2,1,517,15431,15948,0
Curated Web,11500000.0,USA,5,6,1432,13213,14645,1
Analytics|Cloud Computing|Databases|Information Technology,1198810.0,GBR,2,1,794,14579,15373,0
Customer Service|Internet|Shopping,3600000.0,USA,1,5,0,16630,16630,0
Coupons|Discounts|Fashion|Finance|Mobile|Retail|Sales and Marketing|Shopping,1400000.0,USA,1,1,0,15400,15400,0
Music,3300000.0,USA,3,9,695,15168,15863,0
Mobile,5900000.0,USA,2,1,350,15644,15994,0
Games,2500000.0,GBR,1,2,0,15799,15799,0
Networking|Sports,1250000.0,USA,1,1,0,13695,13695,0
Curated Web|Facebook Applications|Film|Social Television|Video on Demand,500000.0,GBR,1,4,0,16153,16153,0
Apps|Development Platforms|Mobile|Software,300000.0,USA,1,2,0,15690,15690,0
Collaboration|Enterprise Software|Productivity Software,1800000.0,USA,1,2,0,15857,15857,1
Entrepreneur|Internet|Media|News|Online Shopping|Startups|Video on Demand|Video Streaming,1200000.0,GBR,1,3,0,16160,16160,0
Human Resources|Recruiting|SaaS|Social Recruiting,700000.0,USA,2,4,386,15988,16374,0
Education|Enterprise Software|Video,40000.0,CHL,1,1,0,16222,16222,0
Curated Web,500000.0,USA,1,1,0,16010,16010,0
Entertainment,5000000.0,ISR,1,1,0,16265,16265,0
Public Relations|Publishing|Writers,345000.0,USA,3,4,338,15765,16103,0
Big Data Analytics|Blogging Platforms|Content|Content Discovery|Content Syndication|Enterprise Software|SaaS|Social Media Marketing,58920529.0,CAN,5,21,2091,14610,16701,0
E-Books|File Sharing|News|Publishing|Social Media,47762000.0,USA,6,21,3137,13300,16437,0
Media|Music|Online Shopping|Social Network Media|Video,225000.0,USA,1,1,0,13262,13262,0
Enterprise Software,500000.0,USA,1,1,0,15099,15099,0
Comics|Photography|Photo Sharing,40000.0,CHL,1,1,0,15614,15614,0
Investment Management,2500000.0,IND,1,6,0,16659,16659,0
Entertainment|Film|Software|Video Streaming,791274.0,USA,3,1,1497,13810,15307,0
Enterprise Software,162364.0,CHN,1,1,0,16010,16010,0
Crowdsourcing|E-Commerce|Freelancers|Marketplaces,14500000.0,USA,4,16,1092,15307,16399,0
Doctors|Finance|Medical|Mobile,432000.0,USA,2,2,131,14822,14953,0
Enterprises|Enterprise Software|Intelligent Systems|Networking|Software|Testing,9952199.0,USA,4,15,956,15340,16296,0
Communities|Consumer Internet|Curated Web|Forums,900000.0,SGP,3,4,686,15785,16471,0
Apps|Enterprises|iPad|iPhone|Mobile|Software,49647751.0,USA,7,2,2143,14608,16751,0
Manufacturing,159444.0,GBR,1,1,0,15400,15400,0
Curated Web|Mass Customization,5397761.0,FRA,1,2,0,16527,16527,0
Delivery|E-Commerce|Shipping|Transportation,2500000.0,IRL,2,3,329,15742,16071,0
Automotive|Electric Vehicles|Environmental Innovation,2573200.0,ESP,1,3,0,16177,16177,0
Games|Mobile,40785000.0,USA,6,12,1523,14031,15554,0
Health Care,856000.0,DEU,1,1,0,13318,13318,0
Consumer Electronics|Home Automation|Smart Building,5600000.0,SWE,3,1,1461,14975,16436,0
Security,1420000.0,GBR,1,2,0,13725,13725,0
Electronics|Law Enforcement|Software,113200000.0,ESP,4,7,1484,14803,16287,0
Software,6000000.0,USA,1,4,0,12892,12892,0
Software,1929900.0,BEL,1,1,0,16084,16084,0
Software,24000.0,JPN,1,1,0,14855,14855,0
Biotechnology,4370000.0,FRA,1,2,0,13823,13823,0
Curated Web|Internet,163755.0,CHN,1,1,0,16010,16010,0
Photography|Photo Sharing|Private Social Networking,450000.0,USA,1,2,0,16130,16130,0
Biotechnology,31746594.0,USA,4,15,1484,14312,15796,1
Software,4000000.0,USA,1,1,0,16245,16245,0
Security,25000000.0,GBR,2,4,1292,11607,12899,0
Consumers|Design|E-Commerce|Fashion|Marketplaces|Mass Customization,20000.0,USA,1,1,0,15553,15553,0
Web Hosting,35000000.0,USA,2,1,683,14449,15132,1
Delivery|E-Commerce|Hospitality|Internet|Local|Location Based Services|Mobile|Restaurants,51000000.0,USA,3,5,4033,11306,15339,1
Health Care,5500000.0,USA,3,2,911,15860,16771,0
Travel & Tourism|Ventures for Good,543889.0,USA,2,1,31,16405,16436,0
Entertainment|Games,3430000.0,USA,2,8,177,15845,16022,0
Enterprise Software|Government Innovation|Project Management,6450000.0,USA,4,8,1278,15495,16773,0
Health Care,1100000.0,CAN,1,5,0,16751,16751,0
Messaging|Retail|Social Media,1750000.0,USA,2,5,559,14457,15016,1
Web Hosting,20000000.0,USA,1,1,0,13632,13632,0
Information Services|Information Technology|Internet|Software,20000.0,USA,1,2,0,16556,16556,0
Web Hosting,6500000.0,FRA,1,5,0,13823,13823,0
Advertising|Services,3500000.0,GBR,1,1,0,10771,10771,1
Advertising,14500000.0,USA,2,12,623,14089,14712,1
Data Mining|Enterprise Search|Search|Semantic Search|Software,980392.0,CHE,1,1,0,14853,14853,0
Enterprise Search|Search,769000.0,NOR,2,1,553,13374,13927,0
Curated Web|News,305000.0,USA,1,1,0,14975,14975,0
Advertising|Digital Media|Marketing Automation|Search Marketing,68213212.0,USA,4,4,687,15896,16583,0
Search|Visual Search,46914300.0,USA,6,15,1400,12965,14365,0
Analytics|Content|Internet Marketing|SaaS|Search|Semantic Search|SEO|Social Media Marketing,23885724.316753,DEU,5,9,2010,14638,16648,0
E-Commerce|Enterprises|Search,2250000.0,USA,2,2,488,15034,15522,0
Finance|FinTech|Messaging,265000.0,USA,2,1,89,13726,13815,0
Apps|Developer APIs|Reviews and Recommendations|Search|Software,2059769.0,USA,1,5,0,16503,16503,0
Clean Technology|Water|Water Purification,20000.0,USA,1,1,0,16436,16436,0
Aerospace|Mobile|Travel,130931.0,DEU,1,1,0,15601,15601,0
Android|Entertainment Industry|iOS|Mobile|Music|SaaS|Sports,4000000.0,USA,2,27,306,16130,16436,0
Concerts|Search|Sports|Ticketing|Vertical Search,102970000.0,USA,9,50,2141,14386,16527,0
Social Media|Social Search|Travel,1000000.0,ISR,2,3,515,15687,16202,0
Biotechnology,26000000.0,USA,2,1,207,15932,16139,0
Biotechnology|Health Care|Therapeutics,164000000.0,USA,2,1,1080,15007,16087,1
Non Profit,17000.0,USA,1,1,0,15796,15796,0
E-Commerce,53000000.0,GBR,4,13,1127,13269,14396,0
Software,17412208.0,CAN,5,8,1354,14676,16030,1
Curated Web,55593417.0,USA,7,5,1840,14771,16611,0
Databases|Information Technology|Technology,19800000.0,GBR,2,5,862,13208,14070,1
Apps|E-Commerce|Price Comparison|Shopping|Software,900000.0,USA,1,7,0,16273,16273,0
Biotechnology|Health Diagnostics,18999999.0,USA,3,4,666,15195,15861,0
Elder Care|Health and Wellness|Mobile Health|Personal Health,60000.0,USA,2,2,155,15747,15902,0
Big Data Analytics|FinTech|Information Technology,120000.0,USA,1,1,0,16587,16587,0
Real Estate|Vacation Rentals,1725000.0,USA,2,1,195,14496,14691,1
E-Commerce,80000.0,RUS,1,1,0,15887,15887,0
Clean Technology,4000000.0,USA,1,1,0,13865,13865,1
Travel,600000.0,CAN,1,1,0,15645,15645,0
Games,19000000.0,USA,2,11,489,12719,13208,0
Finance|Startups,34150000.0,USA,5,6,1869,13410,15279,1
Crowdsourcing|Social Media|Social Television|Sports,18000.0,USA,2,2,0,16080,16080,0
E-Commerce,205000000.0,CHN,5,12,1467,15156,16623,0
Software,40000.0,USA,1,1,0,15940,15940,0
Apps|Social Media,35025000.0,USA,3,34,220,16045,16265,0
Travel,72857670.0,GBR,3,9,1378,15265,16643,0
Digital Media|Entertainment|Sports|TV Production,2700000.0,USA,2,6,1096,14883,15979,0
Games|Kids|MMO Games|Mobile Games|Publishing|Technology,2300000.0,USA,1,2,0,14694,14694,0
E-Commerce|Fashion|Online Shopping|Retail,17495275.0,GBR,3,8,1536,14648,16184,0
Enterprises|Network Security|Security,15850000.0,ISR,3,5,1006,14888,15894,0
Security,1940000.0,FRA,1,3,0,13549,13549,0
Security,69900000.0,USA,1,1,0,13012,13012,1
Software,8000000.0,USA,1,2,0,12732,12732,1
Software,12810000.0,USA,2,1,206,16521,16727,0
Computers|Network Security,5000000.0,USA,1,2,0,12293,12293,1
Security,982000.0,USA,1,1,0,14005,14005,0
Security,11100000.0,ISR,2,2,2841,13489,16330,1
Games,4000000.0,USA,1,1,0,12857,12857,1
Software,9250000.0,USA,1,3,0,12824,12824,1
Enterprise Software|Identity Management|Security,13000000.0,USA,2,1,1527,14761,16288,0
Cloud Security|Mobile|Mobile Software Tools,33511.0,AUT,1,1,0,16283,16283,0
Software,5000000.0,USA,1,1,0,13620,13620,1
Security,70481122.0,CAN,6,8,1770,14721,16491,0
E-Commerce|Mobile Payments|Payments|Trading,18000000.0,USA,2,1,840,15545,16385,1
Security,9000000.0,IND,2,1,873,15340,16213,0
BPO Services|Databases|Web Design,12000000.0,USA,1,2,0,13789,13789,0
Information Security|Security,10000.0,IND,1,1,0,15995,15995,0
Services|Test and Measurement|Water,637500.0,USA,3,4,214,15735,15949,0
Security,3900000.0,LUX,1,2,0,12817,12817,0
Security,73500000.0,USA,3,10,5383,11277,16660,1
Health and Insurance|Healthcare Services|Insurance,6172958.05406414,CAN,1,1,0,12876,12876,0
Hardware + Software,15000000.0,USA,1,3,0,12501,12501,1
Risk Management|Security,13100000.0,USA,3,4,2507,14013,16520,0
Cloud Computing|Cyber Security|Reviews and Recommendations|Risk Management|Security,15923277.0,USA,2,6,464,16071,16535,0
Software,3000000.0,USA,1,5,0,16001,16001,0
Gps|Security,4651137.0,USA,6,1,1348,14825,16173,0
Biotechnology,7500000.0,USA,3,5,820,15187,16007,0
Software,796000.0,NOR,1,1,0,13573,13573,1
Biotechnology|Health Diagnostics,1484998.0,USA,3,1,455,15846,16301,0
Public Transportation,670000.0,FRA,1,1,0,14796,14796,0
Enterprise Software|Mobility,2362500.0,USA,5,9,959,15522,16481,0
Art|Design|Photography,4100000.0,USA,2,11,757,15390,16147,0
Software,1300000.0,USA,1,1,0,12062,12062,1
Clean Technology,1411955.0,SWE,1,3,0,15204,15204,0
Health and Wellness,35000000.0,USA,2,2,546,15166,15712,0
Brand Marketing|Consumers|Mobile|Mobile Games|Photography|Social Games,350000.0,USA,1,2,0,15697,15697,0
Curated Web|Internet|iPhone|Local|Local Based Services|Mobile|Politics|Web Tools,3365000.0,USA,3,7,2136,14480,16616,0
Analytics,5117500.0,USA,2,6,2658,12978,15636,1
Software,5120000.0,USA,2,26,327,16405,16732,0
Hardware + Software|Home Automation|Internet of Things,3100000.0,USA,1,1,0,16325,16325,0
Crowdfunding|Crowdsourcing|Entertainment|Film|Games,1235000.0,USA,2,7,613,15675,16288,0
Business Services|Finance|Startups,10501321.0,GBR,4,11,2259,12966,15225,0
Finance Technology|Financial Services|Startups|Venture Capital,950000.0,USA,2,14,151,15979,16130,0
Energy Efficiency|Enterprise Software|Green Building|Renewable Energies,73000.0,CHN,4,4,805,15853,16658,0
Nonprofits,3050000.0,USA,2,1,1182,14903,16085,0
Crowdfunding|Curated Web|Entrepreneur|Social Network Media|Venture Capital,5250000.0,USA,2,9,348,15884,16232,0
E-Commerce,40000.0,CHE,2,2,371,16034,16405,0
Curated Web|DIY|Kids,10600000.0,USA,4,18,552,15820,16372,0
Mobile Commerce|User Experience Design|Web Development,470000.0,KOR,1,1,0,15971,15971,0
Finance,22755553.0,GBR,9,5,2423,14245,16668,0
Private Social Networking,55000.0,USA,1,1,0,15751,15751,0
Social Media Marketing,163448.0,ITA,2,2,545,15645,16190,0
E-Commerce,112243.0,GBR,1,1,0,15974,15974,0
Game Mechanics|Games|Gamification,1504721.0,CAN,2,1,1096,13514,14610,0
Analytics|E-Commerce|Search|User Experience Design,372108.0,GBR,3,2,356,15706,16062,0
Finance|Social Opinion Platform|Stock Exchanges,7000000.0,USA,2,5,1187,13392,14579,0
Business Travelers|Marketplaces|Translation,250000.0,USA,2,2,232,16308,16540,0
EdTech|Education|Networking,2225000.0,USA,4,16,492,15497,15989,0
Software,6261000.0,FRA,2,6,410,13189,13599,0
Communities,42762.0,GBR,1,1,0,16161,16161,0
Direct Marketing|Mobile|Mobile Commerce|Mobile Shopping,3050000.0,USA,5,3,654,15453,16107,0
Content Discovery|Curated Web|Real Time|Search|Social Media,4617567.0,USA,4,16,714,15663,16377,0
Curated Web|Photography|Photo Sharing|SaaS|Sales and Marketing|Social Media|Twitter Applications|Video,2792000.0,USA,4,2,729,14975,15704,0
Creative Industries|Innovation Management|Social Innovation,275000.0,MEX,1,2,0,16315,16315,0
Content|Crowdsourcing|Mobile Video|Video,553576.0,GBR,2,4,386,16071,16457,0
Clean Technology,40600000.0,USA,3,6,1929,14484,16413,1
Social Media,2278902.0,KOR,1,2,0,15470,15470,0
Analytics|Services|Software,12189731.0,USA,3,5,897,15855,16752,0
Advertising|Games|Television|Video on Demand,31551894.0,GBR,2,1,762,13695,14457,1
Advertising|News,23138876.0,USA,7,4,1680,13468,15148,0
Data Visualization|Displays|Search|Software|Technology,96037.0,IRL,2,2,90,16040,16130,0
Android|Brand Marketing|Browser Extensions|CRM|Curated Web|Facebook Applications|Marketplaces|Messaging|Social Media|Twitter Applications|Windows Phone 7,16000000.0,USA,3,17,1188,13818,15006,1
Consumer Electronics|Hardware|Interface Design|Internet|Television,1200000.0,USA,2,1,259,15979,16238,0
Chat|Enterprise Software|Video,1000000.0,USA,1,1,0,13787,13787,0
Online Scheduling|Online Travel|Tourism,16691.0,PRT,1,1,0,16627,16627,0
Advertising|Analytics|Brand Marketing|Consumer Electronics|Facebook Applications|Social Television|Television|Twitter Applications,1200000.0,CAN,2,10,818,15398,16216,0
Advertising|Analytics,17986943.0,USA,8,11,2872,12486,15358,1
Energy Efficiency|SaaS|Software|Sustainability,20000000.0,USA,3,7,540,15440,15980,0
Software,3760000.0,FRA,1,4,0,12929,12929,0
Clean Technology,32236273.0,USA,3,1,972,13634,14606,0
Analytics|Developer APIs|Google Apps,44600000.0,USA,4,11,997,15720,16717,0
Curated Web|Mobile,164744.0,CHN,2,2,243,16071,16314,0
Finance,29517377.0,USA,5,1,1240,15188,16428,0
Analytics|Banking|CRM,625000.0,USA,2,2,241,15961,16202,0
Software,13787114.0,USA,1,4,0,16640,16640,0
Health and Wellness,2500000.0,USA,1,1,0,16196,16196,0
Online Rental|Online Reservations,50000.0,ARG,2,3,322,16101,16423,0
Communities|Security|Technology,477326.0,VEN,2,2,457,15492,15949,0
Biotechnology,1277832.0,USA,2,1,0,14791,14791,0
Clean Technology,161040000.0,USA,3,7,836,13514,14350,1
Games|Mobile Games|Social Games|Video Games,4238332.0,USA,3,5,362,15134,15496,0
Enterprise Software|Presentations|Sales and Marketing|Sales Automation,24500000.0,USA,2,3,511,15932,16443,0
Engineering Firms|Innovation Engineering|Water,5000000.0,USA,1,1,0,14621,14621,0
Analytics|Optimization|Real Time,4000000.0,USA,1,2,0,16533,16533,0
Data Centers|Geospatial|Space Travel,1000000.0,RUS,1,1,0,15492,15492,0
Application Platforms|Crowdsourcing|Social Media,4500000.0,JPN,2,5,445,16296,16741,0
Assisted Living|Elder Care|Software,3636583.0,DNK,2,2,473,16031,16504,0
Biotechnology,900000.0,USA,1,1,0,15867,15867,1
Manufacturing|Medical Devices|Nanotechnology,1600000.0,USA,1,2,0,14000,14000,1
Apps|Cloud Computing|Games|Mobile|Portals,4443800.0,IRL,2,4,4,12992,12996,1
Discounts|Entertainment|Hospitality|Restaurants|Travel,40000.0,USA,1,1,0,16440,16440,0
Manufacturing|Textiles,63992.0,GBR,1,1,0,16375,16375,0
Biotechnology,182042306.0,USA,11,21,2386,14300,16686,0
Advertising,4570000.0,USA,3,4,1478,14207,15685,0
Beauty|Design|E-Commerce|Fashion|Media,2110951.0,FRA,1,2,0,16507,16507,0
Internet Marketing|Networking|Recruiting|Social Recruiting|Web Hosting,5500000.0,USA,1,1,0,13726,13726,1
Industrial|Industrial Automation,7962962.0,CHE,1,1,0,14426,14426,0
Software,2200000.0,USA,2,1,279,14050,14329,0
Biotechnology,74631831.0,USA,4,1,2062,14427,16489,0
Consumer Internet|Finance Technology|FinTech|Personal Finance,2035000.0,USA,2,7,98,16539,16637,0
Health and Wellness|Quantified Self|Self Development,37000.0,USA,1,2,0,16105,16105,0
Consulting|Employment|Video,134229.0,SWE,1,1,0,16399,16399,0
Analytics|Big Data|Internet,7250000.0,USA,3,6,573,16040,16613,0
Financial Services,4300000.0,AUS,1,1,0,16670,16670,0
Online Rental|Real Estate|Travel,10100000.0,USA,2,2,538,14229,14767,0
Advertising Platforms|Marketing Automation|Payments|Social Commerce|Social Media Marketing,8170000.0,USA,4,11,1036,15454,16490,0
E-Commerce|SaaS|Software,968000.0,USA,2,2,756,15918,16674,0
Collaboration|CRM|Mobile|Sales and Marketing,500000.0,ITA,1,4,0,16310,16310,0
CRM|Enterprises|Events|iOS|iPhone|Meeting Software|Mobile|Productivity Software|Professional Services|Task Management|Travel,2828000.0,USA,2,5,500,15522,16022,1
Classifieds|Search,500000.0,RUS,1,1,0,15006,15006,0
E-Commerce,40000.0,GBR,1,1,0,16052,16052,0
Advertising|Creative|Digital Media|E-Commerce|Internet Marketing|Online Shopping|Retail|Search Marketing|Video,20367984.0,USA,4,4,2396,13936,16332,0
Recycling,75000.0,USA,1,1,0,16617,16617,0
Billing|CRM|Customer Service|Enterprise Software,2165094.0,FRA,3,3,1798,14245,16043,0
E-Commerce,404772.0,ESP,2,7,561,15859,16420,0
Technology,3000000.0,USA,2,5,2229,11621,13850,0
E-Commerce,40000.0,CHL,1,1,0,16029,16029,0
E-Commerce|Flash Sales|Wine And Spirits,225000.0,BRA,2,1,609,15340,15949,0
Security|Storage|Surveys,39422003.0,SWE,3,3,1383,14006,15389,1
Biotechnology|Health Diagnostics,12000000.0,USA,3,2,3004,12303,15307,0
Health and Wellness,1000000.0,USA,1,1,0,16456,16456,0
Content|Curated Web|Games|Lifestyle|Mobility|Shopping,380000.0,USA,6,6,718,14849,15567,0
Clean Technology,26300000.0,USA,3,1,1336,15300,16636,0
Analytics|Big Data|Business Intelligence|Market Research|Media|SaaS,40000.0,CHL,1,1,0,16222,16222,0
Collaboration|Semantic Web|Software,2073280.0,AUT,2,2,0,12819,12819,0
E-Commerce,2150000.0,USA,2,2,979,15765,16744,0
Analytics|Business Intelligence|Enterprise Software|Search,9100000.0,USA,3,3,690,13392,14082,0
Advertising,717699.0,DEU,2,6,507,15072,15579,0
Digital Media|News|Social Media,150000.0,USA,1,1,0,15461,15461,0
Clean Technology,50000.0,PER,1,1,0,15675,15675,0
B2B|Market Research,2000000.0,USA,1,1,0,12493,12493,0
Semiconductors,5846400.0,FRA,1,2,0,14818,14818,0
Semiconductors,26000000.0,USA,1,2,0,12999,12999,1
Analytics,4700000.0,GBR,1,2,0,15728,15728,1
Energy|Oil,75000000.0,USA,1,2,0,12768,12768,1
Electronics|Semiconductors|Solar,39000000.0,USA,4,9,1956,12948,14904,0
Clean Energy|Semiconductors|Smart Grid,9000000.0,AUS,1,3,0,14993,14993,0
Biotechnology|Healthcare Services|Medical,44000000.0,USA,1,4,0,16518,16518,0
Software,10000000.0,GBR,2,3,1028,15300,16328,0
Renewable Energies,1230000.0,GBR,1,1,0,13843,13843,0
Clean Technology|Solar,63997160.0,USA,18,24,2964,13710,16674,0
Biotechnology,27000000.0,USA,3,7,1039,14227,15266,1
Game,278792.0,KOR,1,1,0,15686,15686,0
Hardware + Software,17590000.0,USA,2,6,682,13835,14517,1
Energy,25000.0,ARG,1,1,0,16588,16588,0
Cloud Computing|Enterprise Software|PaaS|SaaS,146067.0,AUS,2,1,181,15729,15910,0
Business Services|Marketing Automation|Media,18800000.0,USA,2,7,1070,11515,12585,1
Curated Web|Enterprise Software|Mobile|Open Source|Software|Web Development,29000000.0,USA,2,5,488,14783,15271,0
Jewelry,13000000.0,IND,1,1,0,16352,16352,0
E-Commerce|Fashion|Jewelry,3000000.0,USA,1,2,0,15096,15096,1
Enterprises|Enterprise Software,1300000.0,USA,2,21,549,15901,16450,0
E-Commerce|Logistics|Optimization|Shipping,770850.0,NLD,1,2,0,16456,16456,0
Software,47362000.0,USA,5,24,1944,14462,16406,0
Audio|Business Services|Communications Hardware|Enterprise Software|Messaging|Mobile|SMS|VoIP,10000000.0,USA,4,28,937,15456,16393,0
Mobile|Wireless,10400000.0,USA,3,5,1099,11821,12920,1
Developer APIs|Email|Email Marketing|Email Newsletters|Enterprise Software|SMS|Tracking,1662122.0,FRA,3,3,1826,14184,16010,0
Security,7000000.0,USA,2,6,728,13556,14284,0
Delivery|Logistics|Services,1800000.0,AUS,1,1,0,16546,16546,0
Mobile,34500000.0,USA,4,15,1008,13300,14308,0
E-Commerce,328571.0,RUS,2,2,1,15790,15791,0
Blogging Platforms|Entertainment|Games|Tracking,50000.0,USA,1,2,0,14061,14061,0
Logistics|Travel,159759.0,GBR,1,1,0,15593,15593,0
Enterprise Software|Internet Marketing,2500000.0,USA,2,6,334,13484,13818,1
Communications Infrastructure|Enterprises|Services,28000.0,USA,1,1,0,15522,15522,0
Broadcasting|News|Sports,4000000.0,CAN,2,1,282,15314,15596,0
Content|Email|Sales and Marketing|Software|Web CMS,2300000.0,USA,2,11,267,16071,16338,0
Messaging,33000000.0,USA,3,6,784,13367,14151,0
Apps|Delivery,500000.0,KEN,1,1,0,16595,16595,0
Renewable Energies,1069452.98094653,DNK,1,2,0,16133,16133,0
Clean Technology,2500000.0,USA,1,1,0,14019,14019,0
Biotechnology,38425000.0,USA,3,14,1354,14697,16051,0
Internet,28821913.0,USA,3,4,315,16423,16738,0
Email|Enterprise Software|Finance|FinTech,250000.0,USA,1,3,0,15049,15049,0
Business Services|Security|Services,12400000.0,USA,1,5,0,12522,12522,1
Biotechnology,17000000.0,USA,1,4,0,16051,16051,0
Location Based Services|Software,1800000.0,SWE,3,1,1597,14928,16525,0
Communities|Information Services|Services,20000.0,USA,1,1,0,15765,15765,0
Health and Wellness|Health Care|Health Care Information Technology|Medical,47000000.0,USA,3,12,807,12711,13518,0
Health and Wellness,25000006.0,USA,2,1,1348,15295,16643,0
Elder Care|Families|Senior Citizens,562000.0,USA,3,4,1628,14368,15996,1
Finance,1400000.0,USA,1,3,0,16154,16154,0
Software,17000000.0,USA,3,10,484,12913,13397,0
Health Care|Medical Devices,52732281.0,USA,4,1,2123,13998,16121,0
Manufacturing,10316249.0,USA,3,2,715,14636,15351,0
Software,34300000.0,USA,3,2,3961,11139,15100,1
Security,39918369.0,GBR,7,19,2449,12891,15340,1
Big Data|Text Analytics,1300000.0,USA,1,5,0,16525,16525,0
Information Services|Information Technology|Mobile|Music|Private Social Networking|Social Media,1041250.0,HKG,3,5,282,16071,16353,0
Manufacturing,5600000.0,USA,2,6,1140,14027,15167,0
Software,2210000.0,USA,4,4,874,15807,16681,0
Consulting,130701.0,GBR,1,1,0,14627,14627,0
Enterprise Software|Entertainment|Health Care|Speech Recognition,3778000.0,USA,3,5,709,15896,16605,0
Advertising|Analytics|Location Based Services|Machine Learning|Predictive Analytics,9000000.0,USA,2,4,451,13970,14421,1
Beauty|Cosmetics|Fashion|Services,19615.0,IRL,1,1,0,15762,15762,0
Analytics|Big Data|Cloud Computing,1860000.0,USA,3,5,607,15737,16344,0
Mobile Devices|Personalization|Sensors,2750000.0,USA,1,10,0,16450,16450,0
E-Commerce,32510266.0,FRA,2,4,430,15059,15489,0
Displays|Interface Design|Software,6000000.0,FIN,2,5,2151,14018,16169,0
Hardware + Software,500000.0,USA,1,1,0,16758,16758,0
Ad Targeting|Advertising|Sales and Marketing|Social Media|Technology,3350000.0,ISR,5,3,1399,14641,16040,0
Health and Insurance|Health and Wellness|Health Care|Health Care Information Technology|Healthcare Services|Health Services Industry,160750.0,USA,2,2,153,15918,16071,0
Medical Devices,40299989.0,USA,4,6,479,16179,16658,0
Embedded Hardware and Software|Internet of Things|Sensors|Wireless,1115500.0,USA,3,8,276,16219,16495,0
Hardware + Software,275000.0,USA,3,1,1979,12780,14759,0
Big Data|Financial Services|FinTech,1599036.31411469,CAN,1,3,0,16520,16520,0
Biotechnology,20000000.0,ISR,1,3,0,16020,16020,0
Hardware + Software,427000.0,SWE,1,3,0,13532,13532,0
Consumer Electronics|Environmental Innovation|Green Building|Home Automation|Internet|Internet of Things|Mobile|Mobile Devices|Smart Building,735000.0,ISR,3,5,161,16071,16232,0
Enterprise Software,13000000.0,USA,1,2,0,13052,13052,0
Software,3039567.0,USA,7,2,3868,12784,16652,0
Biotechnology|Health Diagnostics,250000.0,USA,1,1,0,13648,13648,1
Enterprise Software,323920.0,BGR,3,2,497,15584,16081,0
Health Care,33256521.739130396,CHE,6,15,2299,13864,16163,0
Analytics|Chemicals|Cloud Computing|Computers|Consumer Electronics|Internet of Things|Sensors,399857.0,CAN,1,1,0,16495,16495,0
Electronics|Semiconductors,535952.0,USA,2,1,215,15938,16153,0
Software,1368100.0,FIN,1,1,0,15000,15000,1
Open Source|SaaS|Software,6900000.0,FRA,1,1,0,16055,16055,0
Health Care,1000000.0,USA,2,1,309,15776,16085,0
Hardware + Software,6040000.0,FRA,1,2,0,14581,14581,1
Energy Efficiency|Networking|Systems,84000000.0,USA,4,7,896,15796,16692,0
Android|Finance|Mobile,12000.0,USA,1,1,0,14497,14497,1
Augmented Reality|Mobile|Real Estate,1200000.0,CAN,1,3,0,15845,15845,0
Android|iOS|Mobile,1000000.0,USA,2,9,97,15826,15923,0
Software,56674.0,NLD,2,2,586,16030,16616,0
Consumer Electronics|Hardware + Software,2398875.0,DEU,2,3,429,16056,16485,0
Biotechnology,5627820.0,FRA,2,2,1000,15456,16456,0
Enterprise Software|Gps|M2M|Mobile|Tracking,30501799.0,USA,5,17,2280,12676,14956,1
Android|Maps|Mobile|Web Hosting|Wireless,1311300.0,FRA,1,1,0,15715,15715,0
Technology,10000000.0,CHN,2,4,1080,15690,16770,0
Hardware + Software,94100000.0,USA,4,9,3501,11778,15279,0
Clean Technology|Internet of Things|M2M,500000.0,CAN,1,1,0,16552,16552,0
Electronics|Energy|Manufacturing,18400000.0,USA,4,11,1562,13370,14932,0
Analytics,1000000.0,USA,1,4,0,14214,14214,0
Software,21000000.0,AUS,4,14,1328,12551,13879,1
Enterprise Software|Hardware|Real Time|Security|Video Streaming,1500000.0,USA,1,9,0,15000,15000,0
Creative|E-Commerce|Online Shopping,80000.0,JPN,1,4,0,16360,16360,0
Electronics|Energy|Engineering Firms,19299.0,NLD,1,1,0,16020,16020,0
Mobile,16816504.0,USA,5,8,2054,14085,16139,0
Software,116935.0,USA,1,1,0,16636,16636,0
Biotechnology,26842000.0,USA,5,1,1948,14275,16223,0
Medical Devices,800000.0,SGP,1,1,0,16443,16443,0
Cloud Data Services|Internet|Technology,88731.0,KOR,3,1,609,15340,15949,0
Health Care|Pharmaceuticals|Therapeutics,1049999.0,USA,1,2,0,16654,16654,0
Clean Technology,22500000.0,USA,2,2,715,15825,16540,0
IT Management|Software,26350000.0,USA,3,10,1757,13444,15201,0
Health and Wellness,29450000.0,USA,3,15,915,10651,11566,1
Social CRM|Social Media Management|Social Media Monitoring|Software,1515251.0,GBR,1,1,0,16083,16083,0
Security,39520000.0,USA,4,17,942,15779,16721,0
Artificial Intelligence|Social Media,1753107.0,ESP,3,7,732,15779,16511,0
Software|VoIP,39000000.0,USA,4,18,1245,12118,13363,0
Semiconductors,37691801.0,USA,4,2,874,15314,16188,0
Health Care,26000000.0,USA,1,3,0,15495,15495,0
Home Automation|Internet of Things|Security|Smart Building,125000.0,USA,2,3,23,16294,16317,0
Big Data Analytics|Health and Wellness|Health Care|Health Care Information Technology|Hospitality|Information Technology|Machine Learning,9366000.0,USA,5,8,650,15734,16384,0
Music|Musicians|Writers,432772.0,GBR,1,1,0,15483,15483,0
Accounting|Databases|Hardware + Software|Networking|Security|Software,9500000.0,USA,3,6,1323,13641,14964,1
Hardware + Software,865018.0,USA,3,1,937,13866,14803,0
Computers|Cyber Security|Network Security|Security,6000000.0,USA,1,2,0,16330,16330,0
Security,40000.0,IND,1,1,0,15940,15940,0
Mobile|Mobile Security|Web Development|Wireless,1107075.0,IRL,1,1,0,13848,13848,0
Mobile,13000000.0,USA,3,2,912,15310,16222,0
Advertising|Optimization|Sales and Marketing|Search Marketing|Semantic Search|SEO,10000000.0,RUS,1,1,0,15552,15552,0
Business Intelligence|SEO,150000.0,COL,1,1,0,15475,15475,0
E-Commerce|Internet|Mobile Commerce|Online Shopping|SaaS|SEO|Shopping|Social Media|Software,1615000.0,NLD,3,3,1990,13879,15869,1
Flash Storage|Hardware + Software|Technology,88000000.0,USA,7,22,4877,11097,15974,0
Biotechnology,1151550.0,ESP,1,1,0,14300,14300,0
Restaurants|Sensors|Wireless,3263734.0,USA,9,5,1613,13818,15431,0
Health Care,2700000.0,USA,1,1,0,15131,15131,0
Medical Devices,35410772.2636776,CHE,2,12,546,16185,16731,0
Semiconductors,81880403.0,FRA,6,15,3704,12836,16540,1
Biotechnology,25373034.0,USA,4,5,1182,13783,14965,0
Software,25970000.0,USA,3,16,1827,11737,13564,1
Health Care,65100000.0,USA,5,11,1792,14376,16168,0
Biotechnology|Health Diagnostics,41460000.0,USA,4,11,1412,14951,16363,1
Semiconductors,74000000.0,USA,7,9,1666,12731,14397,0
Curated Web,8800000.0,USA,1,1,0,13643,13643,0
Biotechnology,60800000.0,USA,3,9,1542,12862,14404,0
Big Data|Databases|Information Services|Information Technology,10000000.0,CHN,1,1,0,16405,16405,0
Biotechnology,69586850.0,USA,7,16,1464,14978,16442,0
Biotechnology|Health Diagnostics,82000000.0,USA,1,1,0,15454,15454,1
Semiconductors|Service Providers|Software,15750000.0,USA,1,5,0,11971,11971,1
Communications Infrastructure|Health Care|Health Care Information Technology|Mobile Health,890000.0,USA,4,3,704,15799,16503,0
Manufacturing,4385432.0,GBR,2,5,1294,15407,16701,0
E-Commerce,69936227.0,USA,5,2,1487,14680,16167,0
Collaboration|Coworking|Hospitality,11250000.0,USA,3,2,1163,15485,16648,0
Biotechnology|Health Care|Medical,56000000.0,USA,2,16,630,13062,13692,1
Simulation|Virtualization|Virtual Worlds,750000.0,USA,1,1,0,16314,16314,0
Pharmaceuticals,30603972.389705397,GBR,2,7,412,13691,14103,0
Biotechnology,113000000.0,USA,4,8,770,15671,16441,1
Biotechnology|Hardware|Medical,12000000.0,USA,1,2,0,13572,13572,1
Air Pollution Control|Renewable Energies|Water Purification,165000.0,USA,1,1,0,15755,15755,0
Software,6000000.0,USA,1,1,0,13149,13149,0
Publishing,7000000.0,USA,2,3,196,13545,13741,0
Facebook Applications|Games|Social Games,4000000.0,USA,1,1,0,13994,13994,1
Clean Technology,135147224.0,USA,5,22,1481,13818,15299,0
Games|Mobile,28000000.0,USA,4,10,637,16014,16651,0
SEO|Software,75000.0,USA,3,3,609,15573,16182,0
Enterprise Software,21100000.0,USA,4,10,880,12999,13879,1
Training,17000.0,USA,1,1,0,15796,15796,0
Application Performance Monitoring|Enterprise Software|IaaS|SaaS,596705.0,GBR,3,9,767,14512,15279,0
Design,25637090.0,USA,2,1,519,15501,16020,0
Hardware + Software,24500000.0,USA,3,20,2099,11495,13594,0
Security,18000000.0,USA,1,3,0,12444,12444,0
Analytics,200000.0,USA,1,1,0,15259,15259,0
Enterprise Software|IT Management|PaaS|SaaS|Software,83703892.0,USA,6,3,2450,12969,15419,1
Apps|Enterprise Software|Mobile|Tablets,10000000.0,USA,1,3,0,15131,15131,0
Software,12075000.0,USA,3,8,1677,11645,13322,0
Governance|Services|Software,1356885.0,IRL,1,2,0,15071,15071,0
Services,30000000.0,USA,2,3,397,10956,11353,1
Enterprise Software,204000000.0,USA,6,38,2486,14187,16673,0
Automotive|Cloud Computing|Cloud Management|Enterprise Software|Software,15000000.0,USA,2,5,623,15294,15917,1
Software,45000.0,USA,1,1,0,15906,15906,0
SaaS|Services|Small and Medium Businesses|Software,1700000.0,USA,3,3,1943,14123,16066,0
Business Services|Cloud Computing|Health Care|Life Sciences|SaaS|Services|Software|Tech Field Support|Technology,66000000.0,USA,1,7,0,13543,13543,1
Software,18000000.0,USA,2,2,509,16093,16602,0
Software,18000000.0,USA,1,6,0,11729,11729,1
Advertising|Analytics|Crowdsourcing|Translation,9356180.0,USA,2,3,936,14834,15770,1
Home Decor|Home & Garden|Home Renovation,19999890.0,USA,2,5,289,16131,16420,0
Mobile|Software,3011408.0,USA,1,1,0,14593,14593,1
Customer Service|Hospitality|Restaurants,840000.0,USA,3,9,339,16311,16650,0
Health and Wellness,20000.0,USA,2,5,366,15340,15706,1
Music,1262470.0,USA,3,4,995,15539,16534,0
Software,6440000.0,FIN,1,1,0,14210,14210,0
Curated Web|Television|Video,694000.0,USA,3,6,569,14396,14965,1
Advertising|B2B|Monetization|Search|Video,10000000.0,USA,2,4,286,15064,15350,1
Biotechnology,85907152.0,USA,5,8,2296,14390,16686,0
Software,2880000.0,NOR,1,3,0,14640,14640,0
Bridging Online and Offline|Finance|Financial Services|Mobile|Mobile Payments|Restaurants,1815000.0,UKR,3,8,997,15706,16703,0
Software,350000.0,USA,2,1,215,16024,16239,0
Internet,1300000.0,USA,1,1,0,15279,15279,0
Advertising|Internet Marketing|Local|Mobile|Sales and Marketing|Search|SEO|Social Media|Web Presence Management,3517205.0,USA,2,10,903,15279,16182,0
Advertising|Internet Marketing|Local|Mobile|Sales and Marketing|Search|SEO|Social Media|Web Presence Management,3900000.0,USA,3,7,1135,15279,16414,0
Distribution|Energy|Oil & Gas,255000000.0,GBR,1,1,0,16174,16174,0
Big Data Analytics|Business Intelligence|Data Integration|Data Visualization|Oil and Gas,20000000.0,USA,1,1,0,16497,16497,0
Mobile Infrastructure|Software|Wireless,62000000.0,USA,2,10,218,13278,13496,0
Hospitality|Nightlife|Restaurants,4120757.0,USA,4,2,828,15776,16604,0
Clean Technology,20000000.0,USA,1,4,0,13913,13913,0
E-Commerce,1200000.0,USA,1,1,0,13343,13343,0
Apps|Hardware + Software|Home Automation|Internet of Things,1750000.0,FRA,1,1,0,16525,16525,0
File Sharing|Games|Photography|Television|Video|Web Tools,38732500.0,DEU,2,3,809,13239,14048,0
Business Services|Information Technology|Outsourcing,45000000.0,USA,1,4,0,11380,11380,0
Biotechnology,42027500.0,USA,13,11,1562,14733,16295,0
Networking|Software,202000000.0,USA,3,8,2941,13760,16701,0
Non Profit,2150000.0,IND,1,6,0,16546,16546,0
Mobile|Mobile Security|Security,2000000.0,USA,2,4,87,15825,15912,0
Advertising|Apps|B2B|Developer APIs|E-Commerce|Online Video Advertising|PaaS|Personalization|SaaS|Video,180778.0,ESP,3,3,183,15309,15492,0
Games|Television,95892257.0,USA,6,13,1559,13726,15285,1
Blogging Platforms|Curated Web|Forums,1000000.0,USA,1,1,0,13787,13787,1
Delivery|E-Commerce|Hospitality,100000.0,ITA,1,1,0,15390,15390,0
Biotechnology|Pharmaceuticals|Venture Capital,69500000.0,USA,4,4,365,15431,15796,0
Bitcoin,120000.0,USA,2,1,57,16267,16324,0
Biotechnology,37400000.0,USA,3,6,1456,14866,16322,0
E-Commerce,410306.0,ITA,2,5,243,16009,16252,0
Curated Web|Networking|Privacy|Social Media,1800000.0,USA,2,2,458,15857,16315,0
Biotechnology,25000000.0,USA,1,2,0,13837,13837,1
Hardware + Software,110000.0,USA,2,1,0,13665,13665,0
Big Data|Curated Web|SaaS,100000.0,USA,1,5,0,15961,15961,0
Games,956263.0,USA,3,8,571,15006,15577,0
Software,21533301.0,USA,3,7,504,16153,16657,0
Education|Photography|Video,2000000.0,USA,1,3,0,15765,15765,0
Internet,8800000.0,IND,2,5,26,16664,16690,0
Cooking|Portals|Recipes|Social Network Media|Software,500000.0,LBN,1,1,0,15492,15492,1
Hardware + Software,39336.0,EST,2,3,175,15391,15566,0
Entrepreneur|Freelancers|Legal|Mobile|Small and Medium Businesses,4000000.0,USA,2,10,416,15613,16029,1
Delivery|Subscription Service|Wine And Spirits,184894.148100213,GBR,2,1,256,16496,16752,0
Natural Resources|Real Time|Social Media,18000000.0,ISR,3,9,457,14791,15248,0
Online Video Advertising|Video,3800000.0,KOR,4,5,864,15419,16283,0
Mobile,25000.0,USA,1,1,0,15979,15979,0
Business Services|Entertainment|Games|Online Gaming,40000000.0,CHN,1,1,0,12112,12112,1
E-Commerce,1000000.0,CHN,1,2,0,13665,13665,0
E-Commerce,162364.0,CHN,1,1,0,15949,15949,0
Software,811820.0,CHN,2,1,487,15309,15796,0
Clean Technology,20000000.0,CHN,1,1,0,15345,15345,0
E-Commerce,15000000.0,CHN,1,1,0,14944,14944,0
E-Commerce,280000.0,CHN,1,1,0,14153,14153,0
Games,1800000.0,CHN,1,1,0,13604,13604,0
Biotechnology,6000000.0,CHN,2,5,945,14700,15645,0
News,205600000.0,CHN,2,2,2606,13984,16590,0
Games|Video,1000000.0,CHN,1,1,0,14975,14975,0
Social Media,20000000.0,CHN,3,6,505,12996,13501,0
Finance,22900000.0,CHN,3,3,2010,12539,14549,0
Customer Service|Logistics|Real Estate|Storage,250000000.0,CHN,1,1,0,16170,16170,0
Enterprise Software,1463414.0,CHN,1,1,0,14092,14092,0
Health and Wellness,27000000.0,CHN,2,6,704,13149,13853,0
E-Commerce,60000000.0,CHN,3,5,942,14245,15187,0
Clean Technology,26000000.0,CHN,1,3,0,13818,13818,0
Cyber Security|Information Security|Network Security|Security,66000000.0,USA,3,18,669,15456,16125,0
Apps|Information Services|Information Technology|Messaging|Social Media|Software,2500000.0,DEU,1,1,0,15383,15383,0
Fitness|Gamification|Health and Wellness|Health Care Information Technology|Incentives|Mobile Health|SaaS|Social Media|Wearables,15500000.0,USA,3,5,1177,14837,16014,0
3D Printing|E-Commerce|Manufacturing,77500000.0,USA,6,17,1741,14875,16616,0
Professional Networking,3000000.0,USA,1,1,0,16455,16455,0
Cloud Computing|Curated Web|Photo Sharing|Video,1647875.0,USA,3,7,713,15553,16266,0
Biotechnology|Health Care|Medical|Mobile,4125000.0,USA,6,22,509,15645,16154,0
Social Media,50000.0,JPN,1,1,0,15061,15061,0
Enterprise Software,27760493.0,USA,6,11,1644,14922,16566,0
Marketing Automation,18000.0,USA,1,1,0,16266,16266,0
Analytics,6000000.0,USA,1,2,0,16202,16202,0
Advertising|Analytics|Big Data Analytics|Content|Content Discovery|Curated Web|Email Marketing|Internet Marketing|Mobile|Web Tools,7755000.0,USA,4,24,1856,14488,16344,0
Business Development|Employment|Human Resources,206380.0,BEL,1,1,0,16052,16052,0
Financial Services,20000000.0,USA,1,4,0,11631,11631,0
Health and Wellness,34000000.0,USA,4,7,1393,15140,16533,0
Commercial Real Estate|Coworking|Curated Web|Marketplaces,1100000.0,USA,2,11,126,15994,16120,0
Document Management|SaaS|Software,4825002.0,USA,2,3,291,15566,15857,1
Software,2398377.0,GBR,4,2,747,15932,16679,0
Advice|Android|Fashion|iOS|Mobile|Photography|Social Media,30000.0,POL,1,1,0,15248,15248,0
Advertising|Direct Marketing|Social Media Advertising,500000.0,USA,2,2,274,15248,15522,0
Advertising|Analytics|Content|Content Discovery|Contests|Enterprise Software|SaaS|Services|Social Bookmarking,1400000.0,USA,1,4,0,16742,16742,0
Mobile|Networking|Photography|Web Hosting,1644736.0,CHN,1,1,0,16052,16052,0
Digital Media|Mobile|Music|Web Development,416386.0,USA,2,9,284,14883,15167,0
Transportation,791399.0,CAN,2,2,109,16562,16671,0
Advertising|File Sharing|Social Media,61680275.0,USA,6,25,3208,13514,16722,0
Advertising|Brand Marketing|Monetization|Software,38000000.0,USA,7,19,2738,13604,16342,0
Curated Web,2000000.0,USA,1,1,0,13269,13269,0
Collaborative Consumption|Marketplaces|Peer-to-Peer|Software,1200000.0,FIN,3,4,1007,15385,16392,0
SaaS|Small and Medium Businesses|Startups,2000000.0,USA,1,6,0,16085,16085,0
Mobile,1561659.52352033,NLD,1,1,0,13553,13553,0
Social Media,17000000.0,CHN,2,2,395,14853,15248,0
Advertising|E-Commerce|Internet Marketing|Social Commerce|Social Media Marketing|Social Network Media,65853.0,BGR,2,2,120,15706,15826,1
Advertising|Direct Marketing|Internet Marketing|Lead Generation|Sales and Marketing|Social Media|Social Media Marketing,101463.0,CAN,1,2,0,15400,15400,0
Games|Mobile Games|Video Games,1461490.98390415,USA,2,5,352,16139,16491,0
Hardware + Software,120000000.0,JPN,2,2,540,15340,15880,0
Biotechnology,950000.0,USA,3,2,957,15344,16301,0
Software,3015088.0,GBR,1,1,0,13761,13761,0
Distribution|Infrastructure|Innovation Management,1183469.0,FIN,1,1,0,16443,16443,0
Brand Marketing|Events|Photography|Photo Sharing,270645.0,FRA,1,1,0,15065,15065,0
Biotechnology,3855613.0,USA,2,1,341,14358,14699,0
Hardware + Software,2393883.0,USA,4,3,916,14684,15600,0
E-Commerce,25000.0,RUS,1,1,0,16040,16040,0
Consumer Goods|Restaurants|Services,375000.0,LBN,1,1,0,15796,15796,0
Android|Ediscovery|Games|iOS|iPhone|Music,130000000.0,USA,11,16,5110,11382,16492,0
Consumer Goods,25000.0,USA,1,1,0,16105,16105,0
Advertising|Intellectual Asset Management|Software|Video,100000.0,AUS,1,1,0,13787,13787,0
Developer APIs|E-Commerce|Retail|Security|Software|Technology,11177600.0,USA,5,2,1030,15671,16701,0
Mobile|Predictive Analytics|Video,3925000.0,USA,4,21,577,14975,15552,1
Social Media,1000000.0,USA,1,6,0,13545,13545,1
E-Commerce,125000.0,USA,2,1,98,16092,16190,0
Apps|Business Intelligence|Market Research|Retail Technology,20000.0,USA,1,1,0,16269,16269,0
Apps|Internet|Mobile,35000000.0,ISR,2,23,212,16283,16495,0
Distributors|Restaurants|Retail,40000.0,CHL,1,1,0,15314,15314,0
Banking|Financial Services|Real Estate,50000000.0,KEN,1,1,0,16441,16441,0
Consumer Goods,1000000.0,USA,1,1,0,16574,16574,0
Retail,8000000.0,USA,1,3,0,16681,16681,0
Games,150000.0,USA,1,2,0,16013,16013,0
Web Hosting,3250000.0,USA,1,2,0,12926,12926,0
Games,3989751.0,CHN,3,3,610,14365,14975,0
Health Care,1569037.0,CHN,1,1,0,15309,15309,0
Manufacturing,24909310.0,CHN,2,1,122,11201,11323,0
Enterprise Software,543791.0,CHN,1,1,0,11201,11201,0
Games,21961932.0,CHN,1,1,0,14761,14761,0
Biotechnology,13875434.0,CHN,2,3,365,13939,14304,0
Enterprise Software,10122082.0,CHN,2,1,2983,12143,15126,0
Consulting,14650000.0,CHN,1,2,0,14708,14708,0
EdTech|Education,152037.0,CHN,4,3,3987,11231,15218,0
Mobile,2196193.0,CHN,3,3,1003,14153,15156,0
Manufacturing,1346301.0,CHN,2,2,304,12022,12326,0
Manufacturing,36890468.0,CHN,4,2,2253,13453,15706,0
Software,4000000.0,CHN,2,2,92,14883,14975,0
Automotive,29282576.0,CHN,2,1,3136,11443,14579,0
Manufacturing,10878827.0,CHN,3,2,1523,14426,15949,0
Travel,15212981.0,CHN,1,1,0,15034,15034,0
Enterprise Software,10500611.0,CHN,2,1,122,14304,14426,0
Clean Technology,110000000.0,CHN,2,1,577,14123,14700,0
Manufacturing,3102904.0,CHN,2,1,457,14031,14488,0
E-Commerce,55000000.0,CHN,4,4,1857,13149,15006,0
E-Commerce,15000000.0,CHN,3,3,1948,14092,16040,0
Cloud Data Services|Data Security|File Sharing|Local|Software|Storage,854000.0,USA,5,3,1000,15659,16659,0
Health and Wellness,7975213.0,USA,2,9,981,15572,16553,0
Billing|Customer Service|Information Technology|SaaS|Software|Startups|Tech Field Support,30000.0,USA,1,1,0,16436,16436,0
Collaborative Consumption|Curated Web|Social Travel,42928.0,ESP,1,1,0,15857,15857,0
Information Technology|Software,2054488.0,CHE,2,3,485,15737,16222,0
Android|Ediscovery|Events|iPhone|Location Based Services|Mobile|Networking|Social + Mobile + Local,33101.0,GBR,2,12,84,15591,15675,0
B2B|Cloud Computing|Collaboration|Enterprises|Enterprise Software|Mobile|Networking|Social Media|Web Development,2553670.0,USA,3,1,1030,15623,16653,0
Biotechnology,11814560.0,GBR,1,1,0,15126,15126,0
Information Security|SaaS,350000.0,IND,1,6,0,16353,16353,0
Advertising|Consumer Goods|Facebook Applications|Social Media,14000000.0,USA,4,25,1043,15006,16049,1
Technology,73800000.0,USA,3,17,608,16071,16679,0
Business Services|Messaging,1620000.0,USA,2,8,146,16436,16582,0
Bitcoin|Finance|Finance Technology|Financial Services|FinTech|Personal Finance,120000.0,USA,1,2,0,16267,16267,0
Big Data|E-Commerce|Information Technology|Insurance|SaaS,1800000.0,FRA,1,2,0,16407,16407,0
Software,1392573.0,USA,3,1,1344,14368,15712,0
Curated Web,35000000.0,USA,3,23,1113,15650,16763,0
Emerging Markets|Health Care|Medical Devices|Product Design,1219500.0,USA,2,3,191,16435,16626,0
Software,2000000.0,USA,1,1,0,16623,16623,0
Software,4250000.0,USA,3,6,1112,15219,16331,0
Education,12000000.0,CHN,3,5,273,15706,15979,0
Hardware + Software,136666166.0,USA,5,1,1317,15036,16353,0
Advertising|Cyber|Security,3300000.0,USA,2,3,305,15309,15614,0
Manufacturing,101500000.0,CHN,3,8,486,14579,15065,0
Fashion,235000.0,USA,2,1,331,16222,16553,0
Advertising|Advertising Platforms|Direct Advertising|Local Advertising|Mobile Advertising,500000.0,CAN,1,2,0,15056,15056,1
News,4500000.0,GBR,1,1,0,13541,13541,0
Delivery|Developer APIs|E-Commerce|Shipping,1592388.0,DNK,1,3,0,16304,16304,0
Logistics|Mobile|Shipping,1020000.0,USA,2,5,332,16222,16554,0
Retail,15000.0,CAN,1,1,0,16071,16071,0
Apps|Shipping|Software|Technology,108500.0,USA,2,1,314,16014,16328,0
Distribution|Logistics|SaaS|Shipping|Software|Transportation,6000000.0,USA,2,7,309,16040,16349,0
PaaS|SaaS|Software,10050000.0,USA,3,11,458,15922,16380,0
Collaborative Consumption|Crowdsourcing|Delivery|Developer APIs|E-Commerce|Logistics Company|Shipping,150000.0,BRA,1,2,0,16405,16405,0
B2B|Developer APIs|E-Commerce|Logistics|Shipping,2275000.0,USA,6,15,644,16035,16679,0
Marketplaces|Shipping|Transportation,40000.0,CHL,1,1,0,16283,16283,0
Software,5600000.0,CHN,3,3,1704,10196,11900,0
Enterprise Software,10000000.0,USA,2,3,1381,13787,15168,1
Logistics,16691.0,ESP,1,1,0,16627,16627,0
Cloud Computing|Delivery|E-Commerce|Network Security|Shipping|Software|Transportation,285000.0,USA,2,3,396,15218,15614,0
Finance,15000000.0,IND,1,1,0,15235,15235,0
Education,250000.0,IND,1,1,0,16743,16743,0
Event Management|Mobile,200000.0,USA,1,1,0,15779,15779,0
Mobile Commerce,1500000.0,USA,1,4,0,16633,16633,0
Internet,18835026.0,USA,5,1,532,16071,16603,0
Education,4000000.0,USA,1,1,0,13088,13088,0
Hardware + Software,55900000.0,USA,6,15,1861,13620,15481,0
Health Care,52500000.0,USA,2,6,477,16097,16574,0
Cloud Computing|Content Creators|Content Delivery|Digital Media|Hospitality|Mobile|Mobile Analytics|Technology|Television|Video|Video Streaming,4479992.0,USA,5,3,1001,15393,16394,0
Curated Web|Payments|Productivity Software,2511360.0,USA,3,4,1673,13879,15552,0
E-Commerce,9000000.0,USA,1,2,0,12530,12530,1
Fashion,66000000.0,USA,4,7,1049,14567,15616,1
E-Commerce|Fashion|Personalization|Software|Technology,1255000.0,USA,4,5,876,14399,15275,1
Public Safety,120000000.0,USA,1,4,0,12606,12606,1
E-Commerce|Shoes,8550000.0,AUS,4,14,2071,14335,16406,0
Fashion|Shoes|Women,67478.0,FRA,1,1,0,15248,15248,0
Artists Globally|Concerts|Consumer Goods|E-Commerce|Events|Music|Music Venues|SEO|Social Media|Ticketing,300000.0,USA,1,3,0,16252,16252,0
Curated Web,94000.0,GBR,1,1,0,16091,16091,0
Advertising|App Marketing|Mobile Coupons,10000000.0,USA,2,1,546,14637,15183,0
Analytics|Social CRM|Social Media Marketing,129006.0,FRA,1,1,0,15609,15609,0
News,311203.0,SWE,1,2,0,15007,15007,0
Fashion|Lifestyle|Shoes|Shopping|Social Media|Storage,25912.0,ITA,1,2,0,15787,15787,0
E-Commerce|Marketplaces,51521172.0,CAN,2,10,685,15506,16191,0
E-Commerce,25000000.0,IRL,1,1,0,13057,13057,1
Fashion,3500000.0,USA,2,14,483,15567,16050,1
E-Commerce|Software,421742.0,GBR,1,1,0,16229,16229,0
Internet,83053.0,IND,1,1,0,16240,16240,0
Shopping,120000.0,USA,1,1,0,16267,16267,0
Curated Web|E-Commerce|Internet|Shopping|Social Media,12400000.0,GBR,3,8,893,15584,16477,0
Advertising|Big Data|Mobile Shopping|Online Shopping|Shopping,8364999.0,USA,3,6,846,15476,16322,0
Consumers,704000.0,AUS,1,3,0,16752,16752,0
Analytics|Brand Marketing|Market Research,21400000.0,USA,3,11,672,15568,16240,0
Curated Web,22356.0,NLD,1,1,0,15461,15461,0
Curated Web|E-Commerce|Lifestyle|Travel,33000.0,IND,2,3,1180,15461,16641,0
E-Commerce|Enterprise Software|Mobile Commerce|SaaS,10000000.0,USA,2,3,1888,13787,15675,1
Coupons|E-Commerce|Online Shopping|Shopping,1100000.0,SGP,2,3,36,16503,16539,0
Big Data|Curated Web|Digital Media|E-Commerce|Shopping|Social Commerce|Social Media|Startups,4000000.0,GBR,1,2,0,15993,15993,0
E-Commerce,1000000.0,USA,1,3,0,15530,15530,0
Curated Web|E-Commerce|Ediscovery|Fashion|Retail|Social Buying,375000.0,BRA,1,1,0,15553,15553,1
Consumer Internet|E-Commerce|Shopping,131250000.0,IND,6,6,1479,14975,16454,0
Brand Marketing|Discounts|Fashion|Mobile|Social Buying,703916.0,ARG,5,5,792,15248,16040,0
Software,2000000.0,CHN,2,4,13,14365,14378,0
Brand Marketing|Design|E-Commerce|Entrepreneur|Fashion|Shopping|Social Buying|Video|Video Streaming,8000000.0,USA,2,3,108,13953,14061,1
Software,11180367.275065,USA,1,4,0,16709,16709,0
Apps|E-Commerce|Mobile|Mobile Commerce,9400000.0,USA,4,5,1985,14610,16595,0
E-Commerce|E-Commerce Platforms|Mobile Commerce,950000.0,ARE,3,1,457,15645,16102,0
Analytics|Apps|Big Data|Developer Tools|E-Commerce|Enterprise Software|Mobile|Online Shopping|Retail|SaaS|Software|Web Development,122000000.0,CAN,3,13,1094,14956,16050,1
Social Media|Social Media Advertising|Social Media Management|Social Media Marketing,12500000.0,USA,3,3,1416,14671,16087,1
Curated Web|Social Bookmarking|Social Commerce|Social Media,185000.0,USA,4,2,199,15551,15750,0
E-Commerce|Retail Technology,300000.0,PAK,2,2,0,16062,16062,0
E-Commerce,31490.0,USA,1,2,0,14176,14176,0
Cloud Computing|Enterprise Software|Point of Sale|Retail|SaaS,97200000.0,USA,4,17,1288,15356,16644,0
Mobile|Retail|Social Media,26700000.0,USA,4,13,1683,14439,16122,1
Apps|Internet|Video,350000.0,USA,1,3,0,16405,16405,0
E-Commerce|Mobile Commerce,1241250.0,HKG,2,8,223,16252,16475,0
Coupons|CRM|Loyalty Programs|Mobile,325000.0,URY,2,2,116,15345,15461,0
Advertising|Coupons|Local|Shopping,21350000.0,USA,6,10,915,10803,11718,1
E-Commerce,1000000.0,TUR,2,6,153,15400,15553,0
Analytics|E-Commerce,250000.0,USA,1,1,0,15248,15248,1
Software,7000000.0,CAN,1,2,0,13683,13683,0
E-Commerce,7700000.0,FRA,2,3,536,15323,15859,1
Information Technology,846389.0,USA,1,1,0,11047,11047,0
E-Commerce|iPad|Mobile|Mobile Commerce|SaaS|Tablets,500000.0,USA,1,15,0,15945,15945,0
Analytics|Big Data|Cloud Computing|Kinect|Retail,920030.0,USA,3,3,549,15522,16071,0
E-Commerce|E-Commerce Platforms|Retail,3000.0,USA,1,1,0,16602,16602,0
Coupons|Email|Internet|Retail,125744.0,FRA,1,1,0,15525,15525,0
E-Commerce|Mobile Commerce,1000000.0,USA,2,3,29,16231,16260,0
Apps,400000.0,MYS,1,3,0,16448,16448,0
E-Commerce,75000000.0,USA,1,1,0,15936,15936,1
Mobile|Shopping,9500000.0,USA,4,4,1188,14092,15280,0
Software,1650000.0,USA,2,4,610,14903,15513,0
E-Commerce|Mobile|Mobile Commerce|Shopping|Social Commerce,628000.0,SGP,3,4,369,15386,15755,0
Software,14500000.0,USA,2,9,5166,11533,16699,0
Big Data|Curated Web|E-Commerce,5812206.0,FRA,2,1,396,15764,16160,0
Fashion,2000000.0,USA,2,6,197,15420,15617,0
Real Time,20000.0,USA,1,1,0,16287,16287,0
E-Commerce|Mobile|Mobile Commerce|Shopping,6400000.0,USA,2,3,634,15340,15974,0
Analytics|Finance,2030000.0,USA,3,2,151,15838,15989,0
Payments|Point of Sale|Retail Technology,547113.0,GBR,2,1,335,16027,16362,0
Curated Web|Health and Wellness,11339553.0,USA,6,7,2059,14662,16721,1
Price Comparison|Search|Shopping|Video|Web Tools,6250000.0,USA,1,1,0,13330,13330,1
Shopping,13640858.0,DEU,1,2,0,16489,16489,0
Advertising|Curated Web,74500000.0,GBR,3,13,648,10434,11082,1
Software,1930000.0,GBR,1,2,0,13584,13584,0
Hardware|Local Businesses|Mobile|Technology,100000.0,USA,1,1,0,16260,16260,0
Curated Web|Events|Mobile|Networking|Startups,310000.0,USA,1,7,0,15309,15309,0
Brand Marketing|Marketing Automation|Services,250000.0,USA,1,1,0,16717,16717,0
Sports,647045.0,GBR,1,3,0,16636,16636,0
Computer Vision|Image Recognition|Mobile|Retail Technology|Search|Visualization|Visual Search,821122.597962538,ESP,6,6,195,15849,16044,0
Mobile|Sports,325000.0,USA,6,3,557,16040,16597,0
Social Network Media|Software|Video,800766.0,IRL,5,2,847,15314,16161,0
Digital Media|E-Commerce,790010.0,USA,2,1,574,15545,16119,0
File Sharing|Photography|Reviews and Recommendations|Social Network Media,1750000.0,USA,2,3,989,15715,16704,0
Android|iOS|iPhone|Mobile|Social Media|Teenagers,15200000.0,USA,3,20,676,16010,16686,0
Analytics|Security,67933006.0,USA,7,36,3437,13249,16686,0
Apps|Marketplaces|Mobile|Startups,120000.0,USA,1,2,0,16267,16267,0
Apps|Charity|Enterprise Software|Mobile,1025559.0,AUS,1,1,0,15857,15857,0
Games,1250000.0,USA,2,1,330,15286,15616,0
Cloud Computing|MicroBlogging|Mobile|Startups|Web Hosting,1648560.0,USA,2,2,546,14276,14822,0
Enterprise Software,29200000.0,USA,4,6,1864,14628,16492,1
Advertising|Audio|Curated Web|Messaging|Telephony,20000.0,USA,1,1,0,14471,14471,0
E-Commerce|Ticketing,1500.0,BRA,1,1,0,14277,14277,1
Games|Internet|Software|Video,8000000.0,ISR,1,4,0,16632,16632,0
Concerts|Curated Web|Events|Ticketing,7181000.0,USA,7,6,2395,13787,16182,0
Software,2515000.0,USA,2,1,202,15938,16140,0
Computers|Software,2200000.0,USA,1,2,0,11495,11495,0
Concerts|Curated Web|Music|Ticketing,25000.0,USA,1,1,0,15400,15400,0
Education|iPad,840000.0,USA,3,10,502,14700,15202,0
Curated Web|Location Based Services,4170000.0,SGP,5,4,1160,13818,14978,0
Android|iOS|Mobile|Mobile Enterprise|SaaS|Sales and Marketing,10500000.0,USA,2,3,590,15790,16380,0
Curated Web,46916000.0,FRA,1,1,0,14852,14852,0
Enterprise Software,3000000.0,USA,1,1,0,14851,14851,1
Mobile,36000000.0,GBR,3,11,942,12965,13907,1
Social Media,100000000.0,CHN,1,1,0,16130,16130,0
Software,15416011.0,CHN,2,1,213,15340,15553,0
Financial Services|Real Estate,28000000.0,IND,2,7,648,15674,16322,0
Child Care|Transportation,12200000.0,USA,2,9,146,16366,16512,0
Business Services|Crowdsourcing|Services,5800000.0,JPN,1,1,0,16358,16358,0
Information Technology|Services|Virtualization,11500000.0,USA,1,2,0,12634,12634,1
E-Commerce,4792797.0,GBR,1,1,0,15593,15593,0
E-Commerce|Entrepreneur|Logistics|Postal and Courier Services|Retail|SaaS|Services,8685807.0,GBR,6,23,1746,13879,15625,1
Curated Web|Events|Freemium|Internet|Photography|Printing|Project Management|Services|Social Media,52000.0,USA,1,1,0,15737,15737,0
E-Commerce|Internet,3000000.0,USA,1,1,0,11645,11645,1
Mobile,2946785.0,USA,4,4,663,15743,16406,0
Enterprise Software,1048000.0,USA,3,7,670,14975,15645,0
Social Media Marketing|Software,2850000.0,NZL,2,5,1205,15126,16331,0
Enterprise Resource Planning|Software|Startups,1805739.0,DEU,1,1,0,16387,16387,0
Business Services|Security|Technology,17750000.0,USA,1,4,0,11407,11407,0
Logistics|Shipping,62100000.0,USA,3,33,571,15975,16546,0
Health Care,82120000.0,USA,5,8,2251,14330,16581,0
Product Design|Semiconductors|Technology,10000000.0,EGY,1,2,0,15706,15706,0
Semiconductors,12700000.0,USA,1,2,0,14279,14279,0
Biotechnology,8191381.0,USA,5,10,912,15623,16535,0
Mobile,800000.0,USA,1,1,0,15952,15952,0
Finance,1350000.0,ITA,2,11,125,15853,15978,0
Finance Technology,800000.0,THA,1,2,0,16457,16457,0
Hardware + Software,106000000.0,ISR,6,21,2241,12877,15118,0
Curated Web|Groceries|Hospitality|Online Shopping|Sustainability,568936.0,GBR,4,5,701,15706,16407,0
Enterprise Software|File Sharing|Project Management,750000.0,USA,2,4,739,15187,15926,0
Mobile|Semiconductors,113750000.0,USA,6,13,1924,12753,14677,1
Semiconductors,76770000.0,DEU,2,5,752,13803,14555,0
Manufacturing,16295491.0,CHN,1,1,0,16130,16130,0
E-Commerce,29610541.0,CHN,2,3,243,14518,14761,0
Manufacturing,1573905.0,CHN,1,1,0,13879,13879,0
Mobile Health,565000.0,USA,3,4,361,16140,16501,0
Semiconductors,10220000.0,GBR,2,8,508,12908,13416,0
Computers|Design|Hardware|Manufacturing,43105472.0,USA,3,9,1700,12677,14377,0
Software,885000.0,ESP,1,3,0,13782,13782,0
Apps|Delivery|Mobile|Peer-to-Peer|Transportation,35000000.0,USA,5,25,1019,15309,16328,0
E-Commerce|Internet Marketing,15120000.0,USA,4,27,1480,15279,16759,0
Facebook Applications|Sales and Marketing|Social Network Media|Web Hosting,5100000.0,USA,2,4,423,14610,15033,0
Apps|Software,1000000.0,USA,1,2,0,16426,16426,0
Application Platforms|Development Platforms|Games,150000.0,ISR,1,1,0,14730,14730,0
Embedded Hardware and Software|Hardware|Semiconductors,11700000.0,CAN,3,11,924,14740,15664,0
Fantasy Sports|Payments|Video Games,20000.0,USA,1,1,0,16671,16671,0
Biotechnology,32599000.0,USA,2,3,186,15814,16000,0
Music,218000.0,DEU,2,4,322,16279,16601,0
Hotels|Ticketing|Travel,32000000.0,USA,4,7,2619,10926,13545,1
Facebook Applications|Social Media|Social Search,250000.0,USA,1,2,0,14031,14031,0
Collaborative Consumption|Curated Web|Finance|Local|Marketplaces,4000000.0,USA,3,6,633,15156,15789,1
Politics,4850000.0,USA,1,2,0,16694,16694,0
Consumer Electronics|Electrical Distribution|Energy Efficiency|Health Care|Semiconductors,8900000.0,DEU,1,1,0,14809,14809,1
Ad Targeting|Advertising Platforms|Android|Email Marketing|Mobile Advertising|Web Browsers,7777728.0,FRA,2,3,366,13604,13970,0
Early-Stage Technology|Energy Efficiency|Fuels,2950000.0,USA,2,1,280,16240,16520,0
Health Care,150000000.0,USA,2,7,1806,13621,15427,1
Business Intelligence|Consulting|Outsourcing,700000.0,USA,1,1,0,14761,14761,1
Semiconductors,19000000.0,USA,2,5,1199,12084,13283,1
Semiconductors,37250000.0,USA,2,6,661,11694,12355,1
Public Relations,25200000.0,USA,2,3,604,11197,11801,1
Biotechnology,21600000.0,USA,2,4,347,13740,14087,0
Communities|Open Source|Publishing|Software,6126788.0,GBR,3,1,5804,10227,16031,0
Big Data|E-Commerce|Fraud Detection|Machine Learning|Security,23600000.0,USA,3,21,986,15218,16204,0
Consumer Goods|E-Commerce|Online Shopping,2540000.0,USA,2,9,294,15737,16031,0
Entertainment|Games|Hardware + Software,13500000.0,USA,3,4,427,14426,14853,1
Restaurants,4450000.0,USA,2,1,545,16225,16770,0
Curated Web,650000.0,USA,3,4,1196,13879,15075,0
Analytics|Business Intelligence|Lead Generation|Trading,40635.0,CZE,2,1,72,15968,16040,0
Semiconductors,28500000.0,CAN,2,16,879,12784,13663,1
Finance,16000000.0,USA,2,4,660,15888,16548,0
Internet of Things|Wireless,151298218.308425,FRA,4,20,1351,15126,16477,0
Health Care,6.0,ISR,1,1,0,16375,16375,0
Automotive|Big Data Analytics|Industrial Automation|Manufacturing|SaaS,5000000.0,USA,1,7,0,16475,16475,0
Energy|Services|Solar,5000000.0,USA,2,3,130,16611,16741,0
Games|Gamification|Health and Wellness|Leisure|Mobile Games|Social Games|Software|Tourism|Travel,107867.0,IRL,2,3,101,15940,16041,0
Advertising|Internet Marketing|Local Advertising,1700000.0,USA,2,8,321,16098,16419,0
Software,370561.0,USA,2,1,2329,12405,14734,0
Biotechnology|Delivery|Pharmaceuticals,6339385.0,IRL,1,1,0,16342,16342,0
Defense|Electronics|Hardware + Software|Telecommunications,390360.0,ESP,1,1,0,15711,15711,0
Finance,4522000.0,USA,4,6,1064,14853,15917,0
Big Data Analytics|Business Intelligence|Enterprise Software|Media|Software,3200000.0,GBR,2,10,192,16525,16717,0
Hardware + Software,3890000.0,SWE,1,1,0,13558,13558,0
Application Performance Monitoring|Data Security|Software,2000000.0,USA,1,5,0,16210,16210,0
Information Technology,249304.0,USA,1,1,0,16252,16252,0
Software,37500000.0,USA,3,10,852,13118,13970,1
Software,28500000.0,USA,2,3,671,15765,16436,0
Analytics|Big Data|Business Intelligence|Intelligent Systems|New Product Development|Product Development Services,15000000.0,ISR,1,2,0,16734,16734,0
Mobile,6000000.0,USA,1,4,0,15091,15091,0
Mobile|Retail,1100000.0,USA,1,5,0,15095,15095,0
Real Estate,3500000.0,USA,1,1,0,16255,16255,0
Biotechnology,10000000.0,USA,1,1,0,15324,15324,0
Security|Software|Technology,657414.0,ESP,2,4,404,16136,16540,0
Mobile,1850000.0,AUS,1,2,0,13199,13199,0
Software,10000000.0,USA,1,3,0,13404,13404,0
Big Data|E-Commerce|Enterprise Software|Payments|Software,11000000.0,USA,3,16,915,15693,16608,0
Hardware + Software,3610000.0,USA,6,6,1266,14937,16203,0
Curated Web,2500000.0,USA,2,4,358,15047,15405,1
Biotechnology|Health Care,44000000.0,AUS,3,9,2254,14502,16756,0
CRM|Local|Marketing Automation|SaaS|Software,36550000.0,USA,5,13,1860,14693,16553,0
News,18500000.0,USA,1,5,0,12784,12784,1
Machine Learning|Optimization|User Testing,2120000.0,USA,2,4,197,16405,16602,0
Hardware + Software,56494609.0,USA,6,18,1496,13098,14594,1
Android|Consumer Electronics|Mobile,879531.0,GBR,2,2,1137,13879,15016,0
Mobile,116277.0,CHN,3,1,517,15340,15857,0
Software,25000.0,USA,1,1,0,15974,15974,0
Software,18750000.0,USA,3,5,1015,15589,16604,0
Mobile,49000000.0,ISR,3,17,2681,13985,16666,0
Health Care|Medical|Therapeutics,10000000.0,USA,1,2,0,16335,16335,0
Nanotechnology,3550000.0,USA,3,2,2288,14012,16300,0
Semiconductors,5750000.0,USA,4,3,3141,11641,14782,0
Mobile,5000000.0,ISR,1,1,0,13828,13828,0
Professional Services|Training|Tutoring,3738338.0,GBR,1,1,0,16240,16240,0
Curated Web,4545754.0,GBR,1,3,0,16153,16153,0
Hardware + Software,13810000.0,ISR,5,4,2385,13873,16258,0
Enterprise Software,4130000.0,CHE,2,4,705,13936,14641,0
Semiconductors,9550000.0,ITA,2,3,1168,13519,14687,1
Manufacturing,26100000.0,USA,3,7,1102,13301,14403,1
Cloud Computing|Semiconductors,640470.0,SGP,2,1,608,15997,16605,0
Hardware + Software,23000000.0,USA,1,6,0,13733,13733,0
Semiconductors,17000000.0,NLD,2,6,555,13619,14174,0
Semiconductor Manufacturing Equipment,6689484.0,DEU,2,2,2629,13877,16506,0
Semiconductors,11820000.0,IRL,1,1,0,13138,13138,0
Semiconductors,22498182.0,USA,5,1,1306,15373,16679,0
Big Data|Big Data Analytics|Consulting|Data Mining|Data Visualization,3000000.0,USA,1,8,0,15947,15947,0
Semiconductors,57005567.0,USA,3,11,965,14174,15139,1
Hospitality,2581933.0,USA,4,2,1007,15511,16518,0
Semiconductors,9000000.0,USA,1,2,0,12872,12872,1
Manufacturing,345007997.0,USA,9,11,3394,13300,16694,0
Semiconductors,6000000.0,GBR,1,7,0,13528,13528,0
Curated Web|Data Visualization|Media|SEO|Web Tools,3655264.0,NLD,3,11,873,15112,15985,0
Displays|Electronics|Manufacturing,771575.0,CAN,1,1,0,12678,12678,0
Health Care,113625793.0,USA,6,5,3088,13640,16728,0
Beauty|Fashion|Health and Wellness|Manufacturing,4385000.0,USA,2,1,210,16350,16560,0
Fashion,181830.0,GBR,1,2,0,15985,15985,0
Career Management|Cloud Infrastructure|Human Resources,2700000.0,JPN,1,3,0,15057,15057,0
Career Management|Human Resources|Recruiting|Software,199500000.0,USA,8,28,4521,12053,16574,0
SaaS|Software,550000.0,CAN,2,2,1644,14975,16619,0
Nanotechnology,124468875.0,USA,7,26,2356,14400,16756,0
Software,6000000.0,USA,1,4,0,12996,12996,1
Software,552289.0,GBR,2,2,397,15946,16343,0
Software,2147000.0,GBR,2,4,828,14004,14832,0
Networking|Software,68946467.0,USA,10,12,3636,13045,16681,0
Communications Hardware|Technology|Web Hosting,358929976.0,USA,9,15,2184,13607,15791,1
Analytics|Fraud Detection|Security|Software,22100000.0,USA,3,10,1091,14148,15239,1
Enterprise Purchasing|Enterprise Software|Software,31300000.0,USA,2,1,1156,14916,16072,0
Web Hosting,46000000.0,USA,3,11,1674,11589,13263,1
Software,31000000.0,USA,3,12,1964,11185,13149,1
Automotive|E-Commerce|Transportation,37276848.0,USA,4,11,1262,15405,16667,0
Health and Wellness,1777995.0,USA,3,2,1108,14292,15400,0
Cloud Data Services|Enterprise Software|Health and Wellness|Health Care,1929900.0,USA,2,3,1273,14610,15883,0
Video,200000.0,USA,1,1,0,16155,16155,0
Software,12600032.0,USA,3,4,2813,12557,15370,1
Advertising|Email Marketing|Lead Management|Marketing Automation,40000000.0,USA,2,4,1826,13993,15819,1
Ad Targeting|Advertising|Big Data|Local Businesses|Mobile|Software,2800000.0,USA,5,12,881,15820,16701,0
Technology|Transportation|Travel,69000000.0,GBR,4,13,1363,14811,16174,0
Politics,150000.0,USA,2,2,0,16071,16071,0
Information Technology|Network Security|Security|Software,108000000.0,USA,3,9,2437,11311,13748,1
Web Hosting,39000000.0,USA,2,10,1421,11737,13158,1
Clean Technology,3478433.0,GBR,1,1,0,14062,14062,0
Local Search|Mobile|SaaS|Search|Services|Social Media Marketing|Technology|Web CMS,8000000.0,USA,1,2,0,16238,16238,0
Health and Wellness|Medical Devices,7000000.0,USA,1,3,0,14195,14195,1
Clean Technology,8075000.0,USA,2,2,505,14102,14607,0
Music,23011000.0,DEU,2,3,370,14741,15111,0
Software,7000000.0,IRL,1,2,0,12829,12829,1
Advertising|Analytics|Business Intelligence|Business Services|Curated Web|Market Research|Software,65100000.0,GBR,7,14,2458,14276,16734,0
Fraud Detection,5750000.0,USA,3,2,479,16252,16731,0
Curated Web|Education|Networking|Publishing,75000.0,USA,1,1,0,16076,16076,0
Simulation|Software|Virtual Worlds,2642000.0,AUS,2,2,664,13305,13969,0
Curated Web,3427334.0,USA,2,1,321,14329,14650,0
Clean Energy|Clean Technology|Solar,5100000.0,IND,3,5,1478,14942,16420,0
Software,5000000.0,USA,2,1,2015,14035,16050,0
Health Care,27000000.0,USA,2,3,855,15237,16092,0
Analytics|Clean Energy|Clean Technology|Energy Efficiency|Facebook Applications|Finance|Green|Internet|Networking,8916500.0,USA,4,16,910,15187,16097,0
Oil & Gas,1825806.0,USA,5,3,660,16092,16752,0
FreetoPlay Gaming|Games|MMO Games|Publishing|Social Games,140000.0,IRL,2,2,798,14232,15030,0
Android|Health and Wellness|iOS|Mobile,60000.0,USA,1,1,0,16040,16040,0
Consumer Electronics|Hardware + Software|Television,10797752.0,USA,2,2,730,15797,16527,0
Health and Wellness|Mobile|Technology|Wearables,112500.0,HKG,2,2,0,16252,16252,0
Information Technology,700000.0,USA,1,5,0,16737,16737,0
Enterprise Software|FinTech|Health Care|Payments|SaaS,17800000.0,USA,3,11,907,15065,15972,0
Advertising|Developer APIs|Location Based Services,9807367.0,USA,3,26,189,14558,14747,1
Email|Internet|SaaS,1300000.0,FRA,1,3,0,16462,16462,0
Coupons|Curated Web,1000000.0,USA,1,2,0,15279,15279,0
Software,1200000.0,USA,1,5,0,15790,15790,0
Software,58500000.0,CAN,3,15,1162,12551,13713,0
Marketing Automation,10600000.0,USA,3,10,1025,15248,16273,0
Curated Web|Registrars,300000.0,USA,1,1,0,15422,15422,0
E-Commerce|Email|Email Marketing|Finance|FinTech|Personalization|Software,2518000.0,USA,3,10,448,15400,15848,0
Curated Web,5600.0,USA,1,1,0,14114,14114,0
Blogging Platforms|Curated Web|SaaS|Web CMS|Web Hosting,2200000.0,DNK,1,1,0,15653,15653,0
Photography,7100000.0,USA,2,3,740,12265,13005,1
Mobile Video|Video Streaming,6983535.0,GBR,5,2,1230,15126,16356,0
Finance|Finance Technology|FinTech|Personal Finance,240348.0,GBR,1,3,0,15675,15675,0
Education|Finance|Innovation Management,26900000.0,USA,6,9,3163,13252,16415,0
Bitcoin|FinTech|Fraud Detection|Payments,1400000.0,ISR,2,4,277,16218,16495,0
Consulting,142000.0,GBR,1,1,0,13699,13699,1
Advertising|Auctions|Search|Semantic Search|SEO,22837902.0,USA,5,4,1297,14754,16051,0
Curated Web,403112.0,IND,2,3,151,15761,15912,0
Curated Web,3367250.0,ITA,1,1,0,15730,15730,0
Software,2100000.0,USA,1,1,0,13290,13290,1
Enterprise Software|Market Research|Mobile|Productivity Software,450000.0,FRA,1,3,0,16141,16141,0
Finance|Hedge Funds|Marketplaces|Software|Transaction Processing,1580000.0,USA,3,5,175,15680,15855,0
Hardware + Software,6983000.0,USA,4,1,1372,14827,16199,0
Certification Test|EdTech|Education|Project Management|Tutoring,28000000.0,USA,3,5,1113,15435,16548,0
Home Automation|Home & Garden|Security,57000000.0,USA,1,1,0,16211,16211,0
Storage|Virtualization|Web Hosting,276500000.0,USA,5,18,1164,15340,16504,0
Software,4200000.0,USA,1,7,0,16629,16629,0
Analytics|Coupons|Discounts|Finance|FinTech|Incentives|Mobile|Software|Technology,18000.0,CAN,1,1,0,15363,15363,0
Search,34300000.0,USA,5,18,3499,12692,16191,0
Analytics|B2B|SaaS|Social Media,29000000.0,USA,4,12,1537,14610,16147,0
Stock Exchanges,535777.0,AUS,2,2,441,16222,16663,0
Software,899999.0,USA,1,1,0,14413,14413,1
Advertising|Direct Marketing|Email Marketing|Internet Marketing|Marketing Automation,3256411.0,CAN,7,5,5562,10774,16336,0
Application Platforms|Communications Infrastructure|Events,1100000.0,USA,1,10,0,16467,16467,0
Food Processing,1100000.0,GBR,1,1,0,16553,16553,0
Technology,1500000.0,USA,1,2,0,16695,16695,0
E-Commerce|Health and Insurance|Health Care|Insurance,7650000.0,USA,3,22,636,15980,16616,0
Banking|Coupons|Mobile|Mobile Infrastructure|Mobile Payments|NFC|Payments|Point of Sale|QR Codes,10120600.0,USA,5,6,853,15737,16590,0
Politics,41000.0,USA,1,2,0,16314,16314,0
Big Data|Human Resources|Social Recruiting,1200000.0,USA,1,3,0,16706,16706,0
Semiconductors,14920000.0,USA,2,13,266,13147,13413,1
Networking,4929548.0,ITA,1,1,0,12500,12500,0
Software,729000.0,DEU,1,1,0,13250,13250,0
Advertising|Media|Sales and Marketing|Television,58250000.0,USA,6,19,1740,14309,16049,0
Messaging,5700000.0,USA,3,2,1430,12418,13848,0
Games,6992898.0,GBR,2,2,1203,15455,16658,0
Curated Web|Internet,91500000.0,CHN,4,9,5293,9282,14575,1
Curated Web|Software,586000000.0,CHN,1,1,0,15824,15824,1
B2B|FinTech|Retail|Retail Technology,20507.3051578151,ITA,1,1,0,16059,16059,0
Travel,40000.0,CHL,1,1,0,15637,15637,0
Social Media,3000000.0,USA,1,4,0,15273,15273,1
Software,12000000.0,USA,1,2,0,16204,16204,0
Delivery|Hospitality|Restaurants,1851372.0,ESP,2,3,258,14881,15139,1
Financial Services|Real Estate,6500000.0,USA,2,3,0,16484,16484,0
Software,5330000.0,FRA,1,2,0,13483,13483,0
Health Care|Medical|Medical Devices,20000000.0,USA,1,3,0,14035,14035,0
Postal and Courier Services,456850000.0,SGP,2,2,433,16191,16624,0
Cloud Computing|IaaS|Infrastructure|Networking|Web Hosting,72300000.0,USA,4,4,958,15455,16413,0
Content|Curated Web|Hospitality|Restaurants|Reviews and Recommendations|Social Media|Web Development|Web Presence Management,4575000.0,USA,3,10,306,14881,15187,1
Analytics,8950000.0,USA,3,10,827,15006,15833,1
Music,1040000.0,USA,1,1,0,13292,13292,1
Education|Internet|Mobile|Music,428482.0,CAN,3,3,714,15740,16454,0
Advertising|Augmented Reality|K-12 Education|Mobile,50000.0,BRA,2,2,618,16042,16660,0
Advertising|Marketing Automation|SaaS,5000000.0,USA,1,1,0,16268,16268,0
Biotechnology,127336875.0,USA,7,20,2628,13346,15974,0
Career Management|Contests|Law Enforcement|Music,300000.0,USA,1,2,0,15789,15789,0
E-Commerce,530000.0,ARG,3,5,418,15561,15979,1
Software,7503751.0,CHN,1,1,0,14944,14944,0
Curated Web,10000000.0,CHN,1,2,0,13720,13720,0
Batteries,1000000.0,USA,2,1,96,16142,16238,0
Hardware + Software,10710000.0,CHN,3,10,222,14462,14684,0
Health Care,10168014.0,USA,4,1,1289,15070,16359,0
Security,18097057.0,CHN,4,12,2679,12265,14944,1
Games|Music|Startups,750000.0,THA,1,1,0,16522,16522,0
Health and Wellness|Health Care|Medical Devices,180000.0,USA,2,2,303,16310,16613,0
Advertising|Enterprise Software|Media|Software,20001589.0,USA,3,7,3777,11943,15720,0
Nanotechnology,25000.0,USA,1,1,0,15665,15665,0
Hardware + Software,28400000.0,USA,3,10,1268,11856,13124,0
Semiconductors|Video,20150000.0,USA,3,6,2119,13322,15441,0
Chemicals,252486.0,USA,2,2,93,16189,16282,0
Events|Hardware|Social Media,9786.0,POL,1,2,0,16270,16270,0
Security,39730000.0,USA,4,14,1929,12818,14747,1
Analytics,32000000.0,USA,2,10,1323,12577,13900,1
Manufacturing,29100000.0,USA,1,6,0,13284,13284,0
Software,6000000.0,USA,1,1,0,13194,13194,0
Web Hosting,1449360.0,AUT,1,2,0,15370,15370,0
Education,6400000.0,USA,2,7,304,15614,15918,1
Consumer Goods|Manufacturing|Specialty Foods,8500000.0,USA,1,2,0,16661,16661,0
Web Hosting,15398400.0,ITA,1,1,0,15344,15344,0
Medical Devices,4800000.0,GBR,1,2,0,16408,16408,0
Web Tools,4000000.0,USA,4,2,1003,11169,12172,1
Semiconductors|Software|Technology,19600000.0,USA,1,10,0,11757,11757,1
Consumer Electronics|iPhone|Software|Virtualization,24000000.0,USA,2,8,407,14165,14572,1
Semiconductors,35800000.0,USA,2,11,1000,12556,13556,1
Biotechnology|Health Diagnostics,15948800.0,GBR,7,24,1388,13999,15387,1
Mobile|Mobile Devices|Mobile Enterprise|Technology,25000000.0,ISR,1,1,0,16029,16029,0
Biotechnology,45000000.0,USA,1,4,0,13613,13613,0
Software,1910000.0,FRA,1,1,0,13149,13149,0
Risk Management|Services|Software,4580000.0,USA,1,1,0,16185,16185,0
Music|News,1055750000.0,USA,2,1,141,14276,14417,1
Biotechnology,76000000.0,USA,2,6,804,12165,12969,0
Biotechnology,3900000.0,USA,2,9,190,15012,15202,0
Information Technology|Services|Storage,17000000.0,USA,1,10,0,11750,11750,0
Application Platforms|Developer APIs|Gamification|Internet of Things|Location Based Services|Mobile Commerce,5000000.0,USA,1,5,0,16743,16743,0
Biotechnology,13213123.2740358,DEU,1,2,0,13496,13496,0
Biotechnology|Health Care|Pharmaceuticals,82000000.0,USA,4,16,839,12418,13257,1
Health Care,120000.0,USA,1,1,0,16405,16405,0
Financial Services,7500.0,USA,1,1,0,15857,15857,0
Analytics|Big Data|Business Analytics|Business Intelligence|Data Visualization|Information Technology,44000000.0,USA,3,12,1430,14803,16233,0
Mobile,4610000.0,FRA,2,3,954,13848,14802,0
Biotechnology,1000000.0,GBR,1,1,0,14685,14685,0
Software,10000000.0,USA,2,4,280,12093,12373,1
Biotechnology,10000000.0,USA,1,2,0,16031,16031,0
E-Commerce,27000.0,JOR,1,1,0,14975,14975,0
Software,7000000.0,GBR,2,3,177,14937,15114,0
Software,1650000.0,USA,4,1,2305,13354,15659,0
Enterprise Software|Internet|SaaS|Software,350000.0,USA,1,2,0,14822,14822,0
Software,477000.0,CAN,1,1,0,14774,14774,1
Real Estate,903234.0,GBR,2,3,43,15819,15862,0
Mobile,15000000.0,USA,1,1,0,13227,13227,0
Software,180000.0,USA,1,1,0,15796,15796,0
Software,35715957.0,GBR,2,2,617,15467,16084,0
Diagnostics|Health Diagnostics|Medical|Therapeutics,4178358.0,USA,3,7,295,16336,16631,0
Software,7000000.0,USA,1,4,0,13081,13081,1
Optimization|Personalization|Testing,13000000.0,USA,1,1,0,16441,16441,0
Internet Marketing|Lead Generation|Lead Management|Marketing Automation|Search,2325000.0,USA,2,1,2299,13573,15872,0
Brokers|Real Estate|Technology,2200000.0,USA,1,2,0,16547,16547,0
Computers|Semiconductors,105517223.0,USA,7,21,2702,13634,16336,1
Collaboration|Software,125000.0,USA,2,3,374,14540,14914,0
Curated Web,48100000.0,USA,5,23,1768,14274,16042,0
Internet|Social Media|Social Network Media|Software,25000.0,USA,1,1,0,16222,16222,0
Semiconductors,12000000.0,ISR,1,2,0,13159,13159,0
Crowdfunding|EdTech|Education|Gamification,340000.0,USA,1,2,0,16077,16077,0
Software,7700000.0,NOR,2,2,1329,13670,14999,0
Blogging Platforms|Curated Web|Web CMS,22600000.0,JPN,3,5,1043,12165,13208,1
Games,17999998.0,USA,3,5,1031,14089,15120,0
Web Hosting,106392886.0,GBR,2,2,290,15257,15547,0
E-Commerce|Facebook Applications|Social Buying|Social Commerce|Social Media,2300000.0,USA,1,6,0,15231,15231,1
Games,52588928.0,HKG,2,3,560,14630,15190,0
Mobile|Mobile Commerce|Mobile Video|Specialty Foods|Startups|Video,492770.0,GBR,4,3,1035,15248,16283,0
E-Commerce,650000.0,USA,1,6,0,15838,15838,0
Clean Technology,13410000.0,CAN,3,10,1881,12432,14313,0
Construction|Industrial Automation|Technology,2500000.0,CAN,1,1,0,13909,13909,1
K-12 Education|Software,18000.0,USA,1,1,0,16111,16111,0
Real Estate,201000000.0,ARE,1,1,0,16097,16097,0
Manufacturing,14750000.0,IND,1,1,0,15951,15951,0
Apps|Bridging Online and Offline|Navigation|Online Scheduling|Transportation|Travel,2010193.0,AUS,3,6,579,15308,15887,0
Android|Apps|DIY|iPhone|Mobile,212115.0,CHE,1,1,0,15065,15065,0
Manufacturing,18865204.0,EST,3,3,793,15796,16589,0
Software,1500000.0,IND,1,1,0,13467,13467,0
Games,1270000.0,FRA,1,1,0,13279,13279,0
Crowdsourcing|Design|Software|Venture Capital,500000.0,USA,2,2,399,16071,16470,0
3D|Finance|FinTech|Software,9500000.0,USA,3,17,868,15734,16602,0
Media|News|Travel,1100000.0,USA,2,14,93,15840,15933,0
Online Travel|Ticketing|Travel|Travel & Tourism,2800000.0,CHE,2,3,1055,15645,16700,0
Curated Web,65885.0,BGR,2,2,123,15826,15949,0
Education|Games,25000.0,USA,2,2,579,14031,14610,0
Business Services|Consulting|E-Commerce|Sales and Marketing,20000.0,USA,2,1,402,15911,16313,0
Human Resources|Recruiting,20000.0,USA,1,1,0,15764,15764,0
EdTech|Education|Internet|Software|Training,7520836.0,USA,3,7,727,16028,16755,0
Apps|Freelancers|Freemium|Recruiting|Search|Skill Assessment|Social Network Media|Social Recruiting,22085400.0,IRL,3,1,822,14683,15505,1
Android|Games|Mobile Games|Web Development,500000.0,ZAF,1,1,0,14123,14123,0
Architecture|Databases|EdTech|Education|Events|Internet|Software|Testing|Training|Web Development,5000000.0,GBR,1,1,0,15680,15680,0
EdTech|Education,10750168.0,USA,4,18,1034,15095,16129,0
Curated Web|Local|Service Providers,1100000.0,USA,1,8,0,14902,14902,1
EdTech|Education,4000000.0,IND,1,1,0,15884,15884,0
Employment|Enterprise Software|Human Resources,1800000.0,USA,2,7,2403,14004,16407,0
Games|Mobile Games,31000000.0,USA,4,10,1043,15659,16702,0
Collaboration|Social Bookmarking,28437.0,GBR,1,1,0,16130,16130,0
Education,100000.0,USA,1,1,0,15637,15637,0
Hospitality,11700.0,CHN,1,1,0,15946,15946,0
Android|Exercise|Fitness|Health and Wellness|iPhone|Mobile,20000.0,USA,1,1,0,15095,15095,0
Advertising|Performance Marketing,25292877.0,GBR,7,18,2591,13879,16470,0
mHealth|Mobile,769131.0,GBR,5,4,799,15461,16260,0
Manufacturing,12000000.0,USA,1,1,0,15134,15134,0
Peer-to-Peer|Software|Television|Video,23414268.0,GBR,3,4,607,13180,13787,1
Biotechnology,68438712.0,USA,5,16,2381,12025,14406,1
Health and Wellness,100000.0,USA,1,1,0,15779,15779,0
Health and Wellness|Lifestyle,3400000.0,NLD,2,1,1330,15340,16670,0
Hospitals,2500000.0,USA,1,1,0,16468,16468,0
Social Media,750000.0,USA,1,1,0,15371,15371,0
Mobile,536071.0,FRA,2,1,854,15033,15887,0
Health and Wellness,67900000.0,USA,5,9,1618,14851,16469,0
Brand Marketing|Customer Service|Retail|Retail Technology,150000.0,USA,2,1,243,16283,16526,0
Chat|Events|Online Dating|Social Media|Social Network Media,22000000.0,USA,2,1,642,14791,15433,0
Curated Web|Education,100000.0,USA,3,2,533,14228,14761,0
Enterprise Software,750000.0,USA,1,1,0,16071,16071,0
Augmented Reality|Automotive|Consumer Electronics|Public Safety|Wearables,14950000.0,USA,3,10,200,16293,16493,0
Fitness|Health and Wellness|Technology,6348000.0,USA,4,6,945,15811,16756,0
CRM|Software,3000000.0,CAN,1,1,0,15978,15978,0
Cars|Internet|Online Rental|Service Providers,1300000.0,USA,1,7,0,16714,16714,0
Automotive|B2B|Brand Marketing|CRM|Enterprises|Mobile|Mobility|Point of Sale|Retail|SaaS|Sales and Marketing,28000.0,USA,1,1,0,15737,15737,0
Collaboration|Curated Web|Design|Web Design,40000.0,AUS,2,1,429,15530,15959,0
Curated Web|Internet,4000000.0,CHN,2,2,428,13695,14123,1
Consumer Electronics,3830126.0,GBR,1,1,0,16584,16584,0
Semiconductors,15000000.0,USA,1,2,0,13165,13165,0
Cloud Computing|E-Commerce|Enterprise Software|File Sharing|Flash Storage|Synchronization,25000.0,POL,1,1,0,14606,14606,0
Software,48000000.0,USA,4,14,1545,12006,13551,0
Aerospace|Big Data,91000000.0,USA,3,11,991,14456,15447,1
Network Security|Security,23754000.0,USA,5,16,2837,13235,16072,0
Social Games|Stock Exchanges|University Students,40000.0,USA,1,1,0,15778,15778,0
Analytics|Networking|Real Time,12258800.0,USA,2,2,365,15431,15796,0
Aerospace|Drones|Hardware|Hardware + Software|Robotics|Security,46670000.0,USA,7,29,833,15833,16666,0
Manufacturing,51799476.0,USA,6,10,4003,12293,16296,0
Cloud Security|Data Security|Service Providers,100000.0,ARM,1,1,0,16547,16547,0
Security,11000000.0,USA,2,4,861,15657,16518,0
Android|Messaging|Mobile|Networking|Photography|Photo Sharing,4000000.0,USA,2,1,241,13910,14151,0
Algorithms|Innovation Engineering|Navigation,3000000.0,USA,1,3,0,16450,16450,0
Cloud Management|Collaboration|Content|Document Management|Enterprise Software|File Sharing|Social Business|Storage,32435444.0,GBR,1,2,0,15597,15597,0
Education|Internet|Language Learning,13000.0,RUS,1,1,0,15431,15431,0
Mobile,205000.0,USA,2,1,991,15705,16696,0
Enterprise Software,51600000.0,USA,1,3,0,15757,15757,1
Hardware + Software,18000000.0,USA,2,7,701,13018,13719,0
Enterprise Software,40800000.0,USA,5,17,1949,13676,15625,1
Aerospace|Drones|Technology,120000.0,USA,1,2,0,16591,16591,0
Clean Technology|Solar,18600000.0,USA,2,2,268,13702,13970,0
Android|Apps|Cloud Data Services|CRM|Databases|Enterprise Resource Planning|Enterprises|Enterprise Software|iOS|Mobile|Mobile Software Tools|Mobility|SaaS|Security|Software,4500000.0,USA,3,8,653,15831,16484,0
Content|Ediscovery|File Sharing|News|Real Time,13250000.0,USA,2,7,948,13149,14097,0
Cloud Security|Data Security|Enterprise Software|Information Security,66500000.0,USA,3,6,805,15439,16244,0
Consumer Electronics|Gps|Location Based Services|Mobile,16800000.0,USA,3,10,1292,12418,13710,1
Enterprise Software,17227000.0,USA,5,4,1204,15412,16616,0
E-Commerce,661000.0,NOR,1,2,0,15984,15984,0
Services,3400000.0,USA,1,2,0,11562,11562,1
Health and Wellness,23750000.0,USA,4,8,3906,12003,15909,1
Finance,8200000.0,USA,1,2,0,14893,14893,0
Clean Technology,3000000.0,USA,2,4,335,15523,15858,0
Health Care,18101676.0,USA,5,1,2122,14552,16674,0
Health and Wellness|Health Care|Health Care Information Technology|Mobile Health,800000.0,USA,1,3,0,16679,16679,0
Environmental Innovation,4500000.0,IND,1,2,0,16288,16288,0
Clean Technology|SEO,482000.0,CAN,2,2,456,14158,14614,0
Cloud Computing|Enterprise Software|Gas|Oil|Software|Startups,466888.947980726,IRL,7,6,507,15411,15918,0
Apps|Mobile|Taxis,41250.0,HKG,1,1,0,16071,16071,0
Clean Technology|Environmental Innovation|Technology,143500000.0,USA,5,15,1564,14648,16212,0
Messaging|Mobile|Software|Video Conferencing|VoIP,76805032.0,LUX,5,9,3027,11688,14715,1
Travel,1539933.0,CZE,3,3,1127,15340,16467,0
Web Hosting,92800000.0,USA,5,16,2647,11323,13970,1
Information Technology,30000000.0,USA,1,3,0,16540,16540,0
Finance|Finance Technology|FinTech|Hedge Funds|Reviews and Recommendations|SEO|Social Media|Social Network Media,370000.0,USA,3,5,3837,12784,16621,0
Security,10230000.0,FRA,2,4,546,13038,13584,0
Advertising,17000000.0,USA,2,6,499,13444,13943,0
Wireless,23500000.0,USA,1,4,0,16652,16652,0
Development Platforms|Manufacturing|Market Research,752472.0,ITA,1,1,0,16062,16062,0
Mobile,2600000.0,USA,1,1,0,15167,15167,0
Search|Transportation|Travel,5188839.15290471,GBR,2,2,2163,13818,15981,0
Advertising|Brand Marketing,500000.0,USA,2,14,195,15482,15677,0
Aerospace|Drones,120000.0,USA,1,2,0,16591,16591,0
Aerospace|Drones|Robotics,3595000.0,USA,2,3,812,15936,16748,0
Databases|Software,31889536.0,FIN,5,10,1613,14879,16492,0
Clean Technology,6500000.0,USA,3,9,854,15447,16301,0
Cloud Computing|Enterprise Software|SaaS,64510000.0,USA,6,20,2696,13726,16422,0
Analytics|Video|Video Streaming,6000000.0,USA,1,2,0,13010,13010,0
Analytics|Big Data|Machine Learning,21575000.0,USA,4,9,432,15393,15825,0
Mobile Games,41250.0,HKG,1,1,0,16071,16071,0
Android|Apps|App Stores|Entertainment|Games|iOS|iPad|iPhone|Licensing|Mobile,1200000.0,USA,1,6,0,15566,15566,0
Drones|SaaS|Software,5771999.0,USA,3,11,345,16208,16553,0
Gps|Mobile|Tracking,12300000.0,CAN,1,2,0,11992,11992,1
Software,4000000.0,USA,1,3,0,13649,13649,0
Advertising|Content|Internet Marketing|Sales and Marketing|Search|Semantic Search|SEO,25456000.0,USA,5,4,1284,15037,16321,0
Drones|Education|Hardware + Software|Open Source|Robotics,335000.0,USA,2,3,276,16191,16467,0
Crowdsourcing|Recruiting,50000.0,USA,1,1,0,15999,15999,0
Collaboration|Enterprise Software|Unifed Communications,339950000.0,USA,7,30,2296,14245,16541,0
Music,75663277.0,USA,6,17,1429,13586,15015,0
Analytics|Big Data|Data Centers|Development Platforms,3883838.0,USA,2,7,322,16324,16646,0
Manufacturing,285000.0,USA,1,1,0,16526,16526,0
Education,1100000.0,USA,1,3,0,15770,15770,0
Hardware + Software|Social Network Media,15000.0,USA,1,1,0,14152,14152,0
Biotechnology,7150000.0,USA,1,1,0,15512,15512,0
Health Care,33100000.0,USA,3,11,2859,11688,14547,0
Electronics,7000000.0,CHN,1,2,0,16636,16636,0
Curated Web|Travel,200000.0,MUS,2,1,335,15491,15826,0
Curated Web,1000000.0,USA,1,1,0,13858,13858,0
Education|Games,20000.0,USA,2,1,212,15614,15826,0
Advertising|App Marketing|Audio|Content|Digital Media|EBooks|NFC|QR Codes|Software|Video,150000.0,USA,1,2,0,15917,15917,0
Finance Technology|Financial Services|FinTech,2000000.0,USA,2,11,169,16222,16391,0
Artists Globally|Consumer Goods|Gambling|Games|Investment Management|Music,4800000.0,GBR,3,3,610,13300,13910,0
Enterprise Software,15000000.0,USA,1,3,0,14099,14099,0
Security,20000.0,USA,1,1,0,15958,15958,1
Photography|Public Relations|Social Network Media|Software|Web Tools,78000000.0,USA,4,10,1095,12784,13879,1
Mobile|Presentations|SaaS|Software,480000.0,USA,6,10,624,15826,16450,0
Advertising|Advertising Platforms|Android|Mobile Advertising,1200000.0,USA,1,2,0,16531,16531,0
Art|Creative|Curated Web|Hardware|Internet|Mobile|Music|Photography|Social Media|Video|Visualization,7300000.0,USA,2,2,830,15340,16170,0
Email|Mobile,120000.0,USA,1,1,0,16405,16405,0
Credit Cards|E-Commerce|Mobile|Payments,2100000.0,USA,2,7,524,15516,16040,0
Enterprise Software|Presentations|Web Development,7000000.0,USA,2,3,567,13878,14445,1
Curated Web,3000000.0,USA,2,7,127,13879,14006,1
Events,120000.0,CZE,1,1,0,15927,15927,0
3D|Games,2750000.0,USA,2,4,181,14518,14699,0
Travel,1000000.0,USA,2,2,1722,15006,16728,0
Hardware + Software|Television,14500000.0,USA,2,6,242,12723,12965,1
News|Social Media,15000.0,USA,1,1,0,14031,14031,1
Assisitive Technology|Chemicals|Specialty Chemicals,3000000.0,USA,1,1,0,16372,16372,0
Curated Web|Social Media|Twitter Applications,20000.0,USA,1,1,0,14852,14852,0
Service Providers|Telecommunications|Wireless,900458.0,IND,1,1,0,15034,15034,0
Biotechnology,10691320.0,DEU,2,6,897,12921,13818,1
Software,390000.0,USA,2,6,30,16495,16525,0
Consulting,64420000.0,GBR,1,1,0,14034,14034,0
Email|Information Technology|Logistics|Software|Supply Chain Management|Tracking,150000.0,GBR,1,1,0,13439,13439,0
E-Commerce|Internet|Search|Startups|Wine And Spirits,200000.0,GBR,1,1,0,13300,13300,0
Curated Web|Visual Search,37400000.0,CAN,5,11,723,15846,16569,1
Manufacturing,788821.0,NLD,1,1,0,16168,16168,0
Advertising,43100000.0,USA,5,10,2408,13879,16287,0
Cosmetics|E-Commerce,20000.0,USA,1,1,0,14730,14730,0
Digital Media|High Schools,2075000.0,USA,2,5,113,16553,16666,0
Advertising|Brand Marketing|Mobile,1087178.0,ESP,2,4,374,15513,15887,0
Logistics|Shipping,70000.0,USA,1,1,0,15340,15340,0
Health Care,244000000.0,USA,6,13,1436,13879,15315,1
Curated Web,2616169.0,USA,4,12,927,14610,15537,0
Entertainment|Games|Mobile|Startups,3850000.0,FIN,2,5,369,15996,16365,0
Communities|Enterprise Software|Social Media Platforms,1000000.0,USA,1,1,0,13957,13957,1
E-Commerce|Furniture,8315464.0,FRA,2,2,1640,14957,16597,0
News,1500000.0,USA,1,2,0,11376,11376,0
Blogging Platforms|Communities|Curated Web|MicroBlogging|Networking|Twitter Applications,5100000.0,CHE,4,11,2086,13879,15965,0
Advertising,4000000.0,USA,1,1,0,13088,13088,0
Health Diagnostics|Web Hosting,9664366.0,AUT,2,2,890,13725,14615,0
Events|Ticketing,41500.0,GBR,2,1,578,15315,15893,0
Financial Exchanges|Gambling|Marketplaces|Sports,2710000.0,GBR,4,4,1757,14000,15757,0
Transportation,3000000.0,USA,2,16,258,16310,16568,0
B2B|Enterprise Software|Facebook Applications|Information Technology|SaaS|Social Business|Social Media|Social Network Media|Twitter Applications,3187382.31283572,FIN,7,3,1016,15674,16690,0
Advertising,30000.0,EST,1,1,0,16495,16495,0
Active Lifestyle|Nutrition|Specialty Foods,875000.0,USA,2,1,739,15706,16445,0
Games,3650000.0,JOR,2,1,404,14379,14783,0
Education,3000000.0,USA,2,16,301,15998,16299,0
Advertising,2000000.0,RUS,1,1,0,15994,15994,0
Transportation,550000.0,IND,1,1,0,16191,16191,0
Analytics,6410909.0,GBR,1,1,0,15245,15245,0
Travel,13000000.0,USA,3,3,540,14236,14776,0
Home Automation,12500.0,HKG,1,1,0,16252,16252,0
Aerospace,29225.0,MEX,2,2,212,16314,16526,0
Semiconductors,5000000.0,CAN,2,5,876,15430,16306,0
Hardware + Software,3895881.0,SWE,1,1,0,15757,15757,0
Curated Web|Furniture|Home & Garden,8660000.0,USA,6,1,3554,12657,16211,0
Curated Web,125000.0,USA,2,4,386,15706,16092,0
Health Care,6790000.0,GBR,1,1,0,12815,12815,0
Clean Technology,3496500.0,DEU,1,2,0,15469,15469,0
Big Data|Business Intelligence|Data Integration|Enterprise Software|SaaS,4099999.0,JPN,1,1,0,16643,16643,0
Computers|Information Services|Technology,15000.0,USA,1,1,0,16495,16495,0
Energy,11378.0,EST,1,1,0,16298,16298,0
E-Commerce,7039987.0,USA,3,7,684,15575,16259,0
Software,40000.0,CHL,1,1,0,15939,15939,0
Manufacturing|Medical Devices|Product Development Services,6500000.0,ISR,1,1,0,16185,16185,0
Big Data Analytics|Hardware + Software,18000.0,USA,3,3,300,15785,16085,0
Health and Wellness,50000.0,USA,1,1,0,16455,16455,0
Clean Technology,12000000.0,USA,1,1,0,15953,15953,0
E-Commerce|Home Renovation|Lead Generation,2614987.0,USA,3,2,1332,15431,16763,0
Hardware + Software,3959672.0,USA,2,4,10,16077,16087,0
Data Mining|EdTech|Education,12000000.0,AUS,2,3,1155,14975,16130,0
Software,3150000.0,FRA,1,3,0,11346,11346,0
Hardware + Software|Internet of Things|Medical Devices|Mobile Health,6100000.0,USA,1,4,0,16608,16608,0
Electrical Distribution|Manufacturing|Semiconductors,45742501.0,USA,3,2,930,15659,16589,0
Finance,1381877.0,FRA,1,10,0,16184,16184,0
Finance|Sales and Marketing,7600000.0,USA,3,12,588,15566,16154,0
Public Transportation,666953.0,ESP,8,8,1065,15522,16587,0
Energy|Energy Efficiency|Energy Management,5445337.0,DEU,1,1,0,16077,16077,0
E-Commerce|Fashion|Online Shopping|Retail,9000000.0,USA,1,4,0,11925,11925,0
Finance Technology|FinTech|Payments|Subscription Businesses|Subscription Service,750000.0,BRA,2,3,516,15979,16495,0
Public Relations,91239.0,CHL,1,1,0,16287,16287,0
Biotechnology,5220000.0,USA,4,7,1185,13269,14454,1
Software,3000000.0,USA,1,1,0,16044,16044,0
Curated Web|Facebook Applications|Internet|Match-Making|Online Dating,7800000.0,FRA,2,1,265,14670,14935,0
Analytics,178149887.0,USA,6,18,2988,13536,16524,0
Electrical Distribution|Energy|Renewable Energies|Smart Grid,4798337.0,GBR,2,4,381,15340,15721,0
Content|EdTech|Education,12500.0,PHL,1,1,0,16252,16252,0
Analytics|Email Marketing|Marketing Automation|Sales and Marketing,25325496.0,USA,4,3,974,15657,16631,0
3D|3D Technology|Architecture|Cloud Data Services|ICT,2636357.0,CHE,4,1,910,15693,16603,0
Education|Enterprise Software|Human Resources,6350000.0,USA,5,16,991,15138,16129,1
Software,5000000.0,NOR,1,1,0,15001,15001,1
Software,250000.0,USA,2,1,301,15271,15572,0
Software,8520000.0,FRA,2,7,1169,13027,14196,0
App Marketing|Email|Email Marketing|Social Media Marketing|Software,30000000.0,GBR,1,1,0,15622,15622,1
Finance|FinTech,5170000.0,GBR,1,1,0,14217,14217,0
Drones|Teaching STEM Concepts|Toys,100000.0,DNK,1,1,0,16751,16751,0
Recruiting,120000.0,USA,1,1,0,16405,16405,0
Clean Technology,40000.0,CHL,1,1,0,16051,16051,0
Hardware + Software,453000.0,FRA,1,2,0,14802,14802,0
Consumer Goods|EdTech,200000.0,IND,1,1,0,16735,16735,0
Semiconductors,4011821.0,GBR,2,4,1211,15084,16295,0
B2B|E-Commerce|Enterprise Software,63099998.0,USA,4,26,1525,14686,16211,0
Web Hosting,27000000.0,USA,2,5,356,12458,12814,0
Ad Targeting|Advertising Platforms|Analytics|Optimization|Social Media Advertising,2775372.0,FIN,1,1,0,16555,16555,0
Algorithms|Crowdfunding,1400000.0,RUS,1,1,0,15553,15553,0
Apps|Mobile|News,50200000.0,JPN,4,12,593,15931,16524,0
EdTech|Education,370000.0,USA,2,2,351,15932,16283,0
Advertising|Education,1750000.0,CHN,4,3,1241,15271,16512,0
Software,1400000.0,USA,1,3,0,16224,16224,0
Internet|Mobile Payments|Service Providers,10000000.0,CHN,2,4,490,13010,13500,0
Apps|Mobile|Payments,240000.0,IND,1,1,0,16468,16468,0
Telecommunications,4000000.0,USA,1,2,0,11519,11519,0
Analytics|Enterprise Software,1825000.0,USA,4,2,949,15461,16410,0
Enterprise Software|Recruiting|SaaS|Social Recruiting,24960000.0,USA,3,8,1248,15348,16596,0
Home Automation,6475000.0,USA,2,9,335,16345,16680,0
Collaboration|Enterprise Software|Project Management|SaaS,68440000.0,USA,6,9,2518,13677,16195,0
Collaborative Consumption|Crowdsourcing|Curated Web|Freelancers|Marketplaces|Photography|Product Development Services|Video,750000.0,USA,3,2,846,14994,15840,0
Software,250000.0,USA,1,2,0,12866,12866,1
Web Hosting,20868675.0,USA,5,3,1177,15554,16731,0
Sports,1800000.0,USA,1,2,0,16616,16616,0
Hospitality|Mobile Commerce|Travel,20000.0,USA,1,1,0,16290,16290,0
Certification Test|E-Books|EdTech|Education,10600000.0,CHN,1,1,0,16324,16324,0
Web Hosting,81670000.0,USA,6,22,3599,11429,15028,1
Home Automation|Internet|Internet of Things|Mobile|Open Source,15500000.0,USA,2,28,343,15678,16021,1
Advertising,5000000.0,USA,1,2,0,13901,13901,0
Analytics,3400000.0,USA,1,2,0,16650,16650,0
Agriculture|Sensors|Wine And Spirits,40000.0,HUN,1,1,0,15440,15440,0
Enterprise Software,22357298.0,USA,5,6,1924,14649,16573,0
Collaboration|Enterprise Software|Reviews and Recommendations|SaaS,200000.0,DEU,1,1,0,15826,15826,0
E-Commerce|Health and Wellness|Nutrition,19500978.0,USA,6,5,1847,14791,16638,0
Software,400000.0,GBR,1,14,0,16356,16356,0
Biotechnology,4000000.0,USA,1,1,0,16735,16735,0
Music|Television,120000.0,USA,4,4,1308,14245,15553,0
Messaging,1350000.0,USA,1,1,0,14354,14354,0
College Recruiting|Enterprise Software|Recruiting|SaaS|Social Recruiting|Software,9000000.0,USA,1,1,0,16245,16245,0
Curated Web|Fitness|Health and Wellness|Social Media|Sports,40000.0,USA,1,1,0,15307,15307,0
Clean Energy|Clean Technology|Residential Solar|Solar,670000.0,USA,1,2,0,15977,15977,0
Android|Big Data|Consumer Electronics|Hardware + Software|Home Automation|iOS,50000.0,USA,1,1,0,16604,16604,0
EdTech|Education,5989120.0,KOR,3,4,1542,14975,16517,0
Software,3000000.0,USA,1,1,0,15931,15931,0
3D|Games|Startups|Virtual Worlds,11735160.0,DEU,3,2,1179,13431,14610,0
Apps|Health Care|Pets,6000000.0,CHN,1,2,0,16591,16591,0
Software,3593500.0,FRA,1,1,0,14624,14624,0
Android|Apps|iOS|Mobile|Parenting|Social Media|Social Network Media,1206905.0,KOR,2,5,495,15910,16405,0
Internet|Services|Telecommunications,365000000.0,MUS,2,9,0,16686,16686,0
Consumer Internet,14399999.0,USA,4,6,1483,13180,14663,1
Big Data|Machine Learning|SaaS,500000.0,USA,2,1,25,16531,16556,0
Manufacturing,67000000.0,USA,2,1,1566,14636,16202,0
Games,29000000.0,USA,1,5,0,14481,14481,0
Fashion,1022917.0,GBR,1,1,0,15483,15483,0
Music|Software,325000.0,USA,3,2,272,15950,16222,0
Consumer Electronics,100000.0,USA,1,1,0,15737,15737,0
Nanotechnology,2500000.0,SWE,1,1,0,15706,15706,0
Finance|Financial Services|FinTech|Personal Finance,20000.0,USA,1,1,0,15859,15859,0
Curated Web|Design|Finance|Printing|Web Development,2125000.0,USA,3,15,917,15279,16196,0
Clean Technology|Mobility|Transportation,1100000.0,SGP,1,3,0,16318,16318,0
Enterprise Software|Marketplaces|Property Management|SaaS,105000000.0,USA,3,5,1413,15147,16560,0
Mobile,22000000.0,IND,2,5,588,14629,15217,0
Health Care,10500000.0,ISR,1,1,0,15067,15067,0
Audio|iPhone|Mobile|Music,80100000.0,USA,7,18,2669,13879,16548,0
Security,1670000.0,NZL,1,2,0,14445,14445,0
Mobile Games,1975141.0,KOR,1,2,0,16262,16262,0
Health and Wellness|Medical|Mobile|Pharmaceuticals,843973.0,SWE,3,2,761,15218,15979,0
Consulting|Technology,41000000.0,USA,3,10,1688,13355,15043,0
Apps|Entertainment|Film|Social Media|Video,29472731.0,USA,4,11,1074,14990,16064,0
Advertising|Mobile|Tablets,13450000.0,AUS,5,1,601,15248,15849,1
Hardware + Software,11300000.0,USA,1,2,0,11975,11975,0
Curated Web,10000000.0,USA,1,2,0,12965,12965,0
B2B|Content Creators|Contests|Lead Generation|Market Research|Polling|Promotional|Software|Surveys,12000000.0,USA,1,1,0,16742,16742,0
Software,9550000.0,USA,2,5,1014,12090,13104,0
Service Providers|Software|Taxis|Transportation,2467622.0,FRA,1,2,0,16413,16413,0
Bitcoin|Social Commerce,1560000.0,USA,2,11,309,16040,16349,0
File Sharing|Messaging|Mobile|Photography,1185585000.0,USA,8,19,1123,15461,16584,0
Apps|File Sharing|iOS|Mobile|Photography,85000.0,USA,1,1,0,15908,15908,0
E-Commerce,1897699998.0,IND,11,34,1690,14975,16665,0
Fashion,4000000.0,JPN,1,3,0,16279,16279,0
Fashion|Location Based Services|Mobile|Shopping|Social Media,1500000.0,USA,1,2,0,15259,15259,1
Apps,69218.0,LVA,1,1,0,16190,16190,0
Photography|Photo Sharing,43500000.0,USA,2,5,182,10896,11078,1
Mobile|Software,4141000.0,USA,2,1,406,16083,16489,0
Curated Web,10000000.0,USA,3,14,833,15133,15966,1
Software,22300000.0,USA,2,9,211,12975,13186,1
3D|Architecture|Kinect|Real Estate|Smart Building|Software,432950.0,FRA,3,7,533,15948,16481,0
Identity|Social Media|Social Network Media,650000.0,USA,1,1,0,13634,13634,0
Development Platforms|Loyalty Programs|Nightclubs|Restaurants,580000.0,IND,1,1,0,16130,16130,0
Cloud Computing|Cloud Data Services|Data Integration|Enterprise Software|Internet|SaaS,58799998.0,USA,7,13,2709,13655,16364,0
Health Care,600000.0,USA,1,2,0,15932,15932,0
Domains|E-Commerce,8800000.0,USA,3,4,213,11474,11687,1
Android|Apps|Consumer Electronics|iPhone|Mobile|NFC|Software,3798030.0,FRA,3,6,861,13929,14790,0
App Stores|Mobile,5000000.0,USA,1,1,0,13330,13330,0
Cloud Computing|Curated Web|Social Television|Television|Video,2859260.0,USA,3,6,480,15579,16059,1
Email Marketing|Marketing Automation|SaaS|Social Media Marketing|Software|Web CMS,11850000.0,USA,3,1,1407,15030,16437,0
Advertising|Brand Marketing|E-Commerce|Mobile|Mobile Advertising,8750000.0,USA,2,12,569,15971,16540,0
Tracking,10000.0,USA,1,1,0,15857,15857,0
Biofuels|Energy,115000.0,USA,2,2,1408,15064,16472,0
Big Data Analytics|Consulting|EdTech|Education|Hospitality|Hotels|New Technologies|SaaS|Startups,30042016.634582,AUT,2,1,456,16161,16617,0
SEO|Video|Web Design|Web Development,325000.0,USA,2,2,37,15912,15949,0
Design|DIY|E-Commerce|Fashion|iOS|Mobile|Mobile Commerce,1950000.0,HKG,3,11,552,15763,16315,0
Advertising,4000000.0,USA,1,4,0,13671,13671,1
Discounts|Local Search|Price Comparison|Travel & Tourism,1409268.0,GBR,2,2,415,16040,16455,0
Mobile,6000000.0,GBR,1,2,0,14782,14782,1
Apps,600000.0,USA,1,10,0,16252,16252,0
Mobile,3500000.0,USA,1,1,0,16007,16007,0
Audio|Messaging|Mobile,12000000.0,USA,2,5,427,13330,13757,1
Contests|Photo Sharing,50000.0,USA,1,1,0,16307,16307,0
Biotechnology,192243015.0,USA,8,27,3065,13606,16671,1
Software,25000.0,USA,1,1,0,16083,16083,0
Curated Web|Image Recognition|Video,15000.0,USA,1,1,0,14031,14031,0
E-Commerce|Social Buying,4074999.0,USA,3,3,1183,14533,15716,0
Music,500000.0,USA,1,2,0,16071,16071,0
Application Platforms|Information Technology|Mobile|Software,6300000.0,FRA,1,6,0,16612,16612,0
Coupons|iPhone|Mobile|Mobile Coupons|Promotional,2845000.0,USA,3,16,591,15471,16062,1
3D|Android|Apps|Games|iOS|Windows Phone 7,16000.0,ISL,1,1,0,15871,15871,0
Design|E-Commerce|Fashion|Lifestyle|Shopping,1967400.0,USA,4,4,796,15859,16655,0
Content|Games|Peer-to-Peer|Social Network Media,25000000.0,USA,3,6,1520,11688,13208,1
Lifestyle Products,17000.0,USA,1,1,0,15796,15796,0
Android|Enterprise Software|Home & Garden|iOS|IT and Cybersecurity|Mobile|Mobile Devices|Privacy|Security,2065000.0,USA,4,2,723,15887,16610,0
News|Reviews and Recommendations|Shopping|Wine And Spirits,3300000.0,USA,4,7,777,13483,14260,0
Curated Web,1286600.0,DEU,1,1,0,16077,16077,0
Mobile|Software,37345000.0,USA,3,16,5404,10947,16351,0
Analytics|Performance Marketing|Social Media,5250000.0,USA,2,8,365,14944,15309,1
Finance,53084832.0,CHN,3,4,1199,15126,16325,0
Pharmaceuticals,500000.0,USA,1,1,0,13594,13594,0
Software,65000000.0,USA,2,8,245,16364,16609,0
Business Development|Business Services|Finance Technology|FinTech,6000000.0,USA,1,1,0,13341,13341,0
Security|Sports|Twin-Tip Skis,1060000.0,USA,3,1,574,15496,16070,0
Maps|Project Management|Sensors,66874.0,LVA,1,1,0,16297,16297,0
Logistics|Services|Supply Chain Management,10400000.0,IND,1,1,0,15870,15870,0
Mobile|Mobile Games|Security|Toys,3547000.0,USA,5,11,1208,15339,16547,0
Analytics|Neuroscience|Psychology|Text Analytics|Twitter Applications,50000.0,NLD,1,1,0,15422,15422,0
Medical Devices,404688.0,CAN,1,1,0,16596,16596,0
Clean Technology|Consulting|Energy Efficiency|Enterprise Software|Home Renovation|SaaS|Social Media,155000.0,USA,2,1,540,14944,15484,0
Consumer Electronics|Mobile|Security|Sensors,12776691.0,USA,4,4,783,15680,16463,1
Curated Web,5000000.0,GBR,1,1,0,16170,16170,0
Consumers|Mobile|Social Network Media,521000.0,SGP,1,2,0,15882,15882,0
Software,415000.0,GBR,1,1,0,13830,13830,0
Cloud Data Services|Cloud Security|Developer APIs|Software,21000000.0,USA,2,7,2846,13311,16157,0
Clean Technology,10000000.0,USA,1,2,0,14503,14503,0
Curated Web,3095517.74153607,GBR,2,3,936,15786,16722,0
Application Performance Monitoring|Cloud Computing|Cloud Data Services|Enterprise Software|Information Services|Information Technology|Internet|Software|Testing,89891428.0,USA,9,21,3395,13266,16661,0
Software,40000.0,CHL,1,1,0,15638,15638,0
Social Media|Software|Technology|Young Adults,1100000.0,USA,1,2,0,16317,16317,0
Shared Services|Travel,18000000.0,KOR,1,1,0,16357,16357,0
Games,490567.0,GBR,2,2,279,16057,16336,0
Social Media,1500000.0,USA,1,2,0,16391,16391,0
Digital Media|E-Commerce|Enterprise Software|Marketing Automation|SaaS|Social Commerce,7000000.0,USA,2,9,664,14609,15273,0
Advertising,1277939.0,ESP,4,4,638,15614,16252,0
M2M|Public Transportation|Social Media|Transportation,1300000.0,USA,7,8,825,15826,16651,0
Marketing Automation,2000000.0,CAN,1,4,0,16769,16769,0
Health Care,120000.0,USA,1,1,0,16495,16495,0
Advertising|Contests|Events|Fashion|Loyalty Programs|Networking|SaaS|Social Media,20000.0,USA,1,1,0,14352,14352,0
Internet Marketing|Social Media|Social Network Media,4800000.0,USA,2,4,150,16559,16709,0
Education|Finance|Financial Services|Peer-to-Peer,1766199900.0,USA,11,30,1472,15236,16708,0
Nonprofits,398000000.0,USA,4,8,873,15595,16468,0
Games,152000000.0,USA,5,11,2639,14000,16639,0
Social Commerce|Software,1320384.0,USA,1,1,0,15258,15258,0
Software,20000.0,USA,1,1,0,14396,14396,0
Design|Digital Media|Web Development,400000.0,RUS,1,1,0,15584,15584,0
Brand Marketing|Enterprise Software|Fraud Detection|Social Media,4300000.0,USA,4,6,648,15156,15804,1
Software,154392.0,ESP,1,4,0,15924,15924,0
Analytics|Big Data Analytics|Business Analytics|Social Media Monitoring,1850000.0,HKG,2,2,752,15949,16701,0
Software,9750000.0,USA,2,3,491,13804,14295,0
Curated Web,560000.0,USA,1,6,0,13945,13945,1
Content|E-Commerce|Social Media,63197.0,USA,1,1,0,16345,16345,0
Facebook Applications|Games|Social Games|Social Media,44704926.0,ESP,6,8,1125,15148,16273,0
Social Media,47500000.0,USA,3,3,323,13208,13531,1
Enterprise Software|SaaS|Social Media|Software,250000.0,AUS,1,1,0,15887,15887,0
Advertising|Digital Media|Facebook Applications|Sales and Marketing|Social Media|Social Media Advertising|Social Media Marketing,29331159.0,USA,6,2,846,15531,16377,0
Advertising|Social Media,1708480.0,USA,2,3,739,15705,16444,0
E-Commerce|Facebook Applications|Search|Shopping|Social Buying|Social Media,1000000.0,USA,1,1,0,15426,15426,0
Enterprise Software|Software,11750000.0,USA,3,5,628,14055,14683,1
Promotional|Social Television|Software|Television,3800000.0,ISR,2,4,907,15400,16307,0
Event Management|Hospitality|Meeting Software|Networking|Software|Universities,9500000.0,USA,3,17,806,15482,16288,0
Social Media Marketing|Software,6005000.0,USA,4,14,1060,15485,16545,0
Advertising|Facebook Applications|Internet Marketing|Social Media,730000.0,ARG,2,3,426,15614,16040,0
Social Media,58800000.0,CHN,3,5,1222,15457,16679,0
Advertising|Internet Marketing,1701601.0,USA,2,2,401,16012,16413,0
Career Management|Consumer Electronics|Curated Web|Freelancers|Marketplaces|Outsourcing|Professional Networking,40000.0,GBR,1,1,0,15561,15561,0
CRM|Internet|Social CRM,25000.0,ARG,1,1,0,15553,15553,0
Advertising|Analytics|Information Technology|Social Media|Social Media Marketing|Social Media Monitoring,34000000.0,CZE,3,5,873,15246,16119,0
Games|Location Based Services|Mobile|Social Games,240000.0,USA,1,2,0,14214,14214,1
Analytics|Social CRM|Social Media|Twitter Applications,3269528.0,GBR,4,8,568,15294,15862,0
Advertising|Group Buying|Social Buying,500000.0,USA,1,2,0,14610,14610,0
Clean Technology,872482.0,ESP,1,1,0,16518,16518,0
Enterprise Software,9400000.0,USA,3,3,359,14340,14699,1
Content|Mobile Enterprise|SaaS|Social Media Marketing|Software,15000000.0,USA,3,4,2033,14298,16331,0
E-Commerce|Social Commerce|Social Media,298836.0,DEU,1,1,0,13879,13879,1
Consulting|Social Commerce,320000.0,IND,1,3,0,16280,16280,0
Games|iPhone|Mobile|Social Media,456506.0,CAN,1,2,0,14476,14476,1
Finance|FinTech|Social Media Management|Social Network Media|Software,12000.0,USA,1,1,0,15187,15187,1
Analytics|Business Intelligence|Social Media Management,339071.0,BEL,2,4,357,15434,15791,0
Advertising|Publishing|Sales and Marketing|Social Media,27030000.0,USA,6,17,1960,14669,16629,0
Content|Crowdsourcing|Sales and Marketing|Social Media|Software,1100000.0,USA,1,4,0,16505,16505,0
Internet|Networking|Social Media|Social Network Media,3000000.0,GBR,2,1,392,14623,15015,0
Social Media,1900000.0,USA,2,1,295,15071,15366,1
Databases|Local|Location Based Services|Mobile|Navigation|Social Media,100000.0,USA,1,1,0,16375,16375,1
Games,10618475.0,KOR,2,1,112,15309,15421,0
Apps|Content|Curated Web|Events|Film|Games|iOS|Music|Television,272633.0,GBR,2,12,308,15621,15929,0
Interest Graph|Mobile|Social Media|Social Network Media,1820000.0,USA,3,3,219,15279,15498,1
Events|Social Media|Social Network Media,2250000.0,USA,2,3,608,13149,13757,0
Advertising|Consulting|Facebook Applications|Media|Photo Sharing|Social Media|Social Network Media|Twitter Applications,300000.0,USA,1,1,0,15442,15442,0
Advertising|E-Commerce|Mobile Commerce|Shopping|Social Commerce|Social Network Media,138000.0,CHE,1,5,0,15095,15095,0
Advertising Platforms|Content Discovery|E-Commerce|Semantic Search|Social Commerce,200000.0,RUS,2,1,664,15149,15813,0
Advertising|Facebook Applications|Social Media,10000000.0,USA,3,7,516,13757,14273,1
Hotels|Reviews and Recommendations|Social Media|Social Network Media|Television,40000.0,CHL,1,1,0,15309,15309,0
Social Media,1500000.0,USA,1,2,0,15567,15567,0
Curated Web|Social Media|Stock Exchanges,500000.0,USA,1,2,0,13848,13848,1
iPhone|Local|Location Based Services|Mobile|Social Media,12750000.0,USA,1,12,0,15875,15875,0
Analytics|B2B|Big Data Analytics|Brand Marketing|Business Analytics|Business Intelligence|CRM|Enterprise Software|Messaging|Social CRM|Social Media|Social Media Management|Software|Twitter Applications,1150000.0,USA,1,4,0,16203,16203,0
Personal Data,3535000.0,GBR,4,5,767,15698,16465,0
Entertainment|Networking|Software|Television,20000.0,USA,2,2,311,15187,15498,0
Finance|Life Sciences|Software|Surveys,512000.0,USA,3,7,865,14669,15534,0
Software,10000000.0,USA,1,7,0,14887,14887,1
Hospitality|Restaurants|Retail,2216210.0,USA,2,6,657,15765,16422,0
Curated Web|Mobile|Networking|Reviews and Recommendations|Social Games,290000.0,USA,1,2,0,14883,14883,0
FreetoPlay Gaming|Games|Mobile Games|Startups,257320.0,AUT,2,4,315,15937,16252,0
Collaboration|Enterprise Software|Networking|Software|Web Tools,46770000.0,USA,8,13,3043,12418,15461,1
Finance|FinTech|Web Hosting,415000.0,USA,2,2,83,13726,13809,1
Advertising|Brand Marketing|Internet Marketing|Social Media|Social Media Management|Social Media Marketing,45000.0,USA,2,3,59,15616,15675,0
Advertising|Analytics|Facebook Applications|Media|Mobile|SaaS|Sales and Marketing|Social Media|Social Media Marketing|Technology|Twitter Applications,1500000.0,USA,1,1,0,14610,14610,0
Charity|E-Commerce|Enterprises|Humanitarian|Nonprofits|Retail,1850000.0,USA,4,2,1162,14692,15854,0
Social Media|Software,1315000.0,USA,2,1,120,14975,15095,0
Enterprise Software,15022208.0,USA,6,10,2320,13879,16199,1
Young Adults,100000000.0,USA,1,1,0,16723,16723,0
Consumer Lending|Credit|Finance Technology|Financial Services|FinTech|Peer-to-Peer|Personal Finance|Small and Medium Businesses,28737450.0,AUS,2,7,273,16134,16407,0
Enterprise Software|Financial Services,300000.0,USA,1,1,0,15450,15450,0
Search Marketing|SEO|Social Media,325000.0,IND,1,1,0,15936,15936,0
Natural Resources|Product Development Services|Sustainability,14300000.0,FRA,1,1,0,12956,12956,0
Internet,12000000.0,USA,1,2,0,12006,12006,1
Advertising,300000.0,USA,2,2,191,15271,15462,0
Games|Video,7459110.0,CHN,3,2,1157,14549,15706,0
Mobile|Technology|Wireless,3800000.0,IRL,1,1,0,14861,14861,0
Analytics|Cloud Computing|Enterprise Software|M2M,54500000.0,USA,3,10,2470,13929,16399,0
Curated Web|Education,7500000.0,USA,2,8,533,15986,16519,0
Education|Skill Assessment,750000.0,USA,1,6,0,15918,15918,1
Analytics|Meeting Software|Social Media,10000.0,AZE,1,2,0,16052,16052,0
Machine Learning|Security|Social Media,7200000.0,USA,3,16,405,16246,16651,0
News,12650000.0,USA,3,6,663,13392,14055,1
Consumer Electronics|Entertainment|Hardware + Software|Health and Wellness,9300000.0,ISR,1,1,0,14098,14098,1
Social Media,1200000.0,USA,2,13,123,14365,14488,0
Software,5330000.0,CAN,1,3,0,13532,13532,0
Biotechnology,8500000.0,USA,3,7,1409,14951,16360,0
Consulting|Fashion|Lifestyle|Online Shopping|Shopping,50000.0,RUS,1,1,0,15857,15857,0
Social Media,5000000.0,USA,1,2,0,13266,13266,0
Health Care,19633619.0,USA,5,4,2397,13984,16381,0
Banking|Business Services|Robotics,236000000.0,JPN,1,2,0,16604,16604,0
Hardware + Software,4900000.0,JPN,1,1,0,16132,16132,0
Finance|Finance Technology|Financial Services|FinTech,7500000.0,USA,1,1,0,15474,15474,1
Software,250000.0,USA,1,1,0,13398,13398,0
Mobile|SaaS|Services|Software|Translation,45000.0,HKG,1,1,0,15380,15380,0
Cloud Computing|Data Centers|Information Technology|Networking|Virtualization|Web Hosting,30000000.0,USA,2,1,176,14517,14693,1
Cloud Computing,2000000.0,KOR,1,2,0,11611,11611,0
Mobile|Payments|Services,1000000.0,VNM,1,1,0,16725,16725,0
Software|Virtualization,29600000.0,USA,2,12,2989,11897,14886,1
Software,1470000.0,KOR,1,1,0,12890,12890,0
Hardware + Software,19000000.0,USA,2,7,2366,11766,14132,1
Apps,915000000.0,GBR,1,1,0,11246,11246,0
Mobile,56170000.0,GBR,2,8,465,13521,13986,0
Automated Kiosk|Automotive|Innovation Management,3000000.0,USA,1,1,0,16412,16412,0
Information Services|Information Technology|Search|Web Browsers,448000000.0,CHN,1,1,0,15958,15958,0
Network Security,9800000.0,USA,1,4,0,16532,16532,0
Logistics|Procurement|Services,15130000.0,IND,1,2,0,16706,16706,0
Curated Web|Internet,25000000.0,CHN,2,6,3687,10317,14004,1
Accounting|Advertising|Lead Generation,600000.0,ARG,1,1,0,14883,14883,0
Advertising Platforms|Travel,42500000.0,USA,4,14,1981,14075,16056,0
EdTech|Education,2000000.0,USA,1,3,0,15758,15758,0
E-Commerce,1399997.0,USA,2,1,354,16192,16546,0
B2B|Business Intelligence|Emerging Markets|Market Research,12000.0,CAN,1,1,0,16752,16752,0
Photography|Video,1000000.0,TWN,1,1,0,14700,14700,0
Analytics|Internet Marketing|Sales and Marketing|Search Marketing|Social Media Marketing,1030000.0,IND,2,2,1403,15042,16445,0
Clean Technology|Semiconductors,5000000.0,ISR,1,1,0,16658,16658,0
Consumer Electronics,56256014.0,USA,5,5,1518,14975,16493,0
Clean Technology,22921790.0,SWE,4,8,1900,14065,15965,0
Health Care,20000000.0,USA,2,4,795,15427,16222,0
Clean Technology,67003889.0,USA,4,7,1256,13472,14728,1
Mobile|Mobility|Usability,1122467.0,ESP,3,3,2013,13533,15546,0
Clean Technology|Solar,26590000.0,FRA,2,4,231,13969,14200,0
Manufacturing,3850000.0,USA,2,1,712,14587,15299,1
Semiconductors,33800000.0,CAN,5,10,1181,15352,16533,0
Agriculture|Business Intelligence|Mobile,1025000.0,ARG,3,2,585,15870,16455,0
Renewable Energies,339987.0,GBR,1,1,0,16246,16246,0
Clean Technology,3000000.0,CHN,1,1,0,14426,14426,0
Manufacturing,58636000.0,USA,4,10,1774,14022,15796,0
Clean Energy|Clean Technology|Crowdfunding|Finance|Marketplaces|Solar,26897005.0,USA,5,9,651,15491,16142,0
Clean Technology,10000000.0,USA,1,1,0,13776,13776,0
Clean Technology,253000000.0,USA,4,7,952,13774,14726,1
Clean Energy|Clean Technology|Solar,6077370.0,USA,1,2,0,14977,14977,1
Clean Technology|Enterprise Software|Solar,50000.0,USA,1,1,0,16008,16008,0
Clean Energy|Clean Technology|Franchises|Renewable Energies,11000000.0,USA,2,2,1546,14999,16545,0
Clean Technology|Electronics|Technology,105050000.0,USA,7,15,2339,13796,16135,1
Clean Technology,40000.0,CHL,1,1,0,16029,16029,0
Software,25000000.0,USA,1,1,0,12366,12366,1
Clean Technology|Construction,1158040000.0,USA,14,25,3351,13406,16757,1
Solar,4391936.0,NZL,1,1,0,16260,16260,0
Clean Technology|Renewable Energies|Solar,85000000.0,ISR,3,19,753,14518,15271,1
Enterprise Software,242948825.0,USA,19,13,3598,12842,16440,0
Clean Technology,116169114.0,USA,5,10,1906,14585,16491,0
Design,196392.0,NZL,1,1,0,16041,16041,0
Solar,2500000.0,UGA,2,2,603,15750,16353,0
Clean Technology,1500000.0,USA,2,4,18,13973,13991,0
Clean Technology,1100000.0,ISR,1,2,0,13948,13948,0
Clean Technology,3237200.0,IRL,2,3,907,14773,15680,0
Clean Technology,182000000.0,USA,3,10,1133,14138,15271,0
Software,217500000.0,USA,3,5,1527,13118,14645,1
Clean Technology,1000000.0,USA,1,1,0,14208,14208,0
E-Commerce Platforms|Social Commerce|Social Media,26466500.0,USA,4,1,521,15340,15861,0
Advertising|Analytics|Curated Web|Design|Graphics|Market Research|Web Development,250000.0,USA,1,2,0,14153,14153,0
Chemicals|Clean Technology,146110000.0,USA,7,15,2077,12753,14830,1
E-Commerce|Facebook Applications|Social Commerce|Social Media|Software,5000000.0,USA,4,14,1077,15190,16267,0
E-Commerce|Fashion|Shoes|Startups,8000000.0,USA,1,2,0,16587,16587,0
Computers|Cyber Security,2000000.0,ISR,1,1,0,16517,16517,0
Clean Technology,2100000.0,USA,1,1,0,15223,15223,0
Advanced Materials,5800000.0,CAN,4,3,964,15561,16525,1
Business Services|Professional Services|Trading,11000000.0,USA,1,3,0,12858,12858,0
Hardware + Software,5460000.0,FRA,1,2,0,14215,14215,0
Clean Technology|Renewable Energies,120000.0,ITA,1,2,0,16591,16591,0
Clean Technology|Wearables,125000.0,USA,4,3,839,15742,16581,0
Data Integration|Health Care Information Technology|Healthcare Services,3000000.0,USA,1,2,0,16742,16742,0
Analytics|Network Security|Software,58700000.0,USA,7,11,2585,12784,15369,1
Biotechnology,172500000.0,USA,3,2,516,12895,13411,0
Clean Technology,115000000.0,USA,8,30,2709,13755,16464,0
Clean Technology,223920614.0,USA,7,34,1232,15431,16663,0
Clean Technology|Solar,211403000.0,USA,8,19,2223,13208,15431,0
Clean Technology,18000000.0,USA,1,3,0,14040,14040,1
Batteries|Electronics,44825468.0,USA,10,17,4168,12328,16496,0
Software,19236401.719285198,USA,2,4,970,12530,13500,1
Handmade|Marketplaces|Retail|Startups,100000.0,BRA,1,1,0,16100,16100,0
Software,60950000.0,USA,5,16,1722,12377,14099,1
Enterprise Software,150035000.0,USA,5,14,1525,14825,16350,0
Clean Technology,27000000.0,USA,2,8,1042,15371,16413,0
Home Automation|Internet of Things|Mobile,25000.0,ARG,1,1,0,16130,16130,0
Software,10210476.1904762,CAN,3,8,1801,13325,15126,0
Bitcoin|Financial Services|FinTech,3000000.0,USA,1,4,0,16331,16331,0
Biotechnology,21688477.0,USA,6,10,1839,14278,16117,0
Cloud Computing|Consulting|Open Source,4400000.0,USA,2,1,210,16519,16729,0
Clean Technology,68800000.0,USA,7,11,1360,14195,15555,0
Clean Technology|Solar,325000.0,USA,1,4,0,14426,14426,0
Health and Wellness,33214215.0,USA,8,4,2800,13769,16569,0
Education|Mobile,100000.0,USA,2,1,349,16339,16688,0
Networking|Telecommunications|Wireless,9500000.0,USA,2,5,246,11974,12220,1
Cloud Computing|Location Based Services|Mobile|Proximity Internet|Software,3717604.0,USA,4,3,894,15497,16391,0
Emerging Markets|Entertainment|Gambling|Mobile|Sports|Technology,3450000.0,ESP,1,1,0,15584,15584,0
Accounting|Consulting|Professional Services,3200000.0,USA,1,2,0,12803,12803,0
Clean Technology,458089999.0,USA,10,21,2051,13577,15628,1
Marketplaces|Real Estate|Real Estate Investors,3200000.0,USA,2,10,0,16730,16730,0
B2B|E-Commerce|Sales and Marketing,2285900.0,ESP,2,3,2401,13458,15859,0
Curated Web|Fashion|Health Care|Manufacturing,19253219.0,USA,3,23,435,16058,16493,0
Biotechnology,36000000.0,USA,4,4,659,15686,16345,0
Health and Wellness,2700000.0,USA,2,2,1126,15181,16307,0
Biotechnology,93000000.0,USA,2,9,495,12965,13460,1
Health Care,21950000.0,USA,2,4,53,14620,14673,1
Technology,1300000.0,FIN,1,6,0,16664,16664,0
Agriculture|Software,23500000.0,USA,3,4,877,14641,15518,1
Software,18000000.0,ISR,3,10,1269,13879,15148,1
Curated Web,10300000.0,USA,3,7,537,14484,15021,0
Software,4550000.0,CHE,1,3,0,14642,14642,0
Advertising|Mobile|Publishing|Video,16500000.0,USA,4,17,1351,14518,15869,0
Biotechnology|Health Diagnostics,2000000.0,USA,1,3,0,16203,16203,0
Technology,5000.0,USA,1,1,0,16222,16222,0
Software,1250000.0,USA,3,5,422,15712,16134,0
Manufacturing,1567504319.0,USA,8,6,1992,13149,15141,0
Green Consumer Goods|Hardware + Software,5900000.0,USA,2,26,471,15902,16373,0
Web Hosting,74560000.0,USA,2,6,1135,12943,14078,0
Biotechnology|Health Diagnostics,47499993.0,USA,5,2,1550,14841,16391,0
Biotechnology,4920000.0,USA,2,6,162,13017,13179,0
Manufacturing,8000000.0,IND,1,1,0,16128,16128,0
Biotechnology,300000.0,USA,2,4,1094,14277,15371,0
Biotechnology,93999990.0,USA,3,6,1849,12584,14433,1
Curated Web,350000.0,USA,1,2,0,13970,13970,0
Fashion,29843.0,GBR,1,1,0,15774,15774,0
Advertising|Analytics|Games|Networking|Social Media|Virtual Currency,5550000.0,USA,3,6,520,14013,14533,1
Marketing Automation,1100000.0,JPN,1,1,0,16353,16353,0
Advertising|App Marketing|Mobile,5500000.0,GBR,3,3,589,15573,16162,0
Finance|FinTech,5395000.0,USA,6,12,795,14975,15770,0
Advertising|Software,700000.0,ISR,1,1,0,14457,14457,0
Clean Technology,500000.0,USA,2,2,173,14043,14216,0
E-Commerce|Fashion|Personalization,300000.0,DNK,1,1,0,16405,16405,0
CRM|Events|Facebook Applications|Hotels|Identity|Location Based Services|Mobile|Networking|Social Media|Software|Twitter Applications,200000.0,USA,2,4,412,15340,15752,0
Biotechnology,5489792.0,USA,4,5,1574,14868,16442,0
Open Source|Software,44707328.0,USA,4,14,1471,14060,15531,0
Biotechnology,79349874.0,USA,7,12,2108,14209,16317,0
Utilities,6000000.0,USA,1,1,0,16322,16322,0
Biotechnology,41224987.0,USA,5,5,1645,13909,15554,0
Enterprise Software|Video Conferencing,2500000.0,USA,1,2,0,12997,12997,0
Media|Mobile|Music|Open Source,14956252.0,USA,4,4,1213,13423,14636,0
Music,52792.0,GBR,1,1,0,15826,15826,0
Music|Online Dating,110000.0,USA,2,2,404,14936,15340,0
Concerts|Music,32615000.0,GBR,6,10,2925,13665,16590,0
Music,6700000.0,USA,2,17,722,15236,15958,1
Archiving|Cloud Computing|E-Commerce|Email|Enterprise Software|SaaS,50786834.0,USA,6,13,2268,14454,16722,0
Advertising|Audio|Broadcasting|Content|Events|Finance|FinTech|Local|Media|SaaS|Software|Web CMS,4550000.0,USA,3,10,1321,15248,16569,0
Music,4500000.0,USA,1,1,0,13738,13738,1
Social Media,6000000.0,ARG,2,7,561,14033,14594,0
Events|Music|Music Venues|Ticketing,153000.0,CHL,4,3,380,15372,15752,0
Semiconductors,12000000.0,USA,1,5,0,13124,13124,0
Mobile,49649369.0,USA,7,6,3701,11976,15677,0
Health Care,67641704.0,USA,6,9,2789,13399,16188,0
Utilities,9301825.0,DEU,1,3,0,16407,16407,0
Advertising|Publishing|Real Time,10400000.0,USA,1,1,0,16651,16651,0
E-Commerce|Flash Sales|Hospitality|Wine And Spirits,700000.0,BRA,3,1,558,15452,16010,0
Craft Beer|Organic|Wine And Spirits,3175000.0,USA,3,4,303,15826,16129,0
Biotechnology,57492968.0,USA,5,13,2767,13654,16421,0
Mobile,21450000.0,USA,2,3,485,13149,13634,0
Consumer Electronics|Hardware + Software|iPhone|Music|Wireless,453949974.0,USA,9,9,3623,12784,16407,0
Recruiting|SaaS|Software,339000.0,IRL,2,2,1586,14757,16343,0
Communications Infrastructure|Networking|VoIP,23000000.0,USA,1,10,0,10940,10940,1
Legal,25000.0,USA,1,2,0,14031,14031,0
Cloud Security|Cyber Security|Data Security|Enterprise Software,6600000.0,USA,2,9,750,15411,16161,0
Business Services|Curated Web|Local|Local Based Services|Local Search|Reviews and Recommendations|Search|Social Commerce|Social Network Media,15000.0,USA,2,1,36,15652,15688,0
Cloud Computing|Enterprise Software|Mobile|Security,23000000.0,USA,4,14,1377,13392,14769,1
Business Services|Collaborative Consumption|iPhone|Mobile|Mobile Commerce,500000.0,GBR,1,2,0,15950,15950,0
Health and Wellness|Marketplaces|Personal Health,12300000.0,USA,3,8,268,16477,16745,0
Biotechnology,73000000.0,USA,2,16,564,12121,12685,0
Biotechnology,13750000.0,GBR,1,3,0,16258,16258,0
Advertising|Artificial Intelligence|Brand Marketing|E-Commerce|Internet|Internet of Things|Mobile|Mobile Commerce|Mobile Shopping|Online Shopping|Retail|Retail Technology|Search|Semantic Search|Shopping,4900000.0,USA,3,3,1593,14785,16378,0
Biotechnology,37226398.0,USA,3,2,1493,14714,16207,1
Health Care,8523998.0,USA,3,1,598,15579,16177,0
Clean Technology|Green|Renewable Energies|Solar,34390435.0,USA,9,7,3851,11812,15663,0
Curated Web,669365.0,GBR,2,3,579,15675,16254,0
E-Commerce,1139664.0,TUR,2,3,262,15675,15937,0
Clean Technology|Lighting|Semiconductors,101600000.0,USA,4,4,1826,13910,15736,0
Biotechnology,90889217.0,USA,6,19,1340,14865,16205,0
Web Design,20000000.0,USA,1,4,0,12629,12629,0
B2B|Business Services|CRM|Enterprises|Information Technology|Technology,118000.0,EST,1,2,0,16622,16622,0
Communications Infrastructure|Marketplaces|Sales and Marketing,622477.0,USA,1,1,0,16475,16475,0
Cloud Data Services|Information Technology|Services,4000000.0,USA,2,1,159,15223,15382,0
Biotechnology,65065215.0,JPN,2,7,397,12265,12662,0
Social Media,16254000.0,USA,4,18,874,15056,15930,1
Games|Networking|Social Games,946510.0,GBR,3,3,838,15273,16111,0
Curated Web,50000.0,USA,1,4,0,15371,15371,0
Photography,600000.0,NLD,1,1,0,15796,15796,0
Health Care,91510000.0,USA,7,19,2215,13969,16184,0
Bioinformatics|Biotechnology|Technology,50000.0,IRL,1,1,0,16555,16555,0
Information Services,349661.0,ESP,1,1,0,14228,14228,0
Online Shopping,50000000.0,RUS,1,1,0,15566,15566,0
Leisure|Online Rental|Services,1630849.0,JPN,1,1,0,16622,16622,0
E-Commerce,11000000.0,CHN,2,3,243,15706,15949,0
Real Estate|Technology,6000000.0,CHN,2,2,274,10743,11017,1
E-Commerce,40000.0,ARG,1,1,0,15775,15775,0
Application Platforms|Apps|Mobile|Mobile Software Tools,1286269.0,USA,1,1,0,16667,16667,0
Social Network Media|Sports,139000.0,USA,3,2,713,15757,16470,0
Health Care|Medical Devices,8000000.0,USA,1,2,0,11697,11697,0
Biotechnology|Health and Wellness|Health Care|Healthcare Services,16815105.0,USA,3,1,975,15691,16666,0
Hardware + Software,277187.0,GBR,1,1,0,15420,15420,0
App Marketing|Audio|Chat|Customer Service|Email|Messaging|Mobile|Public Relations|SMS,8500000.0,USA,1,2,0,12963,12963,1
Consumer Electronics,500000.0,DEU,2,1,395,16375,16770,0
Artists Globally|Independent Music Labels|Music|Network Security|Usability,123319000.0,USA,5,10,1934,14348,16282,0
Health and Wellness,3000000.0,USA,1,1,0,15062,15062,0
Messaging,150000.0,USA,1,2,0,15393,15393,0
3D Printing|3D Technology|Audio|Mass Customization,212500.0,USA,2,2,284,15816,16100,0
Ediscovery|Music,5800000.0,USA,2,5,714,12418,13132,0
Music,1700000.0,USA,3,12,549,15765,16314,0
Hardware + Software|Wearables,11200000.0,USA,2,3,194,16051,16245,0
Software,800000.0,KOR,2,3,269,16213,16482,0
Independent Music Labels|Legal|Music|Publishing,3726456.77842488,ITA,2,3,1789,14975,16764,0
Apps|Mobile|Music,6400000.0,NOR,2,3,476,15502,15978,0
Early-Stage Technology|iOS|Mobile|Music|Nightlife|Real Time|Search|Startups,50000.0,USA,1,2,0,16477,16477,0
Coworking|Music,250000.0,USA,1,2,0,16363,16363,0
Entertainment|Musicians|Music Services,15000.0,USA,1,1,0,15765,15765,0
E-Commerce,140000.0,USA,1,1,0,15793,15793,0
Music,10900000.0,SWE,1,6,0,16609,16609,0
Cloud-Based Music|Information Technology|Music Education|Music Services,2500000.0,SWE,2,1,154,16615,16769,0
Music,66379.0,BGR,2,2,54,15683,15737,0
Art|Music|Wireless,4000000.0,USA,1,1,0,16346,16346,0
Analytics|Android|Apps|iOS|iPhone|Local|Location Based Services|Music|Real Time|Social Media,2900000.0,IRL,4,16,881,15371,16252,0
Curated Web|MicroBlogging|Social Media|Social Network Media|Startups,111520.0,AUT,2,2,396,13757,14153,0
Curated Web,748678.0,AUT,1,2,0,15222,15222,0
Specialty Foods,814316.518880331,GBR,3,3,699,16071,16770,0
Auctions|E-Commerce|Internet|Online Shopping|Shopping,115000000.0,ARE,3,4,813,15340,16153,0
Price Comparison,1500000.0,IND,2,1,349,15691,16040,0
Music|SaaS,1200000.0,USA,1,1,0,15993,15993,0
Advertising,1123438.42059537,CAN,1,1,0,16762,16762,0
Open Source|Security|Software,500000.0,USA,2,5,171,15248,15419,1
Software,4000000.0,USA,1,6,0,16693,16693,0
B2B|E-Commerce|Fashion|Marketplaces,500000.0,USA,1,3,0,15538,15538,0
E-Commerce|Fashion|Manufacturing,1778000.0,USA,3,8,235,16178,16413,0
E-Commerce,40000.0,CHL,1,1,0,16049,16049,0
Android|Apps|Cloud Computing|Internet|iOS|iPhone|Mac|Mobility|Software|Web Development,10000000.0,USA,1,2,0,15104,15104,1
Developer Tools|SaaS|Security|Software,11500000.0,USA,2,6,503,16232,16735,0
Information Technology|Software,15000000.0,USA,1,5,0,12444,12444,1
Linux|Software|Tech Field Support,7000000.0,USA,1,3,0,13422,13422,0
Developer Tools|Productivity Software,250000.0,GRC,1,1,0,16344,16344,0
Health Care,16000000.0,USA,1,1,0,13278,13278,0
B2B|E-Commerce Platforms|Payments|Startups,5500000.0,USA,4,22,425,16039,16464,0
Big Data,4359000.0,USA,4,4,567,15674,16241,0
Advertising|Internet Marketing|SEO,43182.0,USA,1,1,0,16157,16157,0
Manufacturing,43795620.0,CHN,1,2,0,14214,14214,0
Software,1200000.0,USA,1,1,0,14280,14280,0
Public Transportation,55000000.0,USA,1,1,0,15254,15254,0
News,175000.0,USA,1,1,0,15492,15492,0
Energy|Oil|Oil and Gas,10000000.0,USA,1,1,0,12928,12928,0
Consulting,38856.0,GBR,1,1,0,15491,15491,0
Curated Web,60000.0,USA,1,1,0,15309,15309,0
Nanotechnology,5700000.0,USA,8,3,1859,14432,16291,0
Clean Technology|Renewable Energies,10000006.0,USA,2,9,677,13664,14341,1
Mobile,7630000.0,ESP,1,2,0,13330,13330,0
Biotechnology,7400000.0,CHN,1,1,0,16077,16077,0
Distribution|Industrial|Manufacturing,750000.0,GBR,1,1,0,15890,15890,0
Content Discovery|Digital Media|Event Management|Small and Medium Businesses,20000.0,USA,1,1,0,16130,16130,0
Biotechnology,1190000.0,DEU,2,4,805,13573,14378,0
Advertising|Online Video Advertising|Publishing,18000000.0,USA,1,4,0,16666,16666,0
Career Planning|Travel,734650.0,FRA,2,1,14,14761,14775,0
Consumer Goods|Health Care|Hospitality|Nutrition|Specialty Foods,22300000.0,USA,4,9,957,15492,16449,0
Curated Web|E-Commerce|Retail,705226.0,ESP,2,10,507,15467,15974,0
Curated Web|Social Media,100000.0,USA,1,1,0,15818,15818,0
Clean Technology,6025460.0,FRA,2,2,679,15482,16161,0
E-Commerce|Email|Gift Card|Services|Web Hosting,1300000.0,USA,2,2,427,13344,13771,0
Games|Mobile Games|Social Games,28166074.0,USA,6,11,1000,15568,16568,0
Aerospace|Space Travel,1245460000.0,USA,7,17,3247,13208,16455,0
Online Rental|Online Reservations|Payments,936000.0,JPN,1,2,0,16357,16357,0
Cloud Computing|Consumers|Storage|Web Hosting,2250000.0,USA,3,7,636,15533,16169,1
Analytics|Curated Web,4190185.0,USA,4,6,1765,14031,15796,0
Enterprise Software,4250000.0,CHN,1,1,0,14543,14543,0
Software,42000000.0,USA,3,9,1682,14277,15959,0
Games|Networking,50000.0,USA,1,1,0,15211,15211,0
Marketplaces|Social Network Media|Startups,1170843.0,NLD,1,1,0,16451,16451,0
Software,49000000.0,USA,5,15,2309,13070,15379,1
Broadcasting|Industrial|Public Relations,293000000.0,ISR,1,1,0,16020,16020,0
Algorithms|Office Space|Professional Services,38126.0,AUS,1,2,0,16526,16526,0
Software,1350000.0,USA,1,2,0,15187,15187,0
Analytics|Apps|Big Data,16343297.0,USA,4,6,1287,14847,16134,0
Curated Web,25000.0,USA,1,1,0,15864,15864,0
Aerospace,28500000.0,USA,2,3,603,15887,16490,0
Crowdfunding|Finance|Project Management,2000000.0,GBR,1,2,0,16381,16381,0
Public Relations|Space Travel,22400000.0,ISR,1,3,0,16170,16170,0
Industrial|Office Space|Retail|Software|Storage,1190121.0,CAN,4,6,384,15670,16054,0
Web Hosting,7500000.0,USA,1,1,0,14844,14844,0
Games,3000000.0,USA,1,2,0,15441,15441,1
Curated Web,40000.0,USA,1,1,0,15156,15156,0
Software,6500000.0,USA,1,2,0,13571,13571,1
Advertising|Content|Media,14000000.0,USA,4,13,1710,14789,16499,0
Messaging,13000501.0,USA,2,2,1495,12975,14470,0
Cloud Data Services|Enterprise Software|Storage,9000000.0,USA,2,2,714,15070,15784,0
Web Hosting,1525000.0,USA,2,3,395,14036,14431,0
Apps|Crowdsourcing|Mobile|Mobile Commerce,13250000.0,USA,2,6,261,16411,16672,0
Marketplaces|Self Storage|Startups|Storage,49350000.0,USA,5,12,2017,14488,16505,0
Automotive|E-Commerce,1285133.0,AUS,2,2,203,16217,16420,0
Real Estate,150000.0,CAN,2,2,110,16136,16246,0
Diagnostics|Health Care|Medical,500000.0,USA,1,1,0,15522,15522,0
Advertising|Advertising Platforms|Media|Mobile|Mobile Advertising|Social Media Advertising,50000.0,ARG,1,1,0,16314,16314,1
Financial Services|FinTech|Investment Management|Mobile Commerce|Personal Finance|Social Investing,120000.0,USA,1,1,0,16405,16405,0
Software,793770.0,POL,1,5,0,16518,16518,0
Biotechnology,122800000.0,USA,2,7,217,16000,16217,1
Gift Card|Software,10525040.0,USA,7,7,3088,12631,15719,0
Curated Web,1000000.0,USA,1,4,0,14942,14942,1
Customer Service|Customer Support Tools|Enterprises|Facebook Applications|Messaging|SaaS|Social Media|Twitter Applications,17625000.0,USA,3,12,1115,15340,16455,0
Big Data|Development Platforms|Mobile|Point of Sale|Retail Technology,1083533.0,GBR,3,2,242,15645,15887,0
Mobile|Mobile Payments|Payments,3809673.0,ITA,1,2,0,15826,15826,0
E-Commerce|Navigation|Personalization|Search|Software,13226500.0,FRA,2,6,1032,14725,15757,0
Curated Web,7050000.0,USA,2,4,714,13910,14624,0
Analytics|Email Marketing|Lead Management|Marketing Automation|Mobile Advertising|Performance Marketing|Search Marketing|Social Media Marketing,4000000.0,USA,1,1,0,13956,13956,1
Messaging|Mobile|Mobile Commerce,2300000.0,USA,1,12,0,15979,15979,0
Consumer Electronics|Internet|Kids,150000.0,ISR,1,1,0,15653,15653,0
Curated Web,5000000.0,USA,1,1,0,14130,14130,0
Software,13874027.0,CAN,3,2,1209,15154,16363,0
Analytics|Big Data|Databases|Software,10000000.0,USA,1,1,0,15934,15934,0
SaaS|Sales and Marketing,113831.0,SWE,1,3,0,16489,16489,0
Insurance,279100000.0,USA,1,5,0,13733,13733,0
E-Commerce|Shoes,55232200.0,FRA,3,11,2123,13514,15637,0
Curated Web|Internet,9500000.0,USA,3,5,668,15340,16008,0
Software,5420000.0,FRA,2,3,738,12881,13619,1
Messaging,200000.0,GBR,1,5,0,16371,16371,0
Hardware + Software,47489278.0,USA,3,4,937,13756,14693,1
Telecommunications|Wireless,45100000.0,USA,3,13,657,11547,12204,1
Health and Wellness,160000.0,IDN,1,1,0,16305,16305,0
Enterprise Software|Entertainment|Games|Meeting Software|Video|Video Games,1000000.0,USA,1,1,0,14480,14480,1
Education|Information Technology,20000.0,IND,1,1,0,16195,16195,0
Analytics|Big Data|Business Intelligence|Developer APIs|Lead Generation|Machine Learning|Marketplaces|Semantic Web|Text Analytics,1800000.0,ITA,2,3,508,15653,16161,0
Fashion|iPhone|Promotional,175000.0,USA,2,1,624,14000,14624,0
Automotive|Customer Service|Hardware + Software|Mobile,2400000.0,USA,1,18,0,13514,13514,0
EdTech|Education|Language Learning|Publishing,25200000.0,USA,3,11,790,15944,16734,0
Information Technology|Telecommunications|VoIP,24000000.0,USA,1,5,0,12493,12493,1
Apps|Software|Technology,5000000.0,USA,1,2,0,16574,16574,0
EdTech|Education|English-Speaking|Language Learning,1000000.0,ISR,1,1,0,16218,16218,0
Information Services|Technology|Telecommunications,253000.0,CZE,2,1,123,15522,15645,0
B2B|Collaboration|Human Resources|Innovation Management|SaaS,820000.0,USA,2,4,298,16074,16372,0
Communications Infrastructure|Language Learning|Professional Networking,10000000.0,IND,1,3,0,16504,16504,0
Analytics|Big Data|Sales and Marketing|Software,3430000.0,USA,2,1,684,15274,15958,0
Algorithms|Social Commerce|Web Design,3207946.0,GBR,1,1,0,15413,15413,0
Consulting|Health and Wellness|Health Care|Hospitals,36850000.0,USA,2,1,1147,14965,16112,0
Biotechnology|Medical Devices,5000000.0,USA,1,1,0,11956,11956,1
Clean Technology,13633363.0,CAN,1,1,0,15967,15967,0
Advertising|Auctions|Digital Media,130868275.0,USA,6,5,2161,13179,15340,0
Analytics|Architecture|B2B|Construction|Lead Generation|Sales and Marketing,189406.0,GBR,1,2,0,16162,16162,0
Advertising|News|Printing,1406733.0,GBR,4,4,964,14343,15307,0
Advertising,118000.0,USA,1,1,0,16622,16622,0
Communities,14638573.0,USA,1,1,0,11943,11943,1
Analytics,6890927.0,USA,5,4,2610,13181,15791,1
Semiconductors,11097772.0,USA,2,3,316,15566,15882,0
Health Care,510660.0,GBR,1,3,0,16273,16273,0
Engineering Firms|Manufacturing|Sensors,1205335.0,FIN,1,3,0,16233,16233,0
Biotechnology|Medical|Technology,9300000.0,USA,1,5,0,12492,12492,0
Health Care,5000000.0,USA,1,1,0,13820,13820,0
Semiconductors,45400000.0,USA,6,14,1756,13180,14936,1
Ediscovery|Music|Personalization|Search|Startups|User Experience Design,504210.0,AUT,1,1,0,14610,14610,0
Assisitive Technology|Innovation Engineering|Real Time,3600000.0,CHE,1,1,0,15204,15204,0
Manufacturing,28000000.0,USA,4,10,2194,12193,14387,0
Manufacturing,7500000.0,USA,1,2,0,11954,11954,1
Clean Technology,91400000.0,USA,2,7,574,14047,14621,0
Web Hosting,25371206.0,USA,5,10,1993,14127,16120,0
Semiconductors,750000.0,USA,1,1,0,14742,14742,0
Software,13100000.0,USA,2,6,386,13767,14153,1
Enterprise Software,10000000.0,USA,1,1,0,13578,13578,0
Hardware + Software,700000.0,USA,1,1,0,16162,16162,0
Internet Service Providers|Wireless,18000000.0,USA,1,2,0,16408,16408,0
Curated Web|Online Dating,11600000.0,USA,3,3,1785,13514,15299,0
E-Commerce,40000.0,CHL,1,1,0,15618,15618,0
Web Hosting,6500000.0,USA,1,1,0,12010,12010,1
Advertising,5000000.0,USA,1,1,0,13929,13929,0
Public Transportation|Transportation,4500000.0,USA,1,1,0,13517,13517,0
Mobile|Software,7950000.0,USA,5,35,624,15508,16132,1
Corporate Training|Education|English-Speaking|Language Learning|Mobile|Software,5000000.0,DEU,1,2,0,16591,16591,0
Food Processing,25000.0,USA,1,1,0,16105,16105,0
Curated Web,50000.0,SGP,1,2,0,14610,14610,0
Clean Technology,4480000.0,USA,4,1,774,15974,16748,0
Health Care,38431786.0433491,NLD,1,3,0,14112,14112,0
Chemicals|Energy|Fuels,150000.0,USA,1,1,0,16275,16275,0
Biotechnology,33000000.0,USA,3,10,1984,14610,16594,0
Consulting,7576257.0,GBR,1,1,0,16133,16133,0
SaaS,135002.0,AUT,1,2,0,16015,16015,0
Design,70000000.0,USA,1,5,0,11180,11180,1
Curated Web,3500000.0,USA,2,11,395,12874,13269,1
Mobile|Photography|Publishing,2275000.0,USA,2,9,277,15702,15979,0
Biotechnology,4858520.0,GBR,2,3,490,15755,16245,0
Hardware + Software,65864387.0,GBR,5,12,3313,13242,16555,0
Electronics,154783.0,CZE,1,1,0,16622,16622,0
Biotechnology,36400000.0,USA,2,7,1001,11915,12916,0
Biotechnology,50000.0,USA,1,1,0,15357,15357,0
Hardware + Software,3440000.0,GBR,1,1,0,13482,13482,0
Aerospace|Services|Transportation|Travel,100000000.0,IND,1,2,0,14103,14103,0
IT Management|Professional Networking|Social Media|Software,111000000.0,USA,5,16,2790,13315,16105,0
Mobile Commerce|Photo Sharing|Social Media,1465654.0,SGP,1,1,0,16111,16111,0
Games,3200000.0,CHN,1,1,0,15065,15065,0
Enterprise Software,120999995.0,USA,5,11,1851,14590,16441,0
Curated Web,5500000.0,USA,2,4,657,15912,16569,0
Software,70101284.0,USA,9,8,3190,13545,16735,0
Cloud Computing|Service Providers|Services,840000.0,JPN,1,2,0,16492,16492,0
Analytics,7960177.28021441,GBR,4,7,2877,11688,14565,0
Cyber Security|Enterprise Security|Security,13400000.0,USA,2,8,659,15706,16365,0
Software,56000000.0,USA,3,12,1047,12929,13976,1
Advice|Curated Web|Health and Wellness|Private Social Networking|Social Network Media,1070000.0,USA,3,1,1051,15034,16085,1
Music|Social Network Media,76000000.0,USA,7,14,2674,13657,16331,0
Hardware + Software,106000000.0,USA,2,4,969,15383,16352,0
Biotechnology|Health Care,49300000.0,USA,3,8,3735,12490,16225,0
Health Care|Medical Devices,111270388.0,USA,5,19,2691,13172,15863,0
Biotechnology|Health Care|Therapeutics,43999998.0,USA,4,4,1912,13795,15707,0
Health Care,20610000.0,USA,2,6,1419,12860,14279,0
Location Based Services|Mobile|Social Commerce,3910000.0,USA,2,6,943,15660,16603,1
Consumer Goods|Manufacturing|Services,2995000.0,USA,2,4,212,16202,16414,0
Manufacturing|Medical|Medical Devices,13708764.0,FRA,2,2,1499,10988,12487,1
Health Care,62500000.0,USA,2,5,1393,13614,15007,0
Health Care,8800000.0,USA,1,2,0,14033,14033,0
Health Care,13348172.0,USA,3,8,2099,14502,16601,1
Health Care,15085185.0,CHE,2,5,1023,14468,15491,0
Health Care,10000000.0,USA,1,1,0,13131,13131,0
Entertainment|Events|Internet Marketing|Local,7000000.0,USA,3,17,950,15364,16314,0
Internet,1000000.0,SGP,1,1,0,16610,16610,0
Biotechnology,64000000.0,GBR,2,8,961,15209,16170,1
Education,200000.0,USA,1,1,0,16174,16174,0
Software,678000.0,CAN,1,1,0,13272,13272,0
Analytics|Facebook Applications|Internet Marketing|Social Media|Twitter Applications,1200000.0,USA,2,8,593,15273,15866,0
Biotechnology|Health Diagnostics,3000000.0,CHE,1,1,0,15714,15714,0
Games|Online Dating,150000.0,USA,1,1,0,14610,14610,0
Messaging,105500000.0,GBR,2,4,501,13958,14459,1
Biotechnology|Health Diagnostics,12483000.0,CHE,1,5,0,13032,13032,0
Digital Media|E-Commerce|Social Commerce|Ticketing,750000.0,CAN,1,2,0,15360,15360,0
Health Care,71300000.0,USA,3,9,1962,14424,16386,0
Bioinformatics|Enterprise Software,4115591.0,USA,3,1,1148,15562,16710,0
Clean Technology,80000.0,USA,1,1,0,14118,14118,0
Music,45000000.0,USA,3,1,699,13149,13848,0
Hardware + Software,80900000.0,USA,5,13,2715,12013,14728,0
Social Network Media|Web Hosting,9000000.0,USA,1,3,0,14068,14068,1
Android|Apps|Cloud Computing|Hardware + Software|Health and Wellness|iOS|Mobile|PaaS|Real Time|Sensors|Software|Tracking|Wearables|Web Development,220000.0,USA,3,3,548,15857,16405,0
Location Based Services|Mobile,977000.0,RUS,1,1,0,15698,15698,0
E-Commerce|Fashion,1250000.0,USA,1,4,0,16084,16084,0
Apps|Information Technology|Sales and Marketing|Sales Automation|Software,1500000.0,USA,1,4,0,16749,16749,0
Medical Devices,8600000.0,USA,1,2,0,16381,16381,0
Development Platforms|Medical|Medical Devices,9341046.0,USA,3,3,1275,13622,14897,1
Bio-Pharm|Clinical Trials|Pharmaceuticals,500000.0,USA,1,1,0,15796,15796,0
Events,1400000.0,ISR,1,4,0,16617,16617,0
Advertising|Advertising Platforms|Brand Marketing|Digital Media|Facebook Applications|Internet Marketing|Social Media Marketing,16045000.0,USA,5,6,1014,15738,16752,0
Events|Software,7500000.0,USA,4,31,1016,15489,16505,0
Online Travel|Travel,4749900.0,ESP,1,2,0,13981,13981,0
Outsourcing,70000.0,USA,2,1,280,16007,16287,0
Music,7250000.0,USA,2,18,343,15987,16330,0
Analytics,22000000.0,USA,4,11,1125,15630,16755,0
Advertising,475000.0,USA,3,7,307,15006,15313,0
Curated Web,1000000.0,ISR,1,6,0,16155,16155,0
Analytics|Mobile|SaaS,300000.0,USA,2,6,116,16114,16230,1
Finance|Music|Nightclubs|Social Media,129320.0,ITA,3,1,1294,14488,15782,0
Consumer Electronics|Hardware + Software,5049997.0,USA,6,8,1666,14610,16276,0
Finance Technology|Mobile Payments|Property Management,1200000.0,GBR,1,8,0,16735,16735,0
Service Providers|Transportation|Travel,145000.0,USA,1,3,0,16595,16595,0
Billing|Curated Web|Mobile|Mobile Payments|Personal Finance,1400000.0,USA,1,8,0,16420,16420,0
Music,150000.0,USA,1,1,0,15584,15584,0
Software,40000000.0,USA,3,6,1004,12753,13757,1
Advertising|Analytics|Coupons|E-Commerce|Enterprise Software|Facebook Applications|Promotional|SaaS|Sales and Marketing|Social Bookmarking|Social Media|Twitter Applications,550000.0,USA,1,3,0,15309,15309,0
Search,7000000.0,USA,1,2,0,13483,13483,1
Email Marketing,19311.0,DNK,1,1,0,14858,14858,0
Games|Incentives|Internet|Local|Mobile|Search|Social Media|Sports|Technology,170000.0,USA,2,1,153,15584,15737,1
Brand Marketing|Consumer Goods,120000.0,USA,1,1,0,16461,16461,0
Contact Management|CRM|Crowdsourcing|Email|Human Resources|Networking|Sales and Marketing|Software|Task Management,25100000.0,USA,3,8,686,11688,12374,0
E-Commerce|Fashion|Mens Specific|Online Shopping,272895.0,GBR,2,2,573,16071,16644,0
Incentives|Local Businesses|Mobile|Photo Sharing|Social Commerce,850000.0,USA,2,1,52,16008,16060,0
Cloud Infrastructure|Computers|Contact Centers|Customer Service|Enterprise Software|SaaS|Software,53246636.0,USA,6,6,2122,14530,16652,0
Hardware|Virtual Currency,6500000.0,ISR,2,9,202,16371,16573,0
Curated Web,400000.0,USA,1,1,0,14718,14718,1
Advertising|Media,10000000.0,USA,2,5,247,15130,15377,0
Advertising|Events,65656.0,BGR,2,2,117,15709,15826,0
Advertising|Advertising Platforms|Information Technology|Marketplaces|Sponsorship|Sports,141403.56411557,DEU,6,5,298,16467,16765,0
Business Services|Finance,800000.0,USA,2,13,571,15316,15887,1
Advertising|Games|Mobile|Monetization|SaaS|Technology,9590000.0,DEU,5,11,1927,14426,16353,1
Mobile,200000.0,USA,1,1,0,14989,14989,0
Software,1000000.0,USA,1,5,0,15343,15343,1
Colleges|Curated Web|Journalism|Media|News|Publishing,5020000.0,USA,3,12,273,16436,16709,0
Art|Curated Web|DIY|Handmade|Women,25000000.0,USA,1,2,0,16673,16673,0
Consumer Goods|Hospitality|Service Industries|Specialty Foods,1000000.0,IND,2,5,123,16433,16556,0
Delivery|Hospitality,13500000.0,USA,2,10,236,15969,16205,0
Advertising,3900000.0,KOR,3,4,612,15675,16287,0
Consumers|Electronics|Mobile Devices|Retail,400000.0,USA,2,2,0,16342,16342,0
Sports,40000.0,CHL,1,1,0,16030,16030,0
Software,39129500.0,USA,5,7,1861,14407,16268,0
Emerging Markets|Mobile|Photography|Sports,25000.0,DNK,1,1,0,15536,15536,0
Sports|Technology|Tracking,6507366.0,USA,1,1,0,15889,15889,0
Loyalty Programs|Mobile|Mobile Advertising|Sports|Sports Stadiums,45000.0,USA,1,2,0,16344,16344,0
E-Commerce|Social Commerce|Sports,653717.0,ITA,1,1,0,15765,15765,0
CRM|Maps|Online Reservations|Search|Social Media|Sports,50000.0,CZE,1,2,0,15340,15340,0
Social Network Media|Sports,129390.0,GBR,1,1,0,15340,15340,0
Ad Targeting|Advertising|Social Media|Sports,11489687.0,USA,3,10,617,13514,14131,1
Crowdsourcing|Games|Sports,150000.0,USA,1,3,0,16071,16071,0
Sports,60395.0,EST,2,2,203,15737,15940,0
Games|Sports,503000.0,GBR,2,1,71,16079,16150,0
News|Sports,3200000.0,ISR,1,1,0,13787,13787,1
Curated Web|Social Network Media|Sports|Technology,16012580.919975,GBR,5,2,1317,15439,16756,0
Sports,2179233.0,CAN,2,5,621,16010,16631,0
Mobile Software Tools|Social Network Media|Software|Sports|Training,506576.0,EST,3,5,1027,14463,15490,0
Sports,270862.0,ESP,1,1,0,16233,16233,0
Fitness|Mobile|Sports,100000.0,USA,1,1,0,16141,16141,0
Advertising|E-Commerce|Flash Sales|Retail|Sports,29082909.7116438,GBR,5,14,1343,15418,16761,0
Sports,98201432.231785,CHE,3,5,1205,15530,16735,0
Services|Sporting Goods|Sports,5000000.0,USA,1,2,0,13056,13056,0
Gps|Sports|Wearables,626562.054009649,AUS,2,1,169,16517,16686,0
Fantasy Sports|Sports,200000.0,USA,1,1,0,11688,11688,0
E-Commerce,1000000.0,IND,1,2,0,16479,16479,0
Blogging Platforms|Consumer Goods|Curated Web|Sports,2250000.0,USA,2,2,136,16010,16146,0
Fitness|Health and Wellness|Sports,2519440.0,USA,7,4,1193,15492,16685,0
Fantasy Sports,6004999.0,USA,2,4,1096,15492,16588,0
Apps,950000.0,USA,1,4,0,16465,16465,0
Curated Web|News|Real Time|Sports,4500000.0,USA,2,3,346,15932,16278,0
Software,12500000.0,USA,1,1,0,14855,14855,0
Games,20395.0,EST,1,1,0,15737,15737,0
E-Commerce|Local|SaaS|Small and Medium Businesses|Sports,8217278.0,USA,4,8,1366,15308,16674,0
Sports,647250.0,ITA,1,2,0,15784,15784,0
Events|Media|Sports,10000000.0,IND,1,1,0,16713,16713,0
Analytics|Developer APIs|Finance|Social Media|Software,358969.0,USA,2,1,282,14822,15104,1
E-Commerce|Entertainment|Mobile|Mobile Commerce|Music|Sports,500000.0,USA,1,2,0,16532,16532,0
Auctions|Classifieds|E-Commerce|Internet|Online Shopping|Technology,73000.0,PAN,1,1,0,14975,14975,0
Finance,21929351.0,DEU,2,7,146,16371,16517,0
Advertising|Mobile|Wireless,7500000.0,USA,1,2,0,11049,11049,1
Curated Web,600000.0,USA,1,2,0,15349,15349,0
Mobile,67983.0,ESP,1,1,0,15737,15737,0
Privacy|Security,1150000.0,USA,2,8,97,15309,15406,0
Curated Web|Marketplaces|Parking|Startups,27510000.0,USA,5,34,1113,15553,16666,0
Travel|Travel & Tourism|Vacation Rentals,20000.0,HRV,1,2,0,15156,15156,1
Cloud Computing|Entertainment|Music|Video Streaming,1063779080.0,SWE,11,37,2524,14153,16677,0
Web Hosting,638000.0,DEU,1,1,0,13300,13300,0
Mobile|Retail,1858875.0,JPN,1,1,0,15458,15458,1
Software,28500000.0,USA,3,6,1835,14909,16744,0
Digital Entertainment|Mobile Commerce|Ticketing,270000.0,ITA,1,1,0,16211,16211,0
Fitness|Health and Insurance|Health and Wellness|Human Resources|Small and Medium Businesses,20000.0,USA,1,1,0,15887,15887,0
Advertising,5000000.0,USA,1,3,0,15572,15572,0
Curated Web,4300000.0,USA,2,8,323,16211,16534,0
Advertising|Android|Incentives|iPhone|Local|Loyalty Programs|Mobile,842193.0,ITA,3,1,455,16071,16526,0
Analytics|Big Data|Social Media Marketing,14270890.0,USA,4,4,1584,14943,16527,0
Advertising|Television,101000000.0,USA,3,17,857,13149,14006,0
Information Technology,1000000.0,SWE,1,4,0,16624,16624,0
Big Data|Social Media,1300000.0,USA,2,5,463,15461,15924,1
Mobile|Online Dating|Social Innovation,14500000.0,DEU,2,3,586,16071,16657,0
Mobile|Social Search|Social Travel|Travel,1491250.0,HKG,4,6,511,15820,16331,0
Mobile,10000000.0,CAN,1,7,0,13165,13165,0
Advertising|Internet|Online Video Advertising,12000000.0,USA,2,1,1079,13879,14958,1
Advertising,14750000.0,NLD,2,2,1002,13845,14847,0
Art|Internet of Things|Mobile|Social Media,1408000.0,USA,2,27,111,16484,16595,0
Advertising|Coupons|Discounts|Internet|Local|Local Based Services|Location Based Services|Loyalty Programs|Mobile|Offline Businesses|Online Reservations|Promotional|Retail|Shopping|Trading,2200000.0,USA,2,4,568,15295,15863,0
Mobile,160000.0,CHL,2,1,301,15755,16056,0
Hardware|Health Care,16403514.0,USA,7,4,1583,15091,16674,0
Hardware + Software|Health Diagnostics,10000000.0,USA,1,2,0,13579,13579,1
E-Commerce|E-Commerce Platforms|Marketplaces|Mass Customization|Point of Sale,12740000.0,DEU,2,3,968,13330,14298,0
Hardware|Hardware + Software|Semiconductors,20000000.0,CHN,1,4,0,13452,13452,1
Audio|Internet Radio Market|Social Media,1007468.0,USA,2,4,325,14900,15225,0
Enterprise Software|Facebook Applications|Photo Sharing|Social Media|Social Network Media|Twitter Applications|Video Streaming,88100000.0,USA,5,11,1784,14713,16497,0
E-Commerce|Open Source|Web Development,6500000.0,USA,2,8,869,15257,16126,1
Social Media,14100000.0,USA,3,9,1069,15329,16398,0
Billing|E-Commerce|Mobile Payments|Payments|SaaS,4700370.0,USA,5,1,869,15866,16735,0
Cloud Computing|Health and Wellness|Health Care,13000006.0,USA,2,1,10,16594,16604,0
Apps|Mobile Commerce|Online Shopping,10000000.0,USA,1,2,0,15522,15522,0
Delivery|Hospitality,56700000.0,USA,4,25,525,16015,16540,0
Clean Technology|Environmental Innovation|Toys,2300000.0,USA,1,1,0,14049,14049,1
Credit Cards|E-Commerce|Internet,2300000.0,USA,2,2,304,15706,16010,0
Biotechnology,25995418.0,USA,4,1,1349,15099,16448,0
Apps|Consumers|E-Commerce|Internet|Retail|Shopping,32500000.0,USA,2,14,281,16260,16541,0
Networking|Social Media,8250000.0,AUS,4,6,657,15706,16363,0
Software,1360000.0,USA,2,2,285,15056,15341,0
Mobile|Software|Wireless,93051049.0,BRA,6,8,1669,14092,15761,0
Apps|Exercise|Fitness|Mobile|Music|Music Services,1971455.0,USA,2,10,153,16353,16506,0
Apps|Mobile|Task Management|Web Tools,7320977.0,USA,3,1,1711,14031,15742,0
Analytics|Big Data|E-Commerce|Internet Marketing|Marketing Automation,10000000.0,USA,3,8,826,15765,16591,0
Cloud Computing|Collaboration|Document Management|Enterprises|Enterprise Software|SaaS,47700000.0,USA,6,8,1619,14867,16486,0
Education|Marketplaces,1085535.0,NLD,2,6,695,15354,16049,0
Health and Wellness,6908482.0,GBR,1,1,0,15512,15512,0
E-Commerce,12420256.0,DEU,2,2,797,15897,16694,0
Biotechnology,23277501.0,USA,2,4,585,14578,15163,0
Advertising|Brand Marketing|Content|Content Creators|Creative|Crowdsourcing|Design|Marketplaces|Market Research|SaaS|Sales and Marketing|Social Media|Social Media Marketing,1050000.0,USA,2,6,119,16366,16485,0
Consumer Electronics,473326.0,CAN,1,2,0,16348,16348,0
Data Centers|Enterprise Software|Information Technology|Software|Storage|Virtualization,34000000.0,USA,1,4,0,15340,15340,0
Software,37339356.0,USA,2,5,380,13674,14054,1
Advertising|Content Discovery|Content Syndication|Video,100000.0,SWE,1,2,0,15707,15707,0
Advertising|Analytics|Blogging Platforms|Enterprise Software|Facebook Applications|Social CRM|Social Media|Social Media Management|Social Media Marketing|Twitter Applications,123500000.0,USA,5,11,1119,15406,16525,0
Software,4275001.0,USA,2,1,513,16139,16652,0
Location Based Services|Mobile|Mobile Commerce|Proximity Internet|Real Time|Retail|SaaS,480000.0,SGP,1,2,0,15642,15642,0
Billing|Electronics|Professional Networking|Software,2273363.0,DNK,1,2,0,15222,15222,0
Advertising|Media|Web Development,8300000.0,USA,2,4,336,13664,14000,1
Facebook Applications|Google Apps|Search|Social Media|Social Network Media|Software|Twitter Applications,19000000.0,USA,4,6,1506,14742,16248,0
Games,836000.0,USA,4,8,1166,15431,16597,0
Curated Web,1000000.0,USA,1,1,0,15774,15774,0
Hardware + Software|Internet of Things,6550924.0,USA,1,12,0,16464,16464,0
Education|Enterprises|Startups,100000.0,USA,1,1,0,16548,16548,0
Health and Wellness|Health Care|Health Care Information Technology,17000000.0,USA,2,7,177,16338,16515,0
Advertising|Enterprise Software|Facebook Applications|Sales and Marketing|Social Media,16014456.0,USA,4,1,853,14804,15657,0
Internet Marketing|Sales and Marketing|Social Media,200000.0,CAN,1,1,0,15761,15761,0
Enterprise Software|Finance,18000.0,USA,1,1,0,14462,14462,0
Information Technology,2175016.0,DEU,1,2,0,16517,16517,0
Software,28000000.0,USA,2,9,714,11477,12191,1
Finance,200000.0,IND,1,1,0,15706,15706,0
E-Commerce|Local|Marketplaces|Tourism|Travel,25000.0,USA,1,1,0,15765,15765,0
Games,40000.0,USA,1,1,0,15749,15749,0
Mobile,2930000.0,USA,4,1,1299,14987,16286,0
Cloud Computing|Enterprises|Mobile|Mobile Devices|Security,1100000.0,USA,3,8,232,15300,15532,0
Curated Web|Mobile,230538.0,GBR,1,3,0,16467,16467,0
Health Care,18000000.0,USA,1,3,0,16562,16562,0
Software,4710000.0,CAN,2,2,282,14048,14330,0
Apps,500000.0,USA,1,1,0,16467,16467,0
Application Performance Monitoring|Service Providers|Software,25000000.0,USA,1,1,0,16602,16602,0
Consulting,1440000.0,CAN,1,1,0,13762,13762,0
Big Data|Big Data Analytics|Internet of Things,7770100.0,USA,2,1,44,15070,15114,0
Advertising|Mobile|Semantic Web,40000.0,CHL,1,1,0,15156,15156,0
Journalism|Media|News,276000.0,USA,3,3,432,16313,16745,0
E-Commerce,15000.0,USA,2,2,769,14610,15379,1
Hardware + Software|Health and Wellness,3218000.0,USA,3,3,588,15853,16441,0
Certification Test|College Recruiting|EdTech|Education|Recruiting|Skill Assessment,3500000.0,SWE,1,1,0,16493,16493,0
Analytics|Big Data|Business Intelligence|Enterprise Software|Geospatial,7400000.0,ISR,1,1,0,16590,16590,0
Accounting|Cloud Computing|Collaboration|CRM|Enterprises|Network Security|Project Management|SaaS|Software|Storage,550000.0,USA,1,2,0,16099,16099,1
Analytics|Big Data|Big Data Analytics|Cyber Security|Data Integration|Data Security|Data Visualization|Interest Graph|Software,14200000.0,USA,3,7,912,15572,16484,0
Mobile|Social Network Media|Software,1700000.0,USA,1,2,0,16728,16728,0
Big Data Analytics|Hardware + Software|Internet of Things|Retail Technology,1000000.0,USA,2,1,427,16300,16727,0
Analytics|Finance|FinTech|Hardware + Software|Mobile|Mobile Payments|P2P Money Transfer,590500000.0,USA,9,39,1977,14549,16526,1
Mobile,650000.0,USA,1,16,0,15706,15706,0
Crowdsourcing|Digital Media|Internet|Social Media,1375000.0,USA,2,3,448,16302,16750,0
Mobile,1000000.0,USA,1,4,0,13864,13864,0
Advertising|Entertainment|Games|Internet Marketing|Media|Television,4440262.0,USA,3,9,1803,14327,16130,1
Apps|Email|iOS|iPhone|SaaS|Software|Web Development,150000.0,USA,2,3,164,15758,15922,0
Blogging Platforms|Content|Curated Web|Internet|Software|Web CMS|Web Design,78500000.0,USA,2,3,1372,14803,16175,0
Hardware + Software|Insurance,247700000.0,USA,4,14,4498,10865,15363,0
Advertising|Consumer Electronics|Curated Web|Sports|Technology,3000000.0,GBR,1,3,0,16177,16177,0
Design|E-Commerce|Mobile|Product Design,65853.0,BGR,2,2,120,15706,15826,0
E-Commerce|SaaS|Telecommunications,87000.0,BRA,1,1,0,15732,15732,0
Employer Benefits Programs|Finance Technology|FinTech|Personal Finance,1096481.0,GBR,3,6,194,16297,16491,0
Analytics|Cloud Computing|Information Technology|SaaS|Software,1500000.0,CHE,3,7,461,15371,15832,0
Apps|Collaboration|Social Media,750000.0,USA,2,2,143,16098,16241,0
Search,550000.0,USA,1,1,0,15413,15413,0
Software|Video|Video Streaming,1100000.0,USA,1,7,0,15946,15946,0
Software,88421.0,GBR,1,1,0,16202,16202,0
Biotechnology,5115000.0,USA,3,3,603,16007,16610,0
Finance,53000000.0,USA,1,1,0,15714,15714,0
E-Commerce Platforms|Finance Technology|FinTech|Mobile Commerce|Mobile Payments,1100000.0,MEX,1,3,0,16265,16265,0
Cars|Insurance|Risk Management,2000000.0,RUS,1,1,0,15492,15492,0
Analytics|Cloud Computing|Search,1510000.0,USA,4,9,562,15385,15947,0
Security,30500000.0,USA,3,14,1586,13357,14943,0
Software,75000000.0,USA,1,1,0,12146,12146,1
Travel & Tourism,350000.0,BLM,1,1,0,14636,14636,0
Colleges|Education|Universities,750000000.0,GRD,1,2,0,16290,16290,0
Health Care,14745580.0,USA,7,1,1960,14356,16316,0
Location Based Services|Mobile|Security|Travel,360000.0,USA,2,4,262,16447,16709,0
Health Care,420000.0,USA,2,2,946,15356,16302,0
Mobile,75500000.0,USA,4,26,1688,12515,14203,0
Databases|Software,68000000.0,USA,4,20,1722,14733,16455,0
Media,250000.0,USA,1,1,0,14014,14014,0
Ad Targeting|Advertising|Advertising Exchanges|Advertising Networks|Advertising Platforms|Internet Marketing,900000.0,CAN,1,2,0,16338,16338,0
Apps|E-Commerce|E-Commerce Platforms|Flash Sales|Social Commerce|Software,800000.0,USA,2,7,189,15356,15545,0
Enterprise Software,15000000.0,USA,2,3,418,15548,15966,1
Developer Tools,4500000.0,USA,2,3,212,16344,16556,0
Application Performance Monitoring|Cloud Computing|Developer Tools|Enterprise Software|Information Technology|SaaS,2000000.0,USA,1,1,0,15354,15354,0
Home Automation,172581.0,GBR,1,1,0,16161,16161,0
Brand Marketing|Social Commerce|Social Media|Social Media Marketing,3839780.0,USA,2,5,313,16372,16685,0
Cloud Computing|Developer APIs|Mobile|PaaS|SaaS,7500000.0,USA,1,3,0,15110,15110,1
Cloud Computing|Enterprise Software|Infrastructure|Marketplaces,870000.0,USA,2,1,23,15317,15340,0
Software,10600000.0,USA,3,3,531,13118,13649,0
Games|Mobile|Software|Sports,30000.0,USA,2,2,488,15126,15614,0
Messaging|Social Media,250000.0,USA,1,1,0,15706,15706,0
Customer Service|Information Technology|Software,1828992.0,SVK,4,4,425,16183,16608,0
Consulting,1250000.0,USA,1,4,0,16772,16772,0
Art|Concerts|Events|Music|Nightclubs,100000.0,CHE,1,1,0,15553,15553,0
EdTech|Education|Entertainment Industry|Film|Professional Networking|Social Network Media|Television|Theatre,250000.0,USA,1,1,0,15232,15232,0
E-Commerce Platforms|Internet|Marketplaces|Mobile|Social Media,610000.0,USA,2,1,782,15413,16195,0
Art|Curated Web|Incentives|Internet|Monetization|Music,40000.0,USA,2,2,1127,14335,15462,0
Concerts|Crowdfunding|Crowdsourcing|Events|Market Research|Music|Sales and Marketing,118000.0,USA,1,1,0,16601,16601,0
Biotechnology,1900000.0,USA,3,10,424,13202,13626,0
Enterprise Software|Media|Social Media|Sustainability,10000.0,USA,1,1,0,15340,15340,0
3D|Services,19299.0,ESP,1,1,0,16020,16020,0
Mobile,3000000.0,USA,2,12,481,15065,15546,1
Document Management,600000.0,USA,1,4,0,16757,16757,0
Cloud Computing|Developer Tools|SaaS|Software|Web Development|Web Tools,404300.0,GBR,2,3,512,15948,16460,0
Curated Web,755000.0,HKG,2,3,191,15400,15591,0
Fashion|Lifestyle,86000000.0,USA,4,28,1914,14585,16499,0
Design|Mobile|SaaS,110000.0,USA,2,2,294,15989,16283,0
Information Technology,2250000.0,USA,1,7,0,16611,16611,0
Life Sciences,1280000.0,USA,2,2,0,16521,16521,0
3D Printing,120000.0,USA,1,1,0,16405,16405,0
Banking|Enterprise Software|Financial Services|Payments|Software,2700000.0,USA,1,18,0,16218,16218,1
Education,6016903.0,USA,2,1,824,14245,15069,0
Apps|Cloud Computing|Enterprise Software|Open Source|PaaS|Web Hosting,10500003.0,USA,6,6,1267,14245,15512,1
B2B|Consulting|Employment|Recruiting|Software,1980198.01980198,CAN,1,10,0,13906,13906,1
Biotechnology,6452960.0,GBR,1,1,0,15175,15175,0
Industrial|Manufacturing,800000.0,USA,3,4,928,12586,13514,0
Hardware + Software,19416467.0,FRA,3,7,2452,13695,16147,0
Advertising,3625000.0,USA,2,6,549,15814,16363,0
Software,3500000.0,USA,1,2,0,13712,13712,1
B2B|Cooking|Distribution|E-Commerce|Manufacturing|Online Shopping,54800000.0,JPN,2,1,9,16256,16265,0
Games|Virtual Worlds,550000.0,CAN,2,1,192,14041,14233,0
Games,179232.0,SWE,1,1,0,15034,15034,0
Telecommunications,30000000.0,USA,1,2,0,16421,16421,0
Enterprise Software,5500000.0,USA,2,5,1054,12251,13305,1
E-Commerce,8000000.0,USA,2,3,231,10849,11080,1
Technology,250000.0,USA,1,1,0,15918,15918,0
Enterprise Software|Storage,13000000.0,USA,1,2,0,15473,15473,0
Games,5960000.0,CAN,1,1,0,13531,13531,0
Business Services,1000000.0,RUS,1,1,0,15675,15675,0
Meeting Software|Technology,15000000.0,USA,1,2,0,14031,14031,1
Telecommunications,21600000.0,NGA,1,1,0,12956,12956,0
Databases,1800000.0,SWE,1,1,0,16462,16462,0
Games,10000000.0,SWE,2,3,146,13180,13326,0
Curated Web,987290.0,FIN,2,3,484,14663,15147,0
Enterprise Software|Telecommunications,48000000.0,USA,2,10,419,12094,12513,1
Enterprise Software,2622800.0,DEU,1,1,0,13479,13479,0
Advanced Materials,10000000.0,USA,1,1,0,13706,13706,0
Curated Web,333355.0,GBR,1,2,0,15862,15862,0
Education|Enterprises|SaaS,4089700.0,USA,2,1,951,14070,15021,1
Security,905000.0,RUS,1,1,0,15456,15456,0
Semiconductors,31800000.0,USA,3,11,784,12219,13003,0
Advertising|Big Data|Brand Marketing|CRM|Data Integration|Email Marketing|Internet Marketing|Mobile|SaaS|Social Media Marketing|Technology,6400000.0,USA,1,8,0,15339,15339,0
Analytics|Financial Services|Mobile|Optimization|Telecommunications|User Experience Design,20000000.0,CHE,1,1,0,12466,12466,0
Mobile|Video|Video Streaming,11695563.0,USA,4,14,1593,14883,16476,0
Enterprise Software|Mobile|Mobility|Virtualization,4000000.0,USA,3,4,511,15993,16504,0
Mobile|Retail|Shopping|Software,13000000.0,USA,1,1,0,16049,16049,0
Curated Web,2700000.0,ISR,1,3,0,13503,13503,1
Marketplaces,1688936.0,FRA,2,5,125,16400,16525,0
Healthcare Services|Infrastructure|Medical,14000000.0,USA,1,1,0,16266,16266,0
Semiconductors,1000000.0,USA,1,1,0,13082,13082,0
Health Care,7429362.0,USA,4,1,1652,13504,15156,0
All Markets|Fantasy Sports|Finance|Soccer|Sports|Trading,5600000.0,USA,4,13,1807,14669,16476,0
Curated Web,1100000.0,ISR,1,6,0,15826,15826,0
Mobile,4300000.0,USA,1,2,0,15426,15426,0
Social Media,402050.0,COL,5,2,1126,15126,16252,0
Crowdfunding|Finance,235677.0,GBR,2,1,894,15328,16222,0
Enterprise Software,6000000.0,USA,2,2,434,13757,14191,1
Curated Web,40000.0,USA,1,1,0,15712,15712,0
Crowdfunding|Entrepreneur|Finance,100000.0,ZAF,2,1,0,15248,15248,0
Internet Marketing|Technology,22160000.0,USA,4,5,1543,10856,12399,0
Crowdfunding|Enterprises|Nonprofits|Software,400000.0,AUS,1,1,0,16552,16552,0
Education|Language Learning,440000.0,USA,2,1,1077,14975,16052,0
Advertising|Small and Medium Businesses|Startups,10000.0,IND,1,1,0,15485,15485,0
Education|Professional Services|Startups,4300000.0,USA,2,1,244,16084,16328,0
Big Data Analytics|Data Visualization,169502.0,ITA,2,2,505,15656,16161,0
Automotive|Education|Entrepreneur|Finance|Incubators|Startups,100000.0,USA,1,2,0,15633,15633,0
E-Commerce,40000.0,CHL,1,1,0,16222,16222,0
Entrepreneur|Events|Startups|Venture Capital,1250000.0,USA,3,1,432,14853,15285,0
B2B|Cyber Security|Data Visualization|Finance|SaaS|Startups,1286600.0,EST,1,2,0,15964,15964,0
Startups,40000.0,COL,1,1,0,16314,16314,0
Employment|Entrepreneur|Events|Media|News|Startups|Technology,200000.0,USA,1,2,0,15042,15042,1
News,300000.0,BRA,1,3,0,15775,15775,0
Consulting|Startups,2300000.0,USA,1,4,0,15925,15925,0
Angels|Communities|Investment Management|Venture Capital,373082.0,ESP,2,10,450,16244,16694,0
Collaboration|Consumers|Curated Web|Recruiting|Search|Social Media,5500000.0,USA,3,4,895,14827,15722,0
All Students|Automotive|Biotechnology|Clean Technology|Consumer Internet|E-Commerce|Entrepreneur|Nonprofits|Startups,4800000.0,USA,3,6,377,15575,15952,0
Software,700000.0,USA,1,1,0,13223,13223,0
Software,3250000.0,CHN,2,4,1897,14278,16175,0
Analytics|Sales and Marketing|Social Media,107504.0,GBR,2,1,257,16071,16328,0
Biotechnology,31784070.0,ESP,2,2,690,15141,15831,0
Analytics|Big Data Analytics|SaaS,122749.0,BGR,2,2,242,15949,16191,0
Open Source|Opinions|Social Media|Startups,14163510.0,GBR,3,2,660,15187,15847,0
Nonprofits,213370.0,GBR,3,3,396,15572,15968,0
Software,6500000.0,USA,2,6,61,16220,16281,0
Travel,6716840.0,GBR,1,1,0,15266,15266,0
Software,15836001.0,USA,5,2,1043,14980,16023,0
Mobile|Mobile Advertising|Mobile Commerce,1798609.0,USA,2,1,217,16435,16652,0
Manufacturing,12367192.0,GBR,1,1,0,15436,15436,0
Big Data Analytics|Content|Demographies|Media|Sports,5300000.0,USA,2,6,404,14825,15229,0
Analytics|Games,813800.0,USA,2,4,396,15461,15857,0
Analytics|Business Intelligence|Enterprise Software|Finance|Software|Web Development,12000.0,USA,1,1,0,14822,14822,1
Mobile|Productivity Software|Sensors,1850000.0,USA,2,12,873,15261,16134,0
News|Small and Medium Businesses,55000.0,GBR,1,2,0,15975,15975,0
MicroBlogging|Open Source|Real Time|Social Network Media|Software,2395000.0,CAN,4,10,565,14259,14824,0
Displays|Software,100000.0,USA,3,4,123,15826,15949,0
Gamification|Soccer|Startups,674164.878257059,HUN,2,2,527,16161,16688,0
Curated Web,750000.0,USA,3,1,1077,13848,14925,1
CRM|Crowdfunding|Events|Nonprofits|Peer-to-Peer|Social Fundraising,18000000.0,USA,3,10,2006,14610,16616,0
Travel,2400000.0,USA,1,5,0,15903,15903,0
Cloud Computing|Enterprise Software|Hotels|Mobile|SaaS|Startups,3750000.0,USA,3,2,488,15911,16399,0
E-Commerce|Hotels|Online Reservations|Travel,20500000.0,IND,3,3,712,15765,16477,0
Health Care|Pharmaceuticals,15400122.0,ISR,4,4,2197,14272,16469,1
Big Data Analytics|Craft Beer|Mobile Analytics|SaaS,14000000.0,USA,4,2,814,15789,16603,0
Education,2200000.0,USA,1,6,0,16603,16603,0
Biotechnology|Industrial Automation|Innovation Engineering|Software,8544226.0,USA,2,3,325,15566,15891,0
Loyalty Programs|Mobile|Photo Sharing|Social Media Marketing,1488000.0,USA,2,2,320,16199,16519,0
Mobile,1100000.0,USA,3,4,330,15439,15769,0
Security,10000000.0,USA,1,1,0,13353,13353,1
Cloud Computing|CRM|Estimation and Quoting|Price Comparison|SaaS|Software,77500000.0,USA,4,10,579,16142,16721,0
Advertising|Analytics|E-Commerce|Retail,14550000.0,USA,3,11,863,14669,15532,0
Enterprise Software,42500000.0,USA,3,6,3809,12696,16505,0
Consumer Electronics|Home Automation|Lighting|Security,16390.0,CHE,1,1,0,16529,16529,0
E-Commerce|Entrepreneur|Jewelry|Retail,37000000.0,USA,1,1,0,14984,14984,0
Bitcoin|Finance|Finance Technology|Financial Services|FinTech|Nonprofits|Payments|Services,3000000.0,USA,1,1,0,16283,16283,0
Apps|Big Data|Mobile,5000000.0,USA,1,3,0,16351,16351,0
Clean Technology,7450000.0,USA,2,3,208,13848,14056,0
Manufacturing,750000.0,USA,1,1,0,14075,14075,0
Customer Service|E-Commerce|Online Shopping|Software,38949999.0,USA,6,21,2008,14623,16631,0
Design,35000000.0,USA,1,4,0,11246,11246,0
Emerging Markets|Hardware|Mobile,30000.0,SWE,2,4,276,15486,15762,0
Apps|Mobile|Social Network Media|Young Adults,172678.465711178,USA,2,1,365,15706,16071,0
Enterprise Software,100097672.0,USA,6,14,1576,15084,16660,0
Biotechnology|Health Diagnostics,473526990.0,USA,3,10,1638,15049,16687,0
Biotechnology,10000000.0,USA,2,1,791,15748,16539,0
Health and Wellness,2500000.0,USA,1,1,0,14935,14935,0
Biotechnology,51885190.0,USA,8,6,1261,14304,15565,0
Biotechnology,7502187.0,USA,4,5,2582,13866,16448,0
Biotechnology|Health and Wellness|Health Care|Health Diagnostics,15090000.0,USA,4,1,1378,13978,15356,1
Biotechnology,1000000.0,CAN,1,1,0,13203,13203,0
Education,25000.0,USA,1,1,0,16217,16217,0
Health Care,40200000.0,FRA,3,5,921,13517,14438,0
Gift Card|Mobile Commerce|Mobile Coupons,136181.0,FRA,1,1,0,16044,16044,0
Software,6500000.0,USA,1,4,0,13886,13886,0
Advertising|Android|iOS|Mobile|Sales and Marketing|Video,4899999.0,USA,2,2,504,15839,16343,0
Design|Telecommunications|Wireless,24910219.0,FRA,1,1,0,12437,12437,0
Consulting|Software|Telecommunications,3990853.0,USA,1,2,0,16212,16212,0
Finance|Online Dating|Social Media|Social Search,1347000.0,USA,2,2,1011,13879,14890,1
Fitness|Health and Wellness|Information Technology|Sports|Wearables,68497.0,BGR,2,2,151,16071,16222,0
Clean Technology,7992756.0,GBR,1,3,0,15330,15330,0
Biotechnology,46000000.0,USA,3,6,3427,12062,15489,1
Entertainment|Music|Networking|Social Media,230000.0,USA,2,3,378,15345,15723,0
Medical Devices,4564996.0,USA,2,1,1,16538,16539,0
Education|Mobile|Telecommunications|Ventures for Good,55063.0,CHL,2,1,164,16222,16386,0
Business Services|Enterprises|Software,30000000.0,USA,2,2,428,16314,16742,0
Social Media|Social Television|Television,2100000.0,ISR,4,6,856,15248,16104,0
Hardware + Software,19314063.0,GBR,1,1,0,15141,15141,0
Software,17000000.0,USA,1,1,0,15996,15996,0
Music,100000.0,USA,1,1,0,14411,14411,0
Brand Marketing|Facebook Applications|Sales and Marketing|Social Games|Social Media|Startups,100000.0,POL,2,2,0,15706,15706,0
Marketplaces,110490.0,USA,1,1,0,16630,16630,0
Advertising|Brand Marketing|Optimization,11000000.0,SWE,3,6,1080,15474,16554,0
Advertising|Advertising Platforms|Online Video Advertising|Real Time|Technology,6107133.0,FRA,3,3,971,14882,15853,0
Internet|Mobile,120000.0,USA,1,1,0,16467,16467,0
Curated Web|Mobile|SEO,1900000.0,USA,2,5,71,14677,14748,0
Communities|Social Network Media|Web Development,93549.0,GBR,1,1,0,16222,16222,0
Travel,62862.0,BGR,2,2,276,16191,16467,0
Business Services,2800000.0,USA,2,5,834,14934,15768,0
Curated Web,325000.0,USA,3,5,113,14123,14236,0
Information Technology|Networking|Network Security|Security|Storage,26400000.0,USA,2,4,2713,11495,14208,0
Health Care,1150000.0,USA,1,3,0,13012,13012,0
Cloud Computing|Hardware + Software|Internet of Things,250000.0,USA,1,1,0,13361,13361,0
3D Printing|Art|Curated Web|Design|E-Commerce|Fashion|Jewelry|Marketplaces|Publishing,1000000.0,DEU,1,3,0,16303,16303,0
E-Commerce|Social Buying,230000.0,TUR,1,1,0,15724,15724,0
Health Care|Medical Devices,1000000.0,ISR,1,1,0,15040,15040,0
Gas|Oil|Services,17330000.0,GBR,3,10,1526,13230,14756,0
Designers,5900000.0,USA,1,1,0,16286,16286,0
Clean Technology,220000000.0,USA,4,14,1995,13691,15686,0
Advertising|E-Commerce|Independent Music Labels|Photography,14379000.0,USA,4,26,757,14931,15688,0
Apps|Loyalty Programs|Mobile,15000.0,USA,1,1,0,15038,15038,0
Health and Wellness,1500000.0,USA,1,6,0,16149,16149,0
Restaurants,14000000.0,USA,1,2,0,12283,12283,0
Design,29.0,USA,1,5,0,12536,12536,0
Big Data Analytics|Data Center Automation|Data Visualization|Information Technology|Services,595000.0,USA,2,2,153,16265,16418,0
Mobile|SaaS|Sales and Marketing,3250000.0,USA,1,14,0,16184,16184,1
Online Dating|Senior Citizens|Travel,1077000.0,USA,3,7,948,15398,16346,0
E-Commerce|Fashion|Retail|Reviews and Recommendations|Subscription Businesses,46750000.0,USA,3,8,467,15764,16231,0
Business Analytics|E-Commerce|Real Time|Retail Technology|SaaS|Software,23000000.0,USA,4,14,1342,15386,16728,0
Entertainment|Internet Radio Market|Mobile|News|Sports,18700000.0,USA,3,9,1359,13879,15238,1
Internet,394000.0,IND,1,2,0,16620,16620,0
Mobile,2150000.0,DEU,2,2,386,15685,16071,0
E-Commerce|Retail,20000.0,USA,1,1,0,16269,16269,0
Finance|Video,25000.0,USA,1,1,0,14035,14035,0
Fashion,40000.0,CHL,1,1,0,15777,15777,0
Finance|Stock Exchanges,100000.0,IND,1,1,0,14978,14978,0
Finance|Social Media,1500000.0,USA,3,7,590,15595,16185,0
Finance|Financial Services|Investment Management|Personal Finance,1201693.0,AUS,2,3,440,16168,16608,0
Curated Web|Social Network Media|Software,8600000.0,USA,5,18,756,14145,14901,0
All Markets|Social Media|Social Network Media|Stock Exchanges,16249.0,GBR,1,1,0,16635,16635,0
Mobile,122609480.0,USA,11,25,3685,12418,16103,0
Food Processing,14000000.0,NZL,1,2,0,16757,16757,0
Software,12300000.0,USA,1,1,0,14621,14621,0
Finance,25000000.0,USA,1,1,0,15412,15412,1
Clean Technology|Water|Water Purification,4100000.0,USA,1,4,0,13803,13803,0
Internet|Marketplaces|Mobile|Real Time,1774173.0,FRA,2,4,478,16084,16562,0
Hardware|Privacy|Security|Software,500000.0,USA,1,1,0,14770,14770,0
Travel,19299.0,POL,1,1,0,15950,15950,0
Developer APIs,118000.0,USA,1,1,0,16517,16517,0
Security,1100000.0,USA,1,2,0,15383,15383,1
Enterprises|Service Providers|Storage,37000000.0,USA,2,10,805,11498,12303,0
Data Centers|Enterprises|Software,26680000.0,USA,5,13,1553,10771,12324,1
Software,33000000.0,TUR,3,3,619,14361,14980,0
Networking,50000000.0,USA,1,5,0,11274,11274,1
Collaboration|Manufacturing|Retail,1000000.0,USA,1,1,0,14568,14568,0
Ediscovery|Enterprises|Enterprise Software|Information Services,44541657.0,USA,5,9,1498,14060,15558,1
Biotechnology,76000000.0,ISR,4,7,784,15882,16666,0
Analytics,750000.0,USA,3,1,1206,15427,16633,0
Commercial Real Estate|Fashion|Marketplaces|Real Estate|Retail,8900000.0,USA,2,19,292,15882,16174,0
E-Commerce,6000000.0,USA,1,1,0,13545,13545,1
iPad|Photography|Publishing|Video,8500000.0,USA,2,9,126,16086,16212,0
Curated Web,171423.0,GBR,2,2,161,15726,15887,0
Artificial Intelligence|Business Services|Machine Learning,27433.0,DEU,1,1,0,16650,16650,0
E-Commerce|Social Buying|Social Media|Web Development,6525000.0,USA,2,13,773,14975,15748,0
Databases|Mobile|Retail,305836.0,GBR,2,2,156,16442,16598,0
Facebook Applications|Hospitality|iPhone|Mobile|P2P Money Transfer|Payments|Restaurants|Search|Software,436730.0,FRA,2,4,335,15005,15340,0
Blogging Platforms|Curated Web|Journalism|Media|Publishing|Real Time|Social Media|Social Network Media,2023000.0,USA,3,5,1188,14426,15614,1
E-Commerce,736000.0,GBR,1,1,0,15574,15574,0
Games|Online Gaming|PC Gaming,19889.0,EST,1,1,0,15918,15918,0
Enterprise Software|News|Risk Management,10800000.0,USA,2,4,459,13483,13942,0
E-Commerce,100000.0,CAN,1,1,0,14488,14488,0
Software,27033367.0,CHN,4,4,1584,13422,15006,0
Clean Technology,350000000.0,CAN,1,1,0,13917,13917,0
Cloud Security|Developer APIs|Developer Tools|Enterprise Software|Identity Management,24700000.0,USA,3,6,1288,15418,16706,0
Curated Web|Mobile|Social Television,700000.0,USA,1,1,0,16122,16122,0
B2B|Enterprise Software|News,3307500.0,USA,4,10,2458,13726,16184,0
EdTech|Education,9705000.0,USA,3,2,1649,14442,16091,0
Cloud Infrastructure|Data Center Infrastructure|Enterprise Software|Software|Storage,261620.0,BGR,2,2,415,15691,16106,0
Enterprise Software,31500000.0,USA,3,10,752,14396,15148,1
Software,13000000.0,USA,1,4,0,13671,13671,0
Storage,28000000.0,USA,2,4,301,13670,13971,1
Education,620000.0,USA,2,6,342,16275,16617,0
Curated Web|Education|Games|Media|Publishing,2500000.0,USA,1,7,0,15918,15918,0
Advertising|Media|Social Commerce|Video,2350000.0,USA,2,4,493,14641,15134,0
Apps|Non Profit,600000.0,USA,1,1,0,16630,16630,0
Social Media,321441.0,JPN,1,3,0,15618,15618,0
Content|Finance|Graphics|Mobile|Parenting,500000.0,USA,2,7,357,15839,16196,0
Entertainment|Games|Publishing|Web Development,3200000.0,IRL,4,3,1277,15279,16556,0
Baby Boomers|Consumer Internet|Families,167000.0,USA,1,2,0,15034,15034,0
Customer Service|Finance|Financial Services,8000000.0,CAN,1,1,0,16574,16574,0
Software,5650000.0,IRL,1,3,0,12794,12794,0
Education,16000000.0,USA,1,4,0,15443,15443,0
Local|Software|Translation|Web CMS,6300000.0,NZL,2,1,2709,13970,16679,0
Biotechnology|Health Diagnostics,30000000.0,USA,1,1,0,15427,15427,0
Artificial Intelligence|Banking|E-Commerce|FinTech|Personal Finance|Personalization|Reviews and Recommendations|Software,79000000.0,ESP,3,6,644,13208,13852,0
Apps|Data Integration|Marketing Automation|Personalization|Wearables,1220000.0,USA,2,7,137,16269,16406,0
Online Shopping,100000.0,USA,1,1,0,16375,16375,0
Infrastructure|Software|Virtualization,3700000.0,USA,2,8,251,16296,16547,0
Biotechnology,16000000.0,USA,1,3,0,13644,13644,0
Big Data Analytics|Cloud Computing|Data Visualization|Software,1231756.0,USA,2,2,61,15584,15645,0
Automotive|Software|Startups,10700000.0,USA,5,7,1581,13026,14607,1
Advertising,6250000.0,AUS,2,2,136,10956,11092,0
Finance|Financial Services|FinTech|Services,110000000.0,USA,1,1,0,16316,16316,0
Finance|SaaS|Trading,270000.0,RUS,2,4,91,16069,16160,0
Games,12000000.0,USA,1,1,0,16730,16730,0
Hardware + Software|Semiconductors|Sensors,2195000.0,USA,4,2,754,15714,16468,0
Biotechnology|New Product Development|Product Design,35929000.0,USA,7,6,1743,14859,16602,0
Software,42000000.0,ISR,2,5,372,16006,16378,0
Cloud Management|Enterprise Software|SaaS,500000.0,USA,1,1,0,13879,13879,0
Android|Fitness|Gps|Hardware + Software|Health and Wellness|iOS|iPhone|Mobile|Sports|Startups|Technology|Wearables,34600000.0,USA,4,7,1489,14883,16372,0
Clean Technology|Internet of Things|Mobile|Renewable Energies,136314.0,SRB,2,2,0,16222,16222,0
Travel,2225000.0,USA,3,4,323,15348,15671,0
Curated Web,1900000.0,USA,1,9,0,15628,15628,0
Mobile|Payments,1000000.0,SGP,1,2,0,15013,15013,0
Semiconductors,38000000.0,USA,2,4,537,12784,13321,0
Software,39000000.0,USA,5,12,2671,12807,15478,1
Telecommunications,933237.0,PRT,1,1,0,15964,15964,0
Enterprise Software,10790000.0,FRA,2,4,679,12922,13601,1
Android|Cloud Computing|Cloud Data Services|Developer APIs|FinTech|Internet|Internet of Things|iPad|iPhone|Mobile|Real Time|SaaS|Software|Web Development,9398833.0,FRA,3,5,1190,14761,15951,0
Mobile,45520000.0,FRA,4,21,1115,13262,14377,1
Education|Enterprise Software,205000.0,ISR,3,2,857,14313,15170,0
Computers|Data Visualization|Hardware + Software,5145960.0,GBR,2,6,585,13444,14029,0
SaaS|Software,3500000.0,USA,2,5,439,16134,16573,0
Cloud Computing|Enterprises|Enterprise Software|Social Media,1360000.0,USA,1,5,0,15522,15522,0
Content Delivery|Peer-to-Peer|Video|Video Streaming,2218000.0,FRA,2,2,384,16387,16771,0
Software,12500000.0,USA,1,5,0,16702,16702,0
Mobile|Mobile Video|Social Media|Software|Startups|Technology|Video,3029994.0,USA,4,11,365,15584,15949,0
Cloud Computing|Cloud Data Services|Consumers|Video Streaming,875000.0,USA,1,13,0,16185,16185,0
Advertising|Mobile|Software,200000.0,GHA,1,1,0,14579,14579,0
Automotive,16212601.0,GBR,3,3,753,13580,14333,1
Auto|Automotive|Cars|Photography|Social Media|Social Network Media|Video,7900000.0,USA,2,2,457,13757,14214,1
Bridging Online and Offline|Location Based Services|Marketing Automation|Messaging|Mobile|Mobile Analytics|Social + Mobile + Local,756803.0,AUS,2,1,1157,15095,16252,0
Bridging Online and Offline|Curated Web|Marketplaces,3800000.0,GBR,2,7,668,16059,16727,0
Finance,40000.0,CHL,1,1,0,15379,15379,0
Classifieds|Databases|Events|Finance|Local|Location Based Services|Networking|News|Social Media|Social Network Media,5829648.0,GBR,3,5,397,15917,16314,0
Hardware + Software|Mobile|SaaS,50000000.0,USA,4,15,1461,14791,16252,0
Auto|Cars|Insurance|Mobile|Services,95000.0,USA,2,3,0,15431,15431,0
Financial Services|FinTech|Marketplaces|Peer-to-Peer,203650000.0,USA,3,4,313,16192,16505,0
Interest Graph|Location Based Services|Online Dating|Social Media,750000.0,GBR,1,1,0,14914,14914,0
Semiconductors,58000000.0,USA,7,15,2106,13325,15431,1
Software,25000.0,USA,1,1,0,16083,16083,0
Software,5600000.0,USA,1,2,0,16120,16120,0
Agriculture,1000000.0,BRA,1,1,0,16344,16344,0
Hardware + Software,6000000.0,USA,2,5,249,14975,15224,0
Advertising,2771812.0,GBR,1,1,0,15350,15350,0
Advertising|Advertising Networks,7000000.0,USA,1,7,0,15965,15965,1
Enterprise Software,12840000.0,USA,3,7,1162,13585,14747,0
Mobile,1500000.0,USA,2,12,149,15675,15824,0
Internet|Messaging|Video,1200000.0,USA,1,3,0,16721,16721,0
Software,6300000.0,USA,1,2,0,16546,16546,0
News|Photography|Video,1500000.0,USA,1,3,0,16770,16770,0
Credit Cards|Payments|Software,280000000.0,USA,7,27,1821,14823,16644,0
Hardware + Software,210000.0,USA,1,1,0,15168,15168,0
Web Hosting,19000000.0,USA,5,18,1540,12339,13879,0
iPad|Mobile|Software|Web Development,2500000.0,USA,1,2,0,14944,14944,1
Clean Energy|E-Commerce|Green,135000.0,USA,2,1,0,15659,15659,0
Biotechnology,28000000.0,USA,3,7,1406,13594,15000,1
Health and Wellness,3631001.0,USA,3,1,1029,15636,16665,0
Software,800000.0,USA,1,3,0,16566,16566,0
Business Services|Coffee,980776.0,KOR,1,1,0,16238,16238,0
Consulting|Distribution|Software|Tech Field Support|Training,9000000.0,USA,2,3,198,15768,15966,1
Advertising|Displays|Email Marketing|Enterprise Software|SaaS|Social Media,38100000.0,USA,6,14,1946,12492,14438,1
Software,40000.0,CHL,1,1,0,15383,15383,0
Apps|Facebook Applications|iPhone|Mobile|Social Network Media|Twitter Applications,195420.0,ITA,1,1,0,14822,14822,0
Consulting,30000000.0,USA,1,1,0,13522,13522,0
Software,572000.0,GBR,1,2,0,13453,13453,0
Manufacturing,1500000.0,USA,1,1,0,16218,16218,0
3D|New Technologies|Services,13049.0,POL,1,2,0,16270,16270,0
Advertising|Displays|Sales and Marketing,8500000.0,USA,1,3,0,15449,15449,1
Mobile|Mobile Commerce|Mobile Shopping|Online Shopping|Shopping,1500000.0,USA,1,19,0,16308,16308,0
Advertising|Content|Developer APIs|Social Media|Software|Technology,1583166.0,CAN,2,3,542,13984,14526,0
Consumer Electronics|Fitness|Services|Sporting Goods,118000.0,USA,1,1,0,16600,16600,0
Logistics,25202754.9287981,FRA,2,1,290,16467,16757,0
Education|Information Services|Mobile,16390.0,NLD,1,1,0,16529,16529,0
College Recruiting|Professional Networking|Recruiting|Social Media|Social Network Media|University Students,159920.0,BEL,1,1,0,16360,16360,0
Finance|FinTech,871766.0,GBR,2,2,273,16071,16344,0
Mobile,1919583.0,JPN,2,2,944,15371,16315,0
Games,40000.0,CHL,1,1,0,15561,15561,0
Entertainment|Television,97500000.0,USA,5,10,645,10650,11295,0
Photography|Video Editing,20290000.0,USA,4,6,2623,13679,16302,0
Advertising,40000.0,CHL,1,1,0,15301,15301,0
Career Management|Recruiting|Staffing Firms,17228263.0,DEU,2,6,1059,15537,16596,0
Curated Web|Databases|Internet,1430645.48604856,NLD,1,2,0,16772,16772,0
Apps|Education,2247131.0,JPN,2,3,716,15847,16563,0
Education|High Schools,326300.0,ESP,1,2,0,15808,15808,0
Education|File Sharing|High School Students,22353939.0,USA,7,3,1988,14425,16413,0
Education,1584717.0,KOR,2,1,851,14610,15461,0
Education,3000000.0,USA,1,3,0,13879,13879,1
Marketplaces,2100000.0,USA,3,6,395,16375,16770,0
Content|Education|Publishing|Universities,100000.0,USA,1,1,0,16283,16283,0
EdTech|Education|SaaS,1977372.0,NLD,2,2,590,15738,16328,0
Advertising|Data Visualization,250000.0,USA,1,1,0,14245,14245,0
App Stores|Classifieds|iOS|Local|Mobile|Social Media|Trading,4221970.0,DEU,5,9,511,15469,15980,0
All Students|Education|Internet Marketing,275000.0,USA,1,1,0,16110,16110,0
Web Design|Web Development,852300.0,PRT,3,2,577,16143,16720,0
Content|Curated Web|Search,18500000.0,USA,4,17,3719,11323,15042,1
E-Commerce|Social Commerce,40000.0,USA,1,2,0,15777,15777,0
All Students|Real Estate,168403.0,GBR,2,1,777,15475,16252,0
Mobile|Networking|Social Network Media,100000.0,USA,1,1,0,13514,13514,0
Apps|Beauty|Local,110000.0,IND,1,1,0,16694,16694,0
Brand Marketing|Content|E-Commerce|Internet Marketing,2726459.0,DEU,1,3,0,16553,16553,0
Fashion,1075000.0,USA,2,2,327,14995,15322,0
Audio|Cloud Computing|Consumers|Entertainment|Mobile|Music|Software|Storage,310457.0,ROM,2,1,857,15340,16197,0
Collaborative Consumption|Fashion|Marketplaces|Peer-to-Peer,50000.0,USA,2,3,424,16071,16495,0
Mobile,228913.0,GBR,1,1,0,15813,15813,0
Beauty|E-Commerce,1000000.0,USA,1,1,0,16638,16638,0
Beauty|Digital Media|E-Commerce|Fashion|Internet|Lifestyle|News|Publishing|Social Media|Technology,5000000.0,USA,2,7,880,14426,15306,1
E-Commerce,227287.0,GBR,1,1,0,15876,15876,0
Fashion,1000000.0,IND,1,1,0,16679,16679,0
E-Commerce|Fashion|Mobile|Shoes,548472.0,GBR,2,2,212,15979,16191,0
Electronics|Shopping|Social Buying|Social Media,3500000.0,USA,3,5,608,13757,14365,1
Curated Web|Fashion|Online Shopping|Retail,27034.0,IRL,1,1,0,15979,15979,0
Beauty|Fashion|Photography|Video|Video Streaming,16900000.0,USA,3,8,467,15372,15839,0
Fashion|Social Buying,2620000.0,USA,1,1,0,13354,13354,1
E-Commerce,2527986.0,DEU,2,6,422,16236,16658,0
Fashion|Lifestyle|Shopping,1000000.0,USA,2,1,171,16234,16405,0
Analytics|Business Intelligence|Fashion|Internet|SaaS,733000.0,USA,1,6,0,16517,16517,0
E-Commerce|Fashion|Lifestyle,5800000.0,USA,2,8,449,15482,15931,0
Beauty|Personal Health|Social Media|Social Network Media,39900000.0,USA,4,25,1473,15156,16629,0
E-Commerce|Fashion|Lifestyle|Retail,1750000.0,USA,2,24,530,15400,15930,0
Fashion,3300000.0,KOR,2,3,624,15567,16191,0
Fashion,26000006.0,USA,3,2,545,14125,14670,1
Retail,7500000.0,IND,1,1,0,16756,16756,0
Fashion|Internet|Shoes,12450000.0,AUS,1,3,0,15427,15427,0
Crowdsourcing|Fashion,1500000.0,USA,1,6,0,14641,14641,0
Consumers|E-Commerce|Fashion|Marketplaces|Retail Technology,1580000.0,FIN,3,10,902,15522,16424,0
Collectibles|Ediscovery|Fashion|Lifestyle,20000.0,USA,1,1,0,15218,15218,0
Fashion,19000000.0,GBR,2,5,296,15076,15372,0
Analytics|Fashion,5605944.0,USA,5,1,1338,15216,16554,0
Beauty|E-Commerce|Spas,250000.0,IND,1,1,0,16763,16763,0
Fashion,9000000.0,GBR,1,1,0,15425,15425,0
Software,890000.0,USA,1,2,0,16665,16665,0
CRM|Customer Service|Information Technology,90000.0,BRA,1,1,0,16284,16284,0
Social Media,120000.0,USA,1,1,0,14993,14993,0
Hardware + Software,16325814.0,USA,3,3,2385,13483,15868,0
Hardware + Software,3788128.0,GBR,1,1,0,16019,16019,0
Communities|Digital Media|Internet|SaaS,700000.0,USA,2,4,12,15709,15721,0
Content|Subscription Businesses|Web CMS|Web Hosting,1000000.0,GBR,2,4,1748,12784,14532,0
Biotechnology,6291194.0,DEU,2,5,1859,13678,15537,0
Advertising,5000000.0,FRA,1,1,0,16581,16581,0
Curated Web|Enterprise Software,950000.0,USA,3,7,841,15654,16495,0
Education,3000000.0,USA,1,4,0,15271,15271,1
E-Commerce|Mobile|Tablets,500000.0,USA,1,6,0,15662,15662,0
Education,13500000.0,USA,2,3,700,15947,16647,0
Education,285000.0,IND,2,2,217,16036,16253,0
Consumer Electronics|Mobile|Music,250000.0,SWE,1,1,0,16679,16679,0
Art|E-Commerce|Fashion,40000.0,CAN,1,1,0,15385,15385,0
Beauty|Content|Curated Web|Entertainment|Fashion|Fitness|Lifestyle|Shopping|Women,46000000.0,USA,4,5,1654,13422,15076,0
Advertising|SEO,74583.0,GBR,1,1,0,14669,14669,0
Curated Web|Storage,61000000.0,USA,7,15,2987,13047,16034,1
Retail,20000.0,USA,1,1,0,16468,16468,0
Real Estate|Search,1690000.0,USA,3,12,843,15712,16555,0
Food Processing|Hospitality|Organic Food,21000000.0,USA,3,2,581,16085,16666,0
Communities|Internet|Social Network Media,23500000.0,FIN,1,3,0,12802,12802,0
E-Commerce|Local Businesses|Online Rental,28100000.0,IND,1,2,0,16545,16545,0
Social Media,11000000.0,USA,4,14,1400,14509,15909,0
Industrial|Innovation Engineering|Manufacturing,2814258.0,BRA,1,1,0,14601,14601,0
Fitness|Health Care|Technology,625000.0,DNK,1,1,0,15644,15644,0
Analytics|Business Intelligence|E-Commerce|Graphics,13500000.0,USA,5,10,1034,15492,16526,0
Software,23080241.0,CHN,7,8,3044,11413,14457,0
IT Management,3636603.0,GBR,2,3,2019,13939,15958,0
Health Care|Hospitals,2000000.0,USA,1,1,0,16519,16519,0
Clean Technology,82500000.0,USA,1,1,0,13770,13770,1
Semiconductors,16512391.0,USA,3,11,2019,13149,15168,1
Curated Web|Reviews and Recommendations|Search,750000.0,USA,1,2,0,13665,13665,1
Apps|iPhone|Mobile|Natural Language Processing|News,1530000.0,GBR,2,21,384,15230,15614,1
Consumers|Market Research|Mobile|Opinions|Video,98534.0,GBR,1,1,0,16090,16090,0
Analytics,155000000.0,USA,4,18,1217,15370,16587,0
Colleges|Direct Marketing|Social Media,425000.0,USA,2,2,600,15400,16000,0
Finance,3609590.0,USA,1,1,0,14882,14882,0
Credit Cards|Mobile|Mobile Payments,44293649.0,GBR,5,13,1135,15461,16596,0
Finance,1000000.0,USA,1,1,0,15603,15603,0
Cooking|Delivery|E-Commerce|Organic Food,4500000.0,USA,1,25,0,16695,16695,0
Clean Technology,18500000.0,USA,4,4,1325,14571,15896,1
Environmental Innovation,2000000.0,USA,1,5,0,16617,16617,0
Clean Technology,43600000.0,IND,4,1,917,14594,15511,0
Energy,1250000.0,USA,1,1,0,16164,16164,0
Clean Technology,2900000.0,USA,3,1,602,14062,14664,0
Information Technology,785000.0,IND,1,3,0,16653,16653,0
Internet,300000.0,IND,1,1,0,16762,16762,0
Advertising Platforms|Digital Media|Personalization|Software|Video,37000000.0,USA,3,11,1743,14250,15993,0
Android|Facebook Applications|Games|iOS|Mobile Games|Social Games,3000000.0,KOR,1,2,0,14944,14944,0
Health Care|Medical,10500000.0,CHN,2,3,914,12965,13879,0
Farming|Renewable Energies|Solar,100000000.0,GBR,1,1,0,16408,16408,0
Clean Technology,21300000.0,USA,1,1,0,13929,13929,0
Advertising|Email|Facebook Applications|Loyalty Programs|Mobile|Sales and Marketing|SMS|Social Media,1400000.0,USA,2,1,211,14851,15062,1
Clean Technology,1043300000.0,USA,7,19,2580,14022,16602,1
Biotechnology|Health Care,43500000.0,USA,1,9,0,14341,14341,1
Health Care,95199996.0,USA,5,6,971,15674,16645,0
Clean Technology,18759371.0,DEU,2,7,453,15673,16126,0
Clean Technology|Finance,2500000.0,USA,1,3,0,16386,16386,0
Software,316000000.0,USA,1,1,0,14477,14477,1
Clean Technology,245500000.0,USA,8,27,2782,13859,16641,0
3D|Architecture|Design|Product Design|Software,1800000.0,USA,1,10,0,15415,15415,0
Mobile Software Tools|Software,20000000.0,CHN,2,5,1232,14791,16023,1
Security,17265985.0,CHN,2,1,335,15218,15553,0
Distributors|E-Commerce|Manufacturing,4630000000.0,CHN,1,1,0,16657,16657,1
Clean Technology|Energy Efficiency|Green,230900000.0,USA,6,7,2274,13780,16054,0
Renewable Energies,2100000.0,LAO,1,1,0,16520,16520,0
Finance|Residential Solar|Service Providers,300000000.0,USA,1,3,0,16694,16694,0
Governments|Nonprofits|Politics,6527820.0,USA,2,2,899,14975,15874,0
Clean Technology,2900000.0,USA,3,3,903,13654,14557,0
Group Buying|Local Based Services|Media|News,100000.0,USA,1,1,0,14610,14610,0
Concentrated Solar Power|Renewable Energies|Residential Solar|Service Providers|Utilities,695000000.0,USA,4,3,531,16199,16730,0
Clean Technology,200000.0,USA,1,1,0,15404,15404,0
Babies|E-Commerce,375000.0,USA,1,1,0,15689,15689,0
Networking|Online Dating|SNS|Social Media,300000.0,KOR,1,1,0,15142,15142,0
Curated Web,149581.0,CAN,2,4,78,15201,15279,0
Clean Technology|Semiconductors,44500000.0,USA,1,1,0,16279,16279,1
Clean Technology,50000000.0,USA,1,2,0,15264,15264,0
Clean Energy|Clean Technology|Residential Solar|Solar,681600000.0,USA,10,19,2394,14050,16444,1
Manufacturing,2923307.0,CHN,1,1,0,12357,12357,0
Hospitality,7000000.0,CAN,1,1,0,15985,15985,0
Manufacturing,40000000.0,CHN,2,3,335,15133,15468,0
Mobility|Technology|Wearables,100000.0,USA,2,2,183,16007,16190,0
Banking|Credit|Finance,100000000.0,USA,1,1,0,16715,16715,0
Commercial Solar|Hardware + Software|Residential Solar|Utilities,15000000.0,USA,1,3,0,16238,16238,0
Advice|Collaborative Consumption|Internet|Mobile|Networking,142837.0,ESP,1,1,0,16471,16471,0
Apps|Internet|Local|Mobile|Social Network Media,1100000.0,GBR,1,4,0,16709,16709,0
Brand Marketing|Digital Media|Music|Social Media,127469.0,GBR,1,1,0,16380,16380,0
Internet of Things|Mobile|Mobile Games|NFC|Toys,530784.741313186,GBR,6,4,693,15553,16246,0
Manufacturing,4292699.0,CHN,2,1,1278,13422,14700,0
Games|Tablets|Technology,42000000.0,USA,4,16,1072,15584,16656,0
Games,1600000.0,USA,1,2,0,15103,15103,0
Mobile|Open Source|Service Providers|VoIP,4000000.0,USA,1,1,0,14879,14879,0
Games|Kids|Social Media Marketing,7000000.0,GBR,1,5,0,16633,16633,0
Career Management|Consulting|Services,201163.0,IRL,3,3,577,15614,16191,0
Games,143025351.23976398,FIN,3,11,930,14883,15813,1
Hardware + Software|Security,10000000.0,USA,1,1,0,14537,14537,0
Games|Market Research|MMO Games|Mobile|Video Games,7377578.0,USA,4,5,4109,10682,14791,0
Analytics|Finance|FinTech|Information Services|Internet|Risk Management,20000000.0,ISR,2,2,0,13879,13879,1
Health Care|Medical,75800000.0,USA,4,12,3146,12083,15229,1
Mobile|Search,19300000.0,USA,3,10,1667,14249,15916,0
Personalization|Search|Travel,500000.0,USA,1,1,0,15006,15006,0
Professional Services|Travel,1500000.0,USA,1,5,0,16237,16237,0
Software,6000000.0,USA,1,1,0,14540,14540,0
Design|Energy|Solar,50000.0,USA,1,1,0,16344,16344,0
Hospitality,405350.0,GBR,1,1,0,16344,16344,0
Advertising,270994.0,CHL,3,3,670,15340,16010,0
Lifestyle|Parenting|Women,21189.0,EGY,2,2,331,15222,15553,0
Delivery|E-Commerce|Groceries|Logistics|Mobile,1213012.3345738,ITA,3,4,242,16314,16556,0
Automotive|Electric Vehicles,6100000.0,USA,2,6,343,15999,16342,0
Education,3000000.0,IND,2,3,835,15598,16433,0
Clean Technology,24200000.0,USA,2,11,630,13622,14252,0
Games|Kids|Social Network Media|Virtual Worlds,10000000.0,USA,2,3,435,13879,14314,0
Biotechnology|Health Care,139847578.0,FRA,5,26,2962,13208,16170,1
Advertising|Mobile|Monetization,23200000.0,USA,5,3,1542,14730,16272,1
Software,5940000.0,FRA,2,4,478,13318,13796,0
Application Platforms,385798.500015432,GBR,1,1,0,16495,16495,0
Enterprise Software,2125000.0,USA,2,1,218,15616,15834,0
CAD,28000.0,USA,2,2,250,16019,16269,0
Electronics|Innovation Engineering|Search|Semiconductors,15500000.0,USA,4,7,2107,12265,14372,0
Construction|E-Commerce Platforms|Marketplaces|SaaS,2975000.0,USA,4,9,540,15323,15863,0
Pharmaceuticals|Software|Supply Chain Management,10000000.0,USA,1,5,0,13762,13762,0
Cloud Computing|Enterprise Software|Environmental Innovation|Supply Chain Management|Sustainability,235000.0,USA,1,2,0,16161,16161,0
Hardware|Manufacturing|Security,3000000.0,USA,1,3,0,12144,12144,0
Advertising,26201284.337455604,GBR,2,3,1380,14119,15499,0
Collaboration|Software,36250000.0,ISR,4,10,1725,13445,15170,0
Customer Service|Customer Support Tools|Services,150000.0,UKR,1,1,0,16040,16040,0
B2B|Customer Support Tools|Software,40000.0,IND,2,2,614,15279,15893,0
Local Search|Networking|Social Media|Social Search,4165000.0,USA,5,6,857,15340,16197,0
Accounting|Apps|Banking|Families|Finance|Legal|Parenting|Payments|SaaS|Web Tools,2700000.0,USA,4,11,821,15706,16527,0
Biotechnology,62875905.534601904,DEU,4,19,2554,13292,15846,1
Manufacturing,40000000.0,CAN,1,1,0,16300,16300,0
Document Management|Flash Storage|Software,4000000.0,USA,1,1,0,15329,15329,0
Logistics|Storage|Supply Chain Management|Technology,1500000.0,GBR,2,2,499,15706,16205,0
Financial Services,7000000.0,BGD,1,1,0,16547,16547,0
E-Commerce,1516843.0,USA,2,2,390,15835,16225,0
Hardware + Software,39347357.0,USA,3,5,1458,15286,16744,0
Cloud Data Services|Enterprise Software|Local Based Services|Local Businesses|Local Search|Location Based Services|SaaS|Semantic Search|Small and Medium Businesses|Social Media|Web Presence Management,2500000.0,USA,1,3,0,16227,16227,0
Cloud Data Services,13000000.0,USA,2,1,1090,15478,16568,0
Games,1600000.0,USA,1,1,0,13757,13757,0
B2B|SEO|Software,2670000.0,ISR,3,2,1498,14944,16442,0
News,5700000.0,IND,1,2,0,16083,16083,0
Transportation|Travel,83759387.0,USA,5,27,833,15456,16289,0
Messaging,12000000.0,USA,2,8,287,13075,13362,0
Biotechnology,23899974.0,USA,2,5,1210,13596,14806,1
Biotechnology,35000000.0,USA,1,4,0,16443,16443,0
Delivery|Logistics|Supply Chain Management,750000.0,IND,1,1,0,16205,16205,0
Content|Curated Web|Ediscovery|Search,5025000.0,RUS,3,2,906,15232,16138,0
Mobile,34914119.0,GBR,2,4,1,12628,12629,1
Telecommunications,15000000.0,GHA,1,2,0,16553,16553,0
E-Commerce|Security|Video Streaming,550000.0,NLD,3,2,396,15461,15857,0
Health and Wellness,750000.0,USA,1,1,0,15874,15874,0
3D Technology|Augmented Reality|Education|Health Care,73964.0,ITA,2,2,349,16282,16631,0
3D|Mobile|Mobile Health,5000.0,USA,1,1,0,15918,15918,0
3D|Health Care|Medical Devices,9525000.0,USA,2,3,927,15800,16727,0
Software,23037230.0,USA,2,5,1156,13341,14497,1
Finance|Venture Capital,50000.0,USA,1,2,0,15838,15838,0
Health Care,65333092.0,USA,6,11,2056,14463,16519,1
Manufacturing|Medical Devices,20000000.0,USA,1,6,0,13623,13623,0
Curated Web|Educational Games|Subscription Businesses,2100000.0,USA,2,1,724,15737,16461,0
Advertising|Augmented Reality|Games|Mobile|Video Games|Virtual Goods|Virtual Worlds,150000.0,USA,1,1,0,15201,15201,0
Nanotechnology|Semiconductors,11168660.0,GBR,3,7,1944,14479,16423,0
E-Commerce|Social Media,65000.0,HKG,2,1,0,15742,15742,0
Marketing Automation|Social Media|Social Media Marketing|Software,20000.0,USA,1,1,0,15824,15824,0
Analytics|Market Research|Surveys,7717000.0,USA,3,7,1145,15492,16637,0
Surveys,792132.0,USA,1,1,0,16267,16267,0
Big Data|Clean Technology|Geospatial,36700000.0,USA,1,3,0,16141,16141,0
Software|Surveys,1150000000.0,USA,5,17,2065,14354,16419,0
Software,2071730.0,USA,2,4,680,15826,16506,0
Software,150000.0,USA,2,2,531,15706,16237,0
Games|Hardware,4200000.0,USA,1,5,0,16209,16209,0
Games,158638.0,GBR,1,2,0,15434,15434,0
Business Analytics|SaaS|Sales and Marketing,100000.0,USA,1,1,0,16100,16100,0
Clean Technology,500000.0,IND,1,2,0,16239,16239,0
Banking,4500000.0,IND,1,1,0,16237,16237,0
Curated Web,325000.0,GBR,2,4,506,15314,15820,0
Clean Technology,16666.0,CHE,2,3,1641,14457,16098,0
Hospitality,8076565.84420305,GBR,1,1,0,13780,13780,1
Consulting|Real Estate|Sustainability,1200000.0,USA,1,1,0,14981,14981,0
Clean Technology,150000.0,USA,1,1,0,16175,16175,0
Clean Technology,235609.0,GBR,3,2,328,15743,16071,0
Clean Technology|Electrical Distribution|Electronics|Software,528530.0,GBR,1,1,0,16283,16283,0
Real Estate,1627829.0,USA,3,3,1216,14643,15859,0
Enterprises|Food Processing|Trading,96309.0,GBR,2,2,92,15645,15737,0
News,40000.0,USA,1,1,0,15749,15749,0
Home Renovation|Services|Sustainability,16390.0,NLD,1,1,0,16529,16529,0
Clean Technology,24000000.0,USA,3,2,629,14468,15097,0
Consulting,30000000.0,USA,1,1,0,13235,13235,0
Clean Technology|Hardware|Water,50000.0,USA,1,1,0,16071,16071,0
Biotechnology,116305000.0,USA,7,23,2901,13149,16050,0
Bio-Pharm,22000000.0,USA,1,4,0,16639,16639,0
Manufacturing,22900000.0,IND,1,1,0,15964,15964,0
Web Hosting,9470000.0,CAN,2,5,141,14032,14173,0
Curated Web,1180000.0,JPN,1,2,0,16146,16146,0
Semiconductors,76078582.0,USA,7,16,2871,13213,16084,0
Biotechnology,17825845.0,CHN,3,2,2343,13514,15857,0
Manufacturing,7896600.0,ITA,1,1,0,15454,15454,0
Nanotechnology,21507228.0,USA,5,1,864,14670,15534,0
Health Care,90566945.0,USA,8,7,2044,14392,16436,0
Advertising|Marketplaces|Social Media,965000.0,USA,3,7,168,15810,15978,0
E-Commerce,4830000.0,DEU,1,1,0,14771,14771,0
Software,20000000.0,USA,1,1,0,16273,16273,0
E-Commerce|Fashion,70000.0,UKR,1,1,0,15633,15633,0
Curated Web,550000.0,USA,1,5,0,14935,14935,1
Web Hosting,34000000.0,USA,1,2,0,14370,14370,0
Fashion,100000.0,USA,1,1,0,15294,15294,0
Advertising|Digital Media|E-Commerce|Gift Card|Internet Marketing|Market Research|Mobile|Online Shopping|Search|Surveys|Virtual Currency,60000000.0,USA,1,1,0,16203,16203,0
Water Purification,1200000.0,IND,1,2,0,16650,16650,0
Biotechnology,2060130.0,USA,1,3,0,16507,16507,0
Financial Services|Intellectual Asset Management|Investment Management,23000000.0,USA,1,1,0,16518,16518,0
Customer Service|Online Dating|Services,1099517.0,BEL,1,3,0,16325,16325,0
Collaboration|Music|Product Development Services|Social Network Media|Software|Startups,300000.0,USA,1,3,0,15740,15740,0
E-Commerce|Logistics|Shipping,3000000.0,USA,3,11,791,15765,16556,0
E-Commerce|E-Commerce Platforms|Games|Internet|Peer-to-Peer,1988994.0,USA,2,1,0,15918,15918,0
Curated Web,4650000.0,USA,2,6,365,11443,11808,1
Auctions|Curated Web|Finance|Marketplaces|Trading,46000.0,USA,3,2,578,15006,15584,0
Games,1000000.0,USA,1,1,0,15911,15911,0
E-Commerce|Social Commerce|Web Development,30000.0,USA,1,1,0,16467,16467,0
Coupons|E-Commerce,100000.0,ISR,1,1,0,15218,15218,0
Apps|Internet|Mobile,750000.0,USA,1,3,0,16708,16708,0
Curated Web|Finance|Kids|Recycling|Retail|Social Commerce|Trading,11350000.0,USA,3,2,1424,13330,14754,0
Bitcoin|Crowdfunding|Financial Services|Virtual Currency,1010000.0,USA,2,1,73,16271,16344,0
Analytics|Location Based Services|Mobile|Retail|Shopping|Web Development|Wireless,4500000.0,USA,2,7,418,15623,16041,1
3D Printing|E-Commerce|Hardware|Internet|Manufacturing|Product Design,20000.0,ISR,1,1,0,16287,16287,0
Advertising|Sales and Marketing|Social Media,2000000.0,USA,1,2,0,14628,14628,0
Biotechnology|Software,750000.0,USA,1,2,0,15877,15877,0
Advertising|Email|Optimization|Sales and Marketing|Software,1486851.0,USA,3,2,680,14123,14803,0
B2B|Business Services|Consumers|Entertainment|Sales and Marketing|Small and Medium Businesses,27793.321450144304,LTU,1,1,0,16660,16660,0
Hospitality,33600000.0,USA,2,2,355,13971,14326,1
Consumer Goods|Manufacturing|Specialty Foods,50000.0,USA,1,1,0,16421,16421,0
Analytics|E-Commerce|Enterprise Software|Loyalty Programs|P2P Money Transfer|Retail|SaaS|Software,1003851.0,CAN,1,2,0,15467,15467,0
Business Services|Construction|Home Renovation|Marketplaces|Match-Making|Real Estate,7320183.0,USA,3,5,617,16111,16728,0
Hospitality|Organic Food,75500000.0,USA,3,13,575,16042,16617,0
Local Search|SEO|Software,4200000.0,CAN,2,9,1463,15279,16742,0
Local|Marketplaces,40000.0,USA,1,1,0,16594,16594,0
Android|App Discovery|SaaS|Software,21500000.0,USA,3,12,1096,14150,15246,0
Food Processing,107125.0,GBR,1,1,0,15826,15826,0
Software,1286600.0,USA,1,2,0,15998,15998,0
Advertising|Content|Mobile|Sales and Marketing|Wireless,1100000.0,USA,1,1,0,16010,16010,0
Entertainment|Media|Social Media|Social Opinion Platform,1180000.0,USA,2,3,396,16266,16662,0
Health Care|Payments,11600000.0,USA,2,4,395,16314,16709,0
Biotechnology,11999999.0,USA,4,4,1848,14840,16688,0
Security,49342.0,CAN,1,1,0,15810,15810,0
Hardware + Software,2600000.0,USA,1,5,0,16303,16303,0
Legal,571895.0,DNK,2,1,321,16252,16573,0
Apps|Consumers|Internet|Pets,2500000.0,USA,1,1,0,15822,15822,0
Health Care|Health Care Information Technology|mHealth,723090.682838401,IRL,3,5,1320,15393,16713,0
Big Data|Consumers|Hospitality|Interest Graph|Online Travel|Travel,8000000.0,SGP,2,1,543,14610,15153,0
Software,1015921.7514491,GBR,1,2,0,16197,16197,0
Software|Storage,23600000.0,USA,3,9,906,15461,16367,0
App Marketing|Developer APIs|E-Commerce|Open Source|User Experience Design,22200000.0,USA,4,21,1159,15340,16499,0
Food Processing,37000000.0,IND,3,8,233,16528,16761,0
Farming|Software|Water,3490000.0,USA,2,1,913,15839,16752,0
Sports,800000.0,USA,3,3,457,15492,15949,0
Curated Web,3475521.0,USA,2,1,235,15196,15431,0
News,4976700.0,IND,1,1,0,16176,16176,0
Curated Web|Presentations|Real Time,1000000.0,GBR,2,5,748,15917,16665,0
Advertising,4018000.0,USA,2,6,286,15826,16112,0
Nonprofits,500000.0,USA,1,6,0,15015,15015,0
Mobile Advertising|Mobile Payments|Payments,95000.0,USA,1,2,0,16565,16565,0
Finance|Payments,40500000.0,USA,5,24,1655,14564,16219,0
Health and Wellness,12228037.0,USA,4,3,1162,15434,16596,0
Analytics|Big Data|Social Media,9001000.0,USA,4,2,334,15483,15817,0
Mobile|Mobile Software Tools|Retail|Sales and Marketing,32000000.0,USA,3,11,995,15553,16548,0
Big Data Analytics|Fantasy Sports|Predictive Analytics|Sports,20000.0,USA,1,1,0,16671,16671,0
Information Technology|Medical|Mobile|Software,3000.0,CHE,1,1,0,15675,15675,0
Medical Devices,12500000.0,TWN,1,2,0,12564,12564,0
Human Resources|Mobile|Networking|Recruiting,2400000.0,USA,1,10,0,16414,16414,0
Information Technology,1250000.0,AUS,1,1,0,16476,16476,0
Telecommunications|VoIP,53000000.0,USA,3,6,1509,15065,16574,0
Clean Technology,7500000.0,CAN,1,4,0,14624,14624,0
Communities|Education|Social Media,550000.0,USA,3,2,395,15989,16384,0
Events|Photography|Video,1220000.0,USA,3,9,232,15273,15505,0
Loyalty Programs|Online Travel|Software,34799900.0,USA,5,19,3360,12265,15625,0
Online Identity|Web Hosting|Web Tools,595043.0,ITA,2,4,533,15860,16393,0
Search,2000000.0,USA,2,2,212,13392,13604,0
Android|Apps|Education|iOS|Video,4550000.0,USA,7,9,1553,15125,16678,0
E-Commerce,1559194.0,GBR,6,5,995,15564,16559,0
Sports,20000.0,USA,1,1,0,16358,16358,0
E-Commerce|Furniture,8620520.0,GBR,3,5,419,15853,16272,0
Advertising,13400000.0,USA,5,1,1452,14975,16427,0
Auctions|E-Commerce|Shopping,14000000.0,USA,2,2,1187,13149,14336,0
Software,5300000.0,USA,1,2,0,13503,13503,1
Biotechnology|Health Diagnostics,5450802.0,USA,6,5,3694,12874,16568,0
DOD/Military|Retail|Textiles,50000.0,USA,1,1,0,16008,16008,0
Internet|Marketing Automation|Mobile|Mobile Analytics|Mobile Software Tools|Predictive Analytics|Social Media,51139440.0,USA,5,18,2496,14254,16750,0
Mobile|Mobile Payments|Public Transportation|Software|Transportation,550000.0,USA,1,5,0,16252,16252,0
Android|Apps|Software,15599906.0,USA,6,11,831,14336,15167,1
Blogging Platforms|Content|Information Technology|Software|Sponsorship|Video,90000.0,USA,1,1,0,13665,13665,0
Social Media,162778.0,CHN,2,2,517,15340,15857,0
Enterprise Software|Health Care Information Technology|Semantic Search,14600000.0,USA,3,3,1286,14975,16261,0
Internet|Services|Wireless,50000000.0,USA,3,20,944,11627,12571,1
Software,12800000.0,USA,2,4,703,12107,12810,0
Computers|Enterprises|Network Security,29880000.0,USA,2,4,462,12016,12478,1
Software,1247800.0,FRA,1,1,0,15518,15518,0
Software,70500000.0,USA,3,12,2008,11231,13239,1
Semiconductors,37570000.0,FIN,4,10,2429,12683,15112,0
Android|Apps|Big Data|Education|iOS|Mobile|Productivity Software,20000.0,USA,1,1,0,15371,15371,0
Clean Technology,40000.0,CAN,1,1,0,16028,16028,0
Software,1000000.0,FRA,1,1,0,13208,13208,0
Mobile,60139600.0,GBR,2,4,3198,11717,14915,0
Pharmaceuticals,41000000.0,USA,1,4,0,16561,16561,0
Health Care|Hospitals|Marketplaces|Medical,848540.0,USA,2,1,1023,15540,16563,0
Biotechnology|Green,7500000.0,USA,1,1,0,16387,16387,0
Biotechnology,48000000.0,IND,1,1,0,16000,16000,0
Big Data|Curated Web|Health and Wellness|Technology,134724.0,USA,2,1,99,15428,15527,0
Enterprise Software|Mobile|Networking|Social CRM,18000.0,USA,1,1,0,15826,15826,0
Biotechnology,25800000.0,CHE,2,3,573,14890,15463,0
Health Diagnostics|Security,4684100.0,GBR,4,8,3509,13075,16584,0
Cloud Computing|Cloud Data Services|Storage|Web Hosting,19700000.0,USA,6,10,1865,14361,16226,1
Biotechnology,42875687.0,USA,4,3,753,16017,16770,0
Bioinformatics|Computers|Software,50000.0,USA,1,1,0,14903,14903,0
Health and Wellness|Medical|Therapeutics,12816000.0,USA,3,1,630,15796,16426,0
Biotechnology,495314228.848417,DNK,9,25,4003,12727,16730,0
Social Media,750000.0,USA,5,2,4769,10917,15686,0
Technology,166000000.0,USA,2,26,376,16344,16720,0
E-Commerce|E-Commerce Platforms|Fashion|Online Shopping,39044997.0,USA,5,17,1245,15072,16317,0
Biotechnology,20000000.0,USA,1,1,0,13257,13257,1
Cloud Computing|Mobility|SaaS|Software,20000000.0,USA,1,1,0,12324,12324,0
Cloud Computing|Enterprise Software|Identity|Identity Management|SaaS,47778903.0,USA,5,6,1478,13879,15357,0
EdTech|Education|Video,106000000.0,USA,4,12,1156,15231,16387,0
Artificial Intelligence|Health Care|Software,250000.0,USA,1,1,0,15898,15898,0
Software,605250.0,DEU,1,1,0,13249,13249,0
Electronic Health Records|Health Care Information Technology|Medical|Physicians|SaaS|Software,50000.0,USA,1,1,0,15959,15959,0
Semiconductors,32300000.0,USA,4,8,1528,12934,14462,1
Web Hosting,11717309.0,CHN,1,1,0,14482,14482,0
Crowdsourcing|Cyber Security|Data Security|Network Security|Security,34000000.0,USA,4,19,724,15761,16485,0
Advertising Platforms|Email|Identity Management|Internet TV|Mobile Software Tools|Portals|Software,17000000.0,USA,2,12,985,12460,13445,1
Biotechnology,70000000.0,USA,4,11,705,14349,15054,1
Software,2000000.0,USA,1,2,0,16667,16667,0
Advertising|Big Data Analytics|Psychology,100000.0,MEX,1,1,0,16462,16462,0
Biotechnology,4430000.0,FRA,1,4,0,14309,14309,0
Health Care,32400000.0,USA,5,10,1147,14761,15908,0
Email|Sales and Marketing|Software,495000.0,USA,3,4,301,15826,16127,0
Health Care,3103358.0,USA,3,2,2788,13269,16057,0
Clean Technology|Data Centers|Green|Sensors|Web Hosting|Wireless,44500000.0,USA,6,29,2599,13298,15897,1
Ad Targeting|Artificial Intelligence|Content Discovery|Machine Learning|Predictive Analytics|Publishing|Semantic Search|Social Media,1450000.0,USA,2,7,512,15762,16274,0
Social Media|Software|Video,5000000.0,USA,1,3,0,13067,13067,1
Software,7341000.0,USA,4,2,725,14063,14788,1
Bio-Pharm,10200000.0,USA,1,2,0,12481,12481,1
Cloud Computing|Enterprises|Enterprise Search|Enterprise Software,644000.0,USA,5,4,594,15737,16331,0
Material Science,206360.0,CAN,3,1,216,16175,16391,0
Big Data|Curated Web|Event Management|Mobile|Networking|Social Media,10000.0,USA,2,1,243,16436,16679,0
Developer APIs|SaaS|Software,10250000.0,USA,4,2,982,15706,16688,0
Facebook Applications|Social Media Management|Social Media Marketing|Software,28300000.0,CAN,2,3,290,14739,15029,0
Software,4500000.0,USA,1,3,0,13039,13039,1
Software,2450000.0,GBR,1,1,0,13788,13788,0
Biotechnology,26000000.0,USA,2,2,877,15376,16253,0
Mobile,39730000.0,GBR,5,3,1262,13894,15156,1
Advertising|Distribution,960000.0,USA,3,1,494,15900,16394,0
Manufacturing,25000000.0,USA,3,3,1217,13847,15064,0
Biotechnology|Health Care|Life Sciences|Medical Devices,725000.0,USA,1,5,0,16623,16623,0
Cloud Computing|Digital Media|Music|Software|Synchronization,650000.0,USA,1,1,0,15065,15065,0
Software,634000.0,DEU,1,1,0,13409,13409,0
Enterprise Software,2350000.0,USA,1,2,0,14183,14183,1
Curated Web|Digital Media|Publishing|Software,1110000.0,USA,2,8,912,14975,15887,0
Hardware + Software,2830000.0,USA,1,1,0,13824,13824,0
Hardware + Software,1286600.0,IRL,1,2,0,15939,15939,0
Cyber Security|Information Security|Security|Software,100000.0,USA,2,2,178,16315,16493,0
Software,11600000.0,USA,1,3,0,13739,13739,0
Software,10000000.0,USA,1,2,0,12954,12954,0
Beauty|Consumer Goods|Health Care,15200000.0,USA,4,3,2040,13482,15522,0
Semiconductors,33385935.0,USA,5,2,1340,14312,15652,0
E-Commerce|Enterprise Software|Product Search|Retail Technology,1950000.0,NLD,3,2,1408,15006,16414,0
Crowdfunding|Finance|Venture Capital,1844725.36651106,GBR,2,2,240,16315,16555,0
Semiconductors,10500000.0,USA,1,5,0,14719,14719,0
Automotive,515000.0,USA,2,2,302,15949,16251,0
Biotechnology,2340000.0,USA,3,7,1638,15013,16651,0
Health and Wellness,18962157.0,USA,3,1,1388,15063,16451,0
Pharmaceuticals,2.0,USA,1,1,0,12094,12094,0
EdTech|Education,45732000.0,USA,3,4,553,15973,16526,0
Image Recognition|Training,40000.0,CHL,1,1,0,15385,15385,0
Consulting|Entrepreneur|Internet|SaaS|Small and Medium Businesses|Software,50000.0,USA,1,1,0,15039,15039,0
Analytics|Big Data|Software|Visualization,1900000.0,NLD,2,3,1583,15034,16617,0
Analytics|Cloud Computing|Linux|Open Source,1406000.0,RUS,2,1,1611,13879,15490,0
Advertising|Analytics|Biometrics|Broadcasting|Business Intelligence|Business Services|Crowdsourcing|Market Research|Media|Wearables,406011.0,HUN,2,3,365,16010,16375,0
Analytics|Consumers|Software,70000.0,IRL,1,1,0,15706,15706,1
Software,16040161.0,USA,3,8,1683,12675,14358,1
Health Care,13750000.0,USA,6,3,1146,15448,16594,0
Cloud Management|Mobile,1400000.0,USA,1,1,0,16018,16018,0
Biotechnology,34400000.0,USA,2,3,77,16273,16350,0
Manufacturing,19999999.0,USA,2,1,68,15431,15499,1
Biotechnology,91500000.0,CHE,3,18,1376,13518,14894,1
Biotechnology,5802480.0,FIN,2,9,538,16023,16561,0
Games,20000.0,USA,1,2,0,15740,15740,0
Biotechnology|Medical|Therapeutics,3285922.0,GBR,1,1,0,16664,16664,0
Big Data|Film Production|Media|TV Production|Video Streaming,406500.0,NOR,2,2,139,16626,16765,0
Software,4000000.0,RUS,1,1,0,14975,14975,0
Biotechnology|Health Care,155350000.0,USA,5,6,4095,12431,16526,1
Biotechnology,71390000.0,GBR,3,13,1823,13101,14924,1
Software,3500000.0,SWE,1,1,0,14043,14043,1
Biotechnology,4869826.0,GBR,4,11,602,15807,16409,0
Biotechnology,784826.0,FRA,1,4,0,16091,16091,0
Brand Marketing|Business Intelligence|Social CRM|Social Media Monitoring|Software,22180000.0,USA,4,6,2826,13317,16143,0
Biotechnology,16103380.0,USA,2,2,321,15650,15971,0
Biotechnology,40000001.0,USA,2,2,2601,13140,15741,0
Biotechnology,6000000.0,USA,1,2,0,16181,16181,0
Enterprise Software,9100000.0,USA,2,5,310,12849,13159,0
Software,500000.0,USA,1,1,0,16293,16293,0
Apps|B2B|Fleet Management|Internet of Things|Logistics|Mobile|SaaS|Software,471000.0,SGP,1,1,0,16300,16300,0
Software,7000000.0,USA,2,6,764,12962,13726,0
Business Services|Defense|Games|Software|Technology,40000.0,CHL,1,2,0,15765,15765,0
Clean Technology,3032235.0,GBR,2,3,830,14967,15797,0
Electronics|Mobile|Skate Wear|Sports,25000.0,USA,3,2,508,16059,16567,0
Biotechnology,83000000.0,USA,2,8,564,15806,16370,0
Software,7220000.0,CAN,1,1,0,13149,13149,0
Software,13000000.0,USA,2,3,744,15886,16630,0
Analytics|Business Intelligence|Social Media,250000.0,CAN,1,3,0,14231,14231,1
Hardware + Software,1380034.419682,GBR,1,1,0,14396,14396,0
Consulting,1500000.0,USA,1,1,0,12852,12852,0
Enterprise Software|Software,33800000.0,USA,3,6,937,11619,12556,1
Internet,120000.0,USA,1,1,0,16652,16652,0
Artificial Intelligence|Content Discovery|Curated Web|Machine Learning|Personalization|Reviews and Recommendations,50000.0,USA,2,1,237,15706,15943,0
Business Services|Internet,1252515.0,POL,1,1,0,15580,15580,0
Games,2100000.0,ISL,1,4,0,16750,16750,0
Crowdsourcing|E-Commerce|Fashion,65000.0,ARG,2,2,258,15412,15670,0
Biotechnology,6340000.0,DNK,1,3,0,12363,12363,0
Communications Hardware|Services|Telecommunications,27000000.0,USA,1,1,0,12488,12488,0
Public Relations,5750000.0,USA,1,4,0,12842,12842,0
Analytics|SaaS|Software,1560000.0,USA,2,1,15,16224,16239,0
Semiconductors,40000000.0,USA,1,6,0,12893,12893,0
File Sharing|Video|Video Streaming,1000000.0,ISR,1,1,0,16685,16685,0
Public Relations,6940000.0,NOR,2,3,750,12837,13587,1
E-Commerce|Manufacturing,13933.0,BGD,4,2,926,15510,16436,0
Software,7400000.0,USA,3,1,2281,13879,16160,0
Health Care,83500000.0,USA,5,33,2643,13149,15792,1
Parking|Software,31000000.0,USA,2,2,1558,13689,15247,0
Security,113000000.0,USA,1,3,0,15839,15839,0
Education,620000.0,THA,1,5,0,16281,16281,0
Financial Services,40704.0,USA,2,2,0,16272,16272,0
Hospitality|Mobile|Mobile Payments,39010353.0,USA,6,11,1969,14621,16590,0
Curated Web|Photography,4000000.0,USA,1,1,0,13149,13149,1
Advertising,10000.0,CZE,1,1,0,15461,15461,0
Entertainment,4600000.0,USA,1,1,0,16196,16196,0
Restaurants,78000.0,MYS,2,4,472,16294,16766,0
Big Data Analytics|Data Visualization|Software,15000000.0,USA,2,2,1674,12418,14092,1
Artificial Intelligence|Online Reservations|Restaurants|Search|Startups,506719.0,SWE,3,3,540,13223,13763,0
E-Commerce|Restaurants,323830.0,IND,2,2,665,15940,16605,0
Entertainment|Games|iPhone|Lifestyle|Mobile|Nightlife|Travel,5524999.0,USA,4,8,351,16272,16623,0
Publishing,278293.0,TUR,1,1,0,15771,15771,0
Consumer Electronics|Curated Web|E-Commerce|Publishing|Textbooks,420000.0,AUS,2,4,465,15796,16261,0
Software,16000000.0,USA,1,2,0,13445,13445,0
Advertising|Content|Content Discovery|Curated Web|Video,160000000.0,USA,7,19,2772,13818,16590,0
Hospitality,250000.0,USA,2,2,100,15675,15775,0
Consumers|Hospitality|Software,480000.0,SGP,1,2,0,15706,15706,0
Analytics|Android|Big Data Analytics|Business Intelligence|Education|iOS|SaaS|Sales and Marketing|Skill Assessment|Training,248648.0,GBR,2,3,214,15796,16010,0
Games,13500000.0,ISR,4,6,1027,14975,16002,0
EdTech|Education,1000000.0,USA,1,4,0,15868,15868,0
Android|Bitcoin|Mobile|Trading,73784.0,NLD,2,1,139,16478,16617,0
Semiconductors,108000000.0,USA,2,8,1335,13726,15061,0
Games|Incentives|Video Games,17345709.0,USA,6,2,2294,13118,15412,0
E-Commerce,1286600.0,ITA,1,1,0,15950,15950,0
Aerospace|Hardware + Software,17070000.0,USA,3,7,2515,12324,14839,0
Data Centers|Open Source|Storage,7500000.0,USA,1,1,0,16511,16511,0
Big Data Analytics|Enterprise Software|Sensors,20728000.0,USA,3,12,761,15826,16587,0
Mobile,1150000.0,CAN,2,3,181,16112,16293,0
Consulting|E-Commerce|Retail|Shopping|Software|Technology,7000000.0,USA,1,4,0,12528,12528,1
Web Hosting,19300000.0,USA,2,9,878,12030,12908,1
Collaboration|Enterprise Software|Knowledge Management|Software,10000000.0,USA,1,4,0,11527,11527,1
Curated Web|EdTech|Mobile Social|Web Tools,1800000.0,USA,9,25,1203,15440,16643,0
Advertising,19000000.0,USA,2,5,337,13216,13553,1
Hardware + Software,500000.0,USA,1,1,0,15843,15843,0
Cloud Computing|Databases|Software|Twitter Applications,1500000.0,USA,1,1,0,16007,16007,0
Software,11200000.0,USA,1,4,0,16154,16154,0
Health Care,23200000.0,USA,3,3,1802,13816,15618,0
3D|3D Technology|Electronics|Product Design,1971750.0,FIN,1,1,0,15366,15366,0
Human Computer Interaction,25400000.0,USA,3,5,1431,14641,16072,0
Curated Web|Governments|Software,654891.0,LUX,3,2,559,15325,15884,0
Clean Energy|Clean Technology|Home Automation,33294621.0,DEU,3,9,762,15953,16715,0
Mobile,50000.0,USA,1,1,0,15355,15355,0
Enterprise Software,1609004.0,GBR,1,1,0,13760,13760,0
Advertising|Curated Web,8228681.0,FRA,1,3,0,16351,16351,0
Computer Vision|Lasers|Manufacturing|Material Science|Photography|Semiconductor Manufacturing Equipment,903171.0,USA,3,2,1279,15065,16344,0
Mobile|NFC|Pets,77000.0,USA,3,2,610,15492,16102,0
Mobile|RFID|Tracking|Wireless,5972500.0,USA,3,4,1430,13545,14975,0
Photography|Semantic Web|Software|Video,1395000.0,USA,3,8,1343,15315,16658,0
Brand Marketing|iPhone|Mobile|Services|Social Media|Social Network Media|Web Development,600000.0,RUS,2,2,549,15126,15675,0
Internet|SaaS|Social Media|Software,292957.0,GBR,2,1,230,15992,16222,0
Electronics,2588460.0,FRA,1,1,0,15471,15471,0
Social Media,28701975.0,USA,5,5,2547,13027,15574,0
Advertising|Advertising Platforms|Blogging Platforms|Internet Marketing|Mobile Advertising|Monetization|Software|Web Development|Web Tools,1040000.0,ARG,2,4,219,15181,15400,0
Games,8750000.0,IND,1,2,0,14783,14783,0
Internet,520000.0,USA,2,2,532,15826,16358,0
Public Relations,50000.0,USA,1,1,0,15765,15765,0
Social Business,705373.0,GBR,2,5,1065,15340,16405,0
iPhone|Location Based Services|Messaging|Mobile|Online Reservations|SEO|Social Media,50000.0,USA,1,1,0,14706,14706,0
Fashion,250000.0,USA,1,1,0,16482,16482,0
Cloud Computing|CRM|Databases|Digital Media|Enterprise Software|Software,886699.0,BRA,1,3,0,15636,15636,0
Advertising|Classifieds|Curated Web|Ediscovery|Information Technology|Search|Startups,184845.0,GBR,2,2,265,14700,14965,0
Software,73884800.0,USA,4,13,1802,12891,14693,0
Mobile,2225818.0,BEL,3,3,142,15992,16134,0
Diagnostics,14225000.0,USA,2,1,134,16597,16731,0
Development Platforms|Enterprise Software|Open Source|SaaS|Software,550000.0,USA,2,1,0,16344,16344,0
Biotechnology,75000000.0,TWN,2,13,1752,12493,14245,0
Ad Targeting|Analytics,500000.0,BRA,1,1,0,15706,15706,0
Software,6340000.0,SWE,2,2,2129,13102,15231,1
Fashion|Lifestyle|Weddings,500000.0,USA,2,1,111,15260,15371,0
Big Data|E-Commerce|Fashion|Retail|Reviews and Recommendations|Shopping,49000.0,USA,3,2,201,16052,16253,0
Design|E-Commerce|Fashion|Lifestyle,25000.0,ITA,1,1,0,16386,16386,0
Curated Web,640000.0,GBR,3,2,337,16165,16502,0
Advertising|Analytics|Social Bookmarking|Social Media|Social Media Marketing,1000000.0,USA,1,2,0,16015,16015,0
Biotechnology,22000000.0,TWN,1,2,0,14699,14699,0
Printing|Semiconductors|Technology,16250000.0,USA,1,7,0,12445,12445,0
Clean Technology|Smart Grid,6000000.0,ISR,1,1,0,15994,15994,0
Human Resources|Software,6121763.0,USA,5,5,1091,15196,16287,0
Art|Entertainment,17000.0,IND,1,1,0,16153,16153,0
E-Commerce|Online Shopping|Retail,100000000.0,ZAF,4,1,1330,14883,16213,0
Delivery|Hospitality,117659357.0,NLD,2,3,821,15349,16170,0
Biotechnology|Health Care|Pharmaceuticals,22340000.0,GBR,2,6,546,12790,13336,0
Education|Local|Marketplaces|Music|Services|Software|Tutoring,19000000.0,USA,5,24,2824,13330,16154,0
Apps|Contact Management|Search|Software,25000.0,RUS,1,1,0,15765,15765,0
Analytics,4500000.0,ISR,2,1,734,15309,16043,0
Hospitality|Local Advertising|Mobile|Sales and Marketing|Search|Technology|Web Development,350000.0,USA,1,3,0,15309,15309,0
Hardware + Software,7790000.0,DNK,1,3,0,12899,12899,0
Email|Internet,273453.0,SWE,1,1,0,16252,16252,0
Hardware + Software,3569750.0,DEU,1,2,0,14628,14628,0
Health Care,14700000.0,USA,2,1,1407,15139,16546,0
Social Media,40000.0,CHL,1,1,0,15562,15562,0
Enterprise Software|Internet|Trusted Networks,45100000.0,USA,6,12,2156,13879,16035,0
Software,11500000.0,USA,1,2,0,12376,12376,0
Entertainment|Social Media|Social Network Media|Startups,73535.0,JOR,1,1,0,14512,14512,1
Education|Kids|Parenting,25000.0,ARG,1,1,0,15765,15765,1
mHealth|Software|Therapeutics,79857.0,CAN,1,1,0,15553,15553,0
Big Data|Development Platforms|Industrial Automation,12000000.0,USA,1,3,0,16658,16658,0
Big Data|Cloud Computing|Data Integration|Enterprise Software|Software,101580000.0,USA,6,16,2750,13300,16050,0
Recruiting|Software,1625065.0,ESP,1,6,0,16637,16637,0
Internet,2200000.0,FRA,1,7,0,16623,16623,0
Curated Web|Recruiting,3200000.0,USA,2,11,0,15902,15902,1
Employment,25488.0,GBR,1,1,0,16240,16240,0
Employment|Human Resources|Recruiting|Social Media,30000.0,THA,1,1,0,15979,15979,0
Advertising|Art|Artists Globally|Collaboration|Creative|Curated Web|Design|Fashion|Film|Music|Peer-to-Peer|Photography|Sales and Marketing|Social Media,29100000.0,USA,3,8,1953,14245,16198,0
Analytics|Databases|Data Integration|Data Mining,575000.0,USA,4,2,171,16598,16769,0
Career Management|Recruiting|Teachers,40000.0,CHL,1,1,0,16029,16029,0
Career Management|Cloud Computing|Human Resources|Machine Learning|Predictive Analytics|Psychology|Recruiting|SaaS,1450000.0,USA,2,2,395,15949,16344,0
B2B|Marketplaces|Recruiting,1700000.0,CHE,1,3,0,16030,16030,0
Social Media,169843.0,ITA,2,1,425,15250,15675,0
Software,52787935.3138524,FRA,4,7,1747,14988,16735,0
Curated Web|Human Resources|Recruiting|SaaS|Semantic Search|Staffing Firms,2700000.0,USA,1,2,0,14531,14531,1
EdTech|Education,4000000.0,IND,1,1,0,15455,15455,0
Curated Web,50000.0,SGP,1,1,0,13514,13514,0
Education,3150000.0,USA,3,5,373,16146,16519,0
Biotechnology|Health and Wellness|Pharmaceuticals,78750000.0,USA,3,6,1848,12996,14844,1
Biotechnology,21000000.0,USA,2,5,788,12874,13662,0
Software,12070000.0,USA,2,2,574,12242,12816,1
Media|Mobile,15000.0,USA,1,1,0,15492,15492,0
Messaging,2000000.0,RUS,1,1,0,15630,15630,0
Customer Service|Customer Support Tools|SaaS|Sales and Marketing,24450000.0,USA,4,9,1442,15273,16715,0
Telecommunications,8997.0,MEX,2,2,212,16314,16526,0
Analytics|Big Data|Big Data Analytics|Mobile,10000000.0,CHN,3,3,482,15857,16339,0
Social Media,2106651.0,JPN,3,1,1300,14700,16000,0
Messaging,5500000.0,USA,1,1,0,13422,13422,0
Information Services,321250.0,HKG,3,4,426,16252,16678,0
Digital Media|Messaging,1130000.0,USA,1,5,0,14056,14056,0
Consumer Internet,13000000.0,USA,4,10,527,16040,16567,0
Messaging,3000000.0,USA,1,1,0,15441,15441,1
Communications Infrastructure|Internet|Software,10000000.0,USA,1,3,0,11338,11338,0
Analytics|Collaboration|Messaging|Social Media|Software|Text Analytics,2000000.0,USA,2,8,918,15258,16176,0
Clean Technology,100000000.0,USA,1,1,0,16112,16112,0
Automotive|E-Commerce,252308.0,ESP,2,2,982,15340,16322,0
Artists Globally|Career Management|Consumer Goods|Curated Web|Entertainment|Fashion|Music|Networking|Video,800000.0,USA,1,1,0,13946,13946,0
Health Care|Pharmaceuticals|Software,36000000.0,USA,3,3,2190,13462,15652,0
Clean Technology,11323389.0,GBR,1,1,0,15463,15463,0
Games|Mobile,900000.0,USA,6,15,758,15813,16571,0
Advertising|Analytics|B2B|Big Data|Location Based Services|Mobile|NFC,5000000.0,GBR,2,1,688,15615,16303,0
Data Integration|Enterprises|Optimization|Technology,41200000.0,USA,2,9,396,16209,16605,0
Health Care,152001200.0,USA,4,5,1527,14067,15594,1
Analytics|Medical|Service Providers,18800000.0,USA,1,1,0,12957,12957,0
Automotive|Finance|FinTech|Incubators|Technology,14738116.0,CAN,2,2,287,15925,16212,0
Clean Technology,6800000.0,USA,1,1,0,13985,13985,0
Health Care,26999992.0,USA,6,7,1230,14887,16117,0
Games,2100000.0,GBR,1,4,0,15789,15789,0
Android|iPhone|Messaging|Mobile,369247364.0,USA,5,10,1387,14761,16148,0
Retail,30000000.0,USA,1,1,0,16630,16630,0
Developer APIs|Enterprise Software|Incentives|Loyalty Programs,10253850.0,USA,4,14,1552,14610,16162,0
Curated Web|Health Care,10173807.0,USA,4,5,1545,14930,16475,0
Consulting,30000000.0,USA,1,1,0,16630,16630,0
Mobile,37479368.0,USA,4,5,1895,13552,15447,0
Software,25950000.0,USA,4,8,1255,12872,14127,1
Fitness|Health and Wellness|Health Diagnostics|Internet of Things|Mobile Devices|Mobile Health|Product Design|Sporting Goods|User Experience Design,3194000.0,USA,3,3,455,16071,16526,0
Enterprise Software|Security,302312497.0,USA,5,7,1972,14735,16707,0
Curated Web|Entertainment|Machine Learning|Personalization|Reviews and Recommendations|Television|Video on Demand,68234.0,GBR,2,2,334,15492,15826,0
Manufacturing,3600000.0,USA,2,6,976,14214,15190,0
Clean Technology|Smart Grid,21595000.0,USA,2,4,1504,13125,14629,0
Marketplaces|Mobile|Online Dating,5000000.0,JPN,1,1,0,16468,16468,0
Hardware,49700000.0,USA,1,5,0,12265,12265,1
Services,5000000.0,USA,1,3,0,16609,16609,0
Application Platforms|Consumer Electronics,7000000.0,GBR,1,1,0,12544,12544,0
E-Commerce,31000000.0,CHN,2,4,289,15949,16238,0
3D|Data Visualization|Presentations|Software,178834.0,FRA,1,11,0,15313,15313,0
Business Services|Games,8000000.0,CHN,4,4,1187,13939,15126,1
E-Commerce|Marketplaces|Shopping,32500000.0,CHN,2,3,400,16252,16652,0
Curated Web,10487092.0,CHN,3,5,1612,14245,15857,0
Hospitality|Mobile|SaaS,882495.0,USA,3,1,1322,15293,16615,0
Android|Digital Media|Mobile|Mobile Advertising,2100000.0,USA,3,2,1238,14649,15887,0
Apps|Innovation Management|Moneymaking,150000.0,ISR,1,1,0,15126,15126,0
Curated Web,40000.0,USA,1,1,0,15859,15859,0
Software,33800000.0,USA,4,39,1532,15036,16568,0
Content|Curated Web|Media,3400000.0,USA,3,8,439,15659,16098,0
Android|Apps|iPhone|Location Based Services|Mobile|Networking|Photography|Real Time|Social Search|Software|Video,675067.0,IRL,1,2,0,15972,15972,0
Mobile,5800000.0,USA,2,4,144,16093,16237,0
Mobile,2500000.0,USA,1,1,0,13573,13573,1
Mobile|Web Development,200000.0,USA,1,1,0,15329,15329,0
Mobile,11700000.0,USA,2,9,324,15706,16030,1
Advertising Platforms,1400000.0,GBR,1,1,0,16316,16316,0
Social Media,1000000.0,AUS,3,5,443,15657,16100,0
Curated Web,25000.0,USA,2,2,491,15348,15839,0
Software,100000.0,USA,1,1,0,16071,16071,0
Health and Wellness|Health Care|Healthcare Services,20000.0,USA,1,1,0,16471,16471,0
Cloud Computing|Home Automation|Mobile,256407.0,SVK,2,4,365,15584,15949,0
Biotechnology,2460000.0,USA,4,1,222,14558,14780,0
E-Commerce|Mobile|Mobile Commerce|Software,36000000.0,USA,3,8,989,15538,16527,0
Mobile,5000000.0,USA,2,2,206,13757,13963,0
Advertising|Mobile|Mobile Advertising|Mobile Analytics|NFC|Proximity Internet|Telecommunications|Wireless,2800000.0,AUS,2,6,476,15215,15691,0
Brand Marketing|Mobile|Mobile Advertising,550000.0,USA,2,2,456,14975,15431,1
Advertising|Android|Apps|Brand Marketing|Games|iOS|Mobile|Windows Phone 7,70600000.0,USA,4,13,1495,13665,15160,0
Apps|Mobile,1200000.0,USA,2,3,465,16075,16540,0
Analytics,2400000.0,USA,2,16,504,16071,16575,0
Apps|iPad|Mobile|Photography,15000.0,USA,1,1,0,14652,14652,0
Enterprise Software|Meeting Software|Photo Sharing,2293122.0,USA,2,1,559,14694,15253,1
Advertising|Apps|Mobile|Retail,77442.0,GBR,1,1,0,15341,15341,0
Services,2200000.0,USA,1,1,0,16618,16618,0
Mobile|Mobile Payments|Payments,2324761.0,AUS,3,1,484,15932,16416,0
User Experience Design|Wearables,100000.0,USA,1,1,0,16375,16375,0
Apps|Communities|Mobile|Mobile Advertising,345916.831256701,ESP,6,5,383,16022,16405,0
Lifestyle|Location Based Services|Mobile,200000.0,VNM,1,2,0,16310,16310,1
Education|Educational Games|Entertainment|Health and Wellness|Kids|Mobile Games|Sports|Video Games,10000.0,CAN,1,1,0,15639,15639,0
Mobile,13800000.0,USA,3,5,2123,12513,14636,0
Audio|Collaboration|Crowdsourcing|Email|Events|iPhone|Mobile|Mobile Emergency&Health|Security|SMS,750000.0,USA,1,3,0,16049,16049,0
App Marketing|Mobile|Software,679611.0,CAN,1,2,0,15981,15981,0
Enterprise Software,11700.0,SGP,1,1,0,15946,15946,0
Photography,5000000.0,USA,2,10,677,15910,16587,0
Advertising|Location Based Services|Mobile|Monetization,5254837.0,ESP,2,1,771,14685,15456,0
Enterprises|Enterprise Software|Events|Home & Garden|iOS|iPad|iPhone,4000000.0,USA,3,6,1073,15210,16283,0
Advertising|Data Integration|Machine Learning|Mobile Commerce,600000.0,USA,2,1,578,15340,15918,1
Advertising|Architecture|Boating Industry|Consumer Electronics|Digital Signage|Displays|Hardware|Home Decor|Hospitality|Internet of Things|Retail Technology,100000.0,USA,2,1,1,16750,16751,0
Enterprise Application|Enterprise Hardware|Event Management|Hardware + Software|NFC|RFID,19299.0,CAN,1,1,0,15992,15992,0
News,17991299.0,USA,3,2,994,14231,15225,1
Apps|Games|Mobile|Software,2800000.0,USA,4,9,342,13879,14221,1
Computers|Games|Toys,8000000.0,USA,1,1,0,16247,16247,1
Mobile,20000000.0,USA,1,6,0,12073,12073,0
Events,183747.0,ESP,1,1,0,16265,16265,0
Technology,25000000.0,USA,2,5,286,12227,12513,0
Dental|Healthcare Services|Medical,3000000.0,GBR,2,6,876,15789,16665,0
Semiconductors,29800000.0,USA,3,13,1157,12023,13180,1
Education|Marketplaces|Tutoring|Video,850000.0,USA,1,1,0,15653,15653,0
EdTech|Education,15000000.0,CHN,4,5,2437,11747,14184,1
Biotechnology|Health Care,124414483.0,USA,4,15,1591,11170,12761,1
Biotechnology,5100000.0,USA,1,2,0,14317,14317,0
Health Care,70000000.0,USA,1,4,0,13556,13556,1
Biotechnology,33728379.0,USA,2,5,2076,12432,14508,1
Analytics,7825000.0,USA,4,2,1660,15015,16675,0
Advertising,12800000.0,USA,2,3,760,13757,14517,1
Agriculture|Biotechnology|Energy,37300000.0,USA,3,9,2233,13290,15523,0
Software,1100000.0,USA,1,3,0,16328,16328,0
Advertising|Digital Media|Internet Radio Market|Music,20190000.0,USA,3,11,1352,13633,14985,0
Consumer Electronics,187500.0,USA,2,1,732,15826,16558,0
Biotechnology,3600000.0,NOR,1,3,0,15862,15862,0
Biotechnology,83800001.0,USA,5,14,2315,14420,16735,0
Messaging,30000000.0,USA,2,2,175,14404,14579,0
Hardware + Software,2560000.0,CAN,2,2,469,13103,13572,0
Biotechnology,121050000.0,USA,7,14,1755,14540,16295,0
Biometrics,18500000.0,USA,1,1,0,16695,16695,0
Advertising|Automotive|Classifieds|Marketplaces|Online Rental,200000.0,TUR,3,1,1558,14458,16016,0
Crowdsourcing|Real Time|Technology,1400000.0,ARE,3,2,574,16136,16710,0
Finance|Productivity Software|Project Management|Software,237280.0,POL,1,1,0,14365,14365,0
Local Based Services|Service Providers,1200000.0,IND,1,2,0,16540,16540,0
Home & Garden|Software,9621250.0,USA,3,6,686,15680,16366,0
Email|Messaging|Productivity Software,50000.0,USA,3,2,566,14409,14975,0
E-Commerce Platforms,263688.0,GBR,3,3,132,15584,15716,0
Curated Web,18316.0,GBR,1,1,0,14914,14914,0
Data Integration|SaaS,120000.0,GBR,2,2,365,16040,16405,0
Curated Web|E-Commerce|E-Commerce Platforms|Online Rental|Peer-to-Peer,37675000.0,USA,6,28,1152,14392,15544,0
Collaboration|Enterprise Software|Productivity Software|Software|Task Management|Tracking,11000000.0,CAN,1,2,0,16245,16245,0
Business Productivity|Enterprise Software,15000000.0,USA,1,1,0,16594,16594,0
Application Platforms|Development Platforms|Shared Services,250000.0,USA,1,1,0,14975,14975,0
Big Data Analytics|Data Visualization|Machine Learning|SaaS|Text Analytics,1150000.0,USA,1,4,0,16495,16495,0
Mobile|Reviews and Recommendations|Search,250308.0,CAN,1,1,0,15470,15470,0
E-Commerce|Mobile|Mobile Commerce|Shopping,1750000.0,USA,2,12,530,15400,15930,1
Music|Online Dating,600000.0,GBR,1,1,0,15813,15813,0
Apps|Health and Wellness,9000000.0,USA,1,2,0,16350,16350,0
Communities|Consumer Goods|Social Commerce,40300000.0,USA,3,10,479,15768,16247,0
Curated Web|Design,3220985.0,USA,3,9,380,15614,15994,0
E-Commerce|Mobile,500000.0,USA,1,1,0,15513,15513,0
Content Discovery|Games|Mobile|Music,3050000.0,USA,2,9,393,15378,15771,1
Manufacturing,5847043.0,USA,1,1,0,14956,14956,1
Curated Web,3000000.0,USA,1,5,0,14937,14937,1
E-Commerce|Internet,5000000.0,IND,1,1,0,15869,15869,1
Services|Telecommunications|Wireless,212000000.0,IND,1,1,0,13213,13213,0
App Marketing|Messaging|Mobile|SMS,600000.0,USA,2,1,2058,13848,15906,0
Mobile,42000000.0,USA,6,10,2654,12128,14782,1
E-Commerce,11000000.0,USA,1,2,0,16321,16321,0
Tourism,555555.0,TUR,1,1,0,15767,15767,0
Artists Globally|Curated Web|Design,45180.0,CAN,1,1,0,16161,16161,0
Blogging Platforms|Crowdsourcing|Design|Digital Entertainment|E-Commerce|Guides|Lifestyle|Social Media,2550000.0,DNK,3,3,932,15725,16657,0
Enterprise Software|Hardware + Software|SaaS,90700000.0,USA,7,22,1507,14949,16456,0
Games,40000.0,CHL,1,1,0,15539,15539,0
Biotechnology|Health Diagnostics,177000000.0,SGP,3,1,1052,15664,16716,0
Restaurants,4500000.0,USA,1,4,0,16604,16604,0
Crowdsourcing|Mobile|Software|Wireless,3000000.0,ISR,4,5,1108,15209,16317,0
Automotive|Mobile,607934.0,POL,1,1,0,15543,15543,0
Android|Apps|Automotive|iOS|Mobile,6700000.0,GRC,3,1,224,15835,16059,0
Automotive|Transportation,44000000.0,IND,4,11,817,15485,16302,1
Software,415515.0,BGR,4,3,409,15966,16375,0
E-Commerce,600000.0,USA,1,3,0,16141,16141,0
Broadcasting,161000.0,IND,1,1,0,16491,16491,0
Energy IT,17000.0,USA,1,1,0,15584,15584,0
Advertising,32000000.0,USA,5,15,2029,14426,16455,0
Software,6000000.0,USA,1,5,0,12874,12874,0
Biotechnology|Health Diagnostics,1500000.0,USA,1,3,0,15904,15904,0
Software,671226.0,GBR,1,1,0,13854,13854,0
Agriculture|Analytics|Service Providers,1503657.0,BRA,1,1,0,16437,16437,0
Finance,795854.0,SWE,1,1,0,13879,13879,0
Security,472300.0,GBR,1,1,0,13424,13424,0
Finance,12250000.0,USA,2,3,864,12566,13430,0
Consulting|Information Technology|Internet|Services|Software,836290.0,GBR,1,2,0,16028,16028,0
Biotechnology|Investment Management|Medical|Pharmaceuticals,8940000.0,ESP,1,3,0,14685,14685,0
Biotechnology,11795700.0,FRA,1,4,0,13866,13866,0
E-Commerce|Specialty Foods,7000000.0,IND,3,5,980,15538,16518,0
EdTech|Education,10600000.0,USA,2,4,169,10833,11002,1
Education|Media|Social Network Media|Startups,158567.0,GBR,1,2,0,13939,13939,0
Education|Internet|SaaS,288000.0,RUS,2,2,0,15615,15615,0
All Students|Education|Teachers,1500000.0,USA,2,4,900,15346,16246,0
EdTech|Education|K-12 Education|Video|Video on Demand,250000.0,USA,1,1,0,16268,16268,0
Software,18250000.0,USA,1,1,0,14481,14481,0
All Students|Charter Schools|Education|Teachers,3450000.0,USA,3,19,877,13514,14391,1
Advertising|Internet|Mobile Video|Online Video Advertising|Video,80932177.0,USA,8,25,3117,13514,16631,0
Marketing Automation|Mobile Games,145000.0,USA,2,1,163,15826,15989,0
Internet|Software|Technology|Usability,20000000.0,USA,2,8,615,11948,12563,1
E-Commerce|Parenting|Subscription Businesses|Tea|Video,310000.0,USA,3,4,559,15552,16111,0
Enterprise Software,77900000.0,USA,5,13,1134,15349,16483,0
Curated Web|Forums|Freelancers|Moneymaking,100000.0,USA,1,1,0,15065,15065,0
Education,28437.0,GBR,1,1,0,16130,16130,0
Cloud Computing|Service Providers,4899039.0,JPN,3,4,1292,15278,16570,0
Cyber Security,18000000.0,ISR,1,5,0,16476,16476,0
E-Commerce,100000.0,USA,1,1,0,16100,16100,0
Internet Marketing|Marketplaces|Online Auctions|Sponsorship,508475.0,DNK,2,2,172,16395,16567,0
Apps,17000000.0,CHN,3,7,935,15765,16700,0
E-Commerce,5000000.0,CAN,1,1,0,15945,15945,0
Communities|Messaging|Social Media|Sports,682850.0,GBR,1,1,0,14679,14679,0
Sports,40000.0,NZL,1,1,0,15939,15939,0
CRM|Project Management|Web Tools,4212583.0,BEL,2,2,362,16212,16574,0
Consulting,22500000.0,IND,1,2,0,15069,15069,0
B2B|Career Management|Collaboration|Enterprises|Enterprise Software|Human Resources|Project Management|SaaS|Task Management,250000.0,USA,2,2,363,15379,15742,0
Curated Web,2300000.0,RUS,2,5,245,15400,15645,0
Music,984913.0,GBR,1,1,0,15970,15970,0
Mobile Health|Software,63000.0,CHL,2,2,602,16044,16646,0
Mobile,22577276.0,USA,6,15,1925,14769,16694,0
Mobile,73667711.0,CHN,1,3,0,15218,15218,0
Hardware + Software|Health and Wellness,54597734.0,USA,6,1,2234,14497,16731,1
Health Care|Medical Devices,114500000.0,USA,2,7,1027,14735,15762,0
Pharmaceuticals,3390000.0,USA,2,4,495,16253,16748,0
Content|Journalism|Media|News|Parenting|Social Media|Systems,24000.0,ARE,1,1,0,15563,15563,0
Angels|Business Services|Employment|Entrepreneur|Events|Finance|FinTech|Local|Media|Networking|News|Social Media|Startups|Technology|Venture Capital,2500000.0,USA,1,1,0,15840,15840,0
Blogging Platforms|Digital Media|Media|News|Publishing|Startups|Technology,407097.46006470604,GBR,2,15,0,16183,16183,0
Media|News|Publishing,4390000.0,SGP,4,15,1573,15034,16607,0
Entrepreneur|Media|News|Public Relations|Startups|Technology,105000.0,USA,3,3,972,15454,16426,0
Software,60000.0,USA,2,1,798,15231,16029,0
Software,3000000.0,USA,1,1,0,16696,16696,1
Business Services|Hardware|Hardware + Software|Mobile,38139999.0,CHN,3,7,1874,12509,14383,1
Hardware + Software,7760000.0,USA,5,7,1383,13629,15012,1
Internet|Services|Technology,1360000.0,ITA,1,2,0,13634,13634,0
Information Technology|Recruiting|Services,22000000.0,USA,1,4,0,10988,10988,0
Domains|Web Design|Web Development,5000.0,IND,1,1,0,16079,16079,0
Advertising|Digital Media|Media|Publishing,175500000.0,USA,4,8,2527,14061,16588,0
E-Commerce,25500000.0,USA,1,3,0,13467,13467,0
Developer Tools|Hardware + Software|Internet of Things,1044000.0,USA,1,5,0,16036,16036,0
Education,6000000.0,ISR,1,1,0,16142,16142,0
Health and Wellness,13300000.0,USA,3,1,1995,12852,14847,0
Software,14000000.0,USA,2,7,2477,13883,16360,0
Hardware + Software,42352200.0,USA,1,2,0,14855,14855,0
Biotechnology,10000000.0,CAN,1,3,0,13186,13186,0
Advertising|Technology,32100000.0,USA,7,14,2599,11931,14530,0
B2B|Cloud Computing|Financial Services|FinTech|Mobile|SaaS|Software|Transportation,846748.0,USA,6,5,470,15721,16191,0
Clean Technology,8000000.0,USA,1,1,0,13996,13996,0
Apps,41250.0,HKG,1,1,0,16252,16252,0
Recruiting,100000.0,USA,1,1,0,16375,16375,0
Biotechnology,20480000.0,CHN,1,1,0,14400,14400,0
Data Security|Insurance|Payments|Real Time,6000000.0,IND,1,1,0,14975,14975,0
Finance|Startups|Venture Capital,34000000.0,USA,3,8,223,15015,15238,0
Business Services|Enterprise Software,85000000.0,USA,2,4,197,12576,12773,1
Semiconductors,15000000.0,ISR,2,3,348,13350,13698,0
Consulting|Services|Technology,3733502.58545054,GBR,1,1,0,12618,12618,1
Security,50000000.0,USA,1,1,0,13366,13366,0
Security|Technology|Video Processing,20000000.0,USA,1,1,0,12335,12335,1
Consumers|CRM|Enterprise Software|Mobile|SaaS,800000.0,USA,1,6,0,16611,16611,0
Design|Manufacturing|Textiles,3425774.0,BRA,1,1,0,15553,15553,0
Clean Technology,18100000.0,USA,4,1,1483,15169,16652,1
Games,1000000.0,GBR,1,1,0,16469,16469,0
Internet,3000000.0,USA,2,3,105,16584,16689,0
Software,10000000.0,USA,1,2,0,12929,12929,0
Health and Wellness,807910.618845723,CHE,1,4,0,16405,16405,0
Hardware + Software|Health and Wellness|Kinect|Medical,630355.0,ESP,2,3,476,15320,15796,0
Hardware + Software|Health Care|Mobile|Parenting,400000.0,GBR,2,1,492,15954,16446,0
Social Media,4800000.0,USA,1,2,0,13726,13726,0
Media|Photography|Service Providers,1655405.0,GBR,1,1,0,13831,13831,0
E-Commerce|Mass Customization,56875000.0,USA,4,7,1021,15371,16392,0
Consumer Electronics|Digital Entertainment|Digital Media|Software,1750000.0,IND,1,2,0,16520,16520,0
Advertising|App Marketing|Mobile|QR Codes,28176.0,GBR,1,1,0,15141,15141,0
Internet of Things|Tea,5100000.0,USA,1,4,0,16773,16773,0
Data Center Infrastructure|Enterprise Hardware|Flash Storage|Virtualization,117523823.0,USA,4,12,1791,14791,16582,0
Artificial Intelligence|Computers|New Technologies,850000.0,RUS,1,1,0,15518,15518,0
Semiconductors,4200000.0,ISR,2,3,977,12940,13917,0
Software,446000.0,ESP,1,2,0,13695,13695,0
Electrical Distribution|Industrial|Innovation Engineering,9078877.0,BRA,2,2,2734,10592,13326,0
Software,14500000.0,USA,2,9,1564,11715,13279,0
Web Hosting,59000000.0,IND,3,8,1015,12789,13804,0
E-Commerce|Shoes,65000000.0,ZAF,1,1,0,16380,16380,0
Semiconductors,8640000.0,DNK,2,2,738,13659,14397,0
Chat|Messaging|Unifed Communications|VoIP,1000000.0,RUS,1,2,0,15034,15034,0
Public Relations,129586.579542599,NOR,1,1,0,16742,16742,0
Semiconductors,62600000.0,USA,5,28,2876,11688,14564,1
Apps|Mobile|SaaS|Web Tools,882121.0,FRA,1,1,0,15160,15160,0
Mobile,600000.0,USA,2,10,153,14761,14914,0
Electronics,510000.0,USA,1,1,0,16393,16393,0
Semiconductors,10250000.0,USA,2,3,787,14228,15015,0
Health and Wellness,74250103.0,USA,5,18,2297,14034,16331,1
Software,29500000.0,USA,3,7,1799,12899,14698,0
Public Relations,73500000.0,USA,3,13,1435,12328,13763,0
Mobile,63460000.0,USA,4,6,1621,14743,16364,0
Semiconductors,10000000.0,USA,1,1,0,13149,13149,1
Mobile|Telecommunications|Wireless,50979197.0,USA,4,1,1158,14008,15166,0
Mobile,150450000.0,USA,11,9,2999,12717,15716,1
Analytics|Artificial Intelligence|Big Data|Business Development|Enterprise Software|Machine Learning|Market Research|Professional Networking|Semantic Search,2319019.82761953,GBR,1,1,0,16730,16730,0
Internet|Service Providers|Telecommunications,19000000.0,NLD,1,2,0,12864,12864,1
Mobile,10490000.0,IND,1,1,0,14189,14189,0
Market Research|Robotics|Technology,200000.0,USA,1,1,0,16344,16344,0
Messaging|SMS,4900000.0,USA,2,2,518,13361,13879,0
Semiconductors,35000000.0,USA,2,6,690,13057,13747,1
Customer Service|Services|Software,35000000.0,USA,2,9,690,11253,11943,1
Software,279000.0,FRA,1,1,0,14235,14235,0
Business Services|Gps|Information Technology,409299.0,IND,1,1,0,15918,15918,0
Bridging Online and Offline|Doctors|Telecommunications,132222.0,GBR,2,2,100,16183,16283,0
Health Care Information Technology|Health Diagnostics|Hospitals,9711297.0130825,ESP,2,2,804,12965,13769,1
Enterprise Software,7000000.0,GBR,1,1,0,13658,13658,0
Software,757625.0,GBR,1,2,0,15989,15989,0
Hardware + Software,5000000.0,USA,1,1,0,15951,15951,0
Health Care|Software|Telecommunications,2500000.0,USA,2,3,10,16290,16300,0
Distribution|Manufacturing|Mobile Devices|Telecommunications|Wireless,38000000.0,USA,1,6,0,11631,11631,1
Enterprise Software|Health Diagnostics,23990000.0,SWE,3,5,1435,13412,14847,0
Location Based Services|Search,2500000.0,USA,1,9,0,16321,16321,0
Health Care|Medical|Medical Devices,300000.0,USA,1,1,0,13724,13724,0
Android|Mobile|SMS|Telecommunications,1000000.0,USA,1,1,0,15694,15694,0
Fraud Detection|Identity|Information Security|Information Technology|Messaging|Mobile|Online Identity|Security,78000000.0,USA,3,5,783,15471,16254,0
Analytics|Biotechnology,86758.5613348325,SRB,1,2,0,16330,16330,0
Data Mining|Document Management|Medical|Video,1000000.0,ISR,2,2,454,15819,16273,0
Messaging|VoIP|Wireless,48260819.0,USA,5,7,1138,13756,14894,1
Software|Telecommunications|Wireless,27628852.0,USA,3,4,3698,11275,14973,1
Bio-Pharm|Biotechnology|Therapeutics,28600000.0,CAN,1,3,0,16667,16667,0
Advertising|Enterprises|Logistics|Mobile|Mobile Software Tools|Services|Software|Wireless,2250000.0,IND,3,6,2099,13149,15248,0
Web Hosting,21720000.0,GBR,1,1,0,14033,14033,1
Enterprise Software,51000000.0,USA,2,4,734,13550,14284,0
Software,5260000.0,FRA,2,9,498,13164,13662,1
Communications Infrastructure|Wireless,25500000.0,ITA,2,3,1200,15019,16219,1
Clean Technology,5765000.0,USA,4,1,1778,14579,16357,0
Startups,25000.0,USA,1,1,0,15400,15400,0
Building Products,1500000.0,USA,1,1,0,16742,16742,0
Analytics|Predictive Analytics|Social Media|Social Media Marketing|Twitter Applications,25000.0,USA,4,5,921,15491,16412,0
Internet Marketing|Software,35950000.0,USA,7,26,1714,14335,16049,0
Analytics|Big Data,17750000.0,USA,3,10,696,14442,15138,1
Internet Marketing,100672.0,DEU,1,1,0,15765,15765,0
Blogging Platforms|Collaboration|Forums|Networking|Photography|SEO|Software|Web Development,36275000.0,USA,5,1,1766,14145,15911,1
Apps|Content Discovery|Mobile|Social Media,250000.0,USA,1,1,0,16040,16040,0
Mobile,6000000.0,USA,1,3,0,10743,10743,1
Biotechnology|Genetic Testing,270862.0,ESP,1,1,0,16233,16233,0
Messaging,40000.0,URY,1,1,0,15915,15915,0
Curated Web,4700000.0,USA,3,15,577,14821,15398,1
Games|Video Games,54400000.0,USA,4,7,3283,13207,16490,0
Enterprise Software,3000000.0,USA,1,2,0,15883,15883,0
Curated Web|Finance|Television,2189405.95710131,FIN,5,1,1308,15279,16587,0
Broadcasting|Publishing|Social Media|Social Television|Television|Video|Video Streaming,257320.0,FIN,1,1,0,16163,16163,0
Messaging|Telecommunications|VoIP,250000.0,USA,1,1,0,15857,15857,0
Ediscovery|Messaging|Search|Social Network Media,35000000.0,GBR,1,3,0,14083,14083,0
Developer APIs|Software|Telecommunications|Unifed Communications,1000000.0,USA,1,6,0,16325,16325,0
Enterprises|Enterprise Software|Fleet Management|Gps|Navigation|SaaS|Software|Transportation,120000000.0,USA,5,4,2236,14337,16573,0
Optical Communications,15200000.0,USA,1,5,0,11479,11479,0
Biotechnology,16225456.0,CHE,2,4,643,15398,16041,0
Biotechnology,14000000.0,USA,1,1,0,15454,15454,0
Curated Web,95000000.0,USA,3,11,564,13131,13695,0
Web Hosting,43500000.0,USA,1,2,0,14398,14398,1
Games,28000000.0,USA,2,4,34,15601,15635,0
Information Technology,56000000.0,AUS,3,2,1558,14975,16533,0
Education|Games|Mobile,40000.0,USA,1,1,0,15949,15949,0
Security,17000000.0,USA,2,2,120,16377,16497,0
Brand Marketing|Cloud Computing|Enterprise Software|SaaS,4153539.40108803,DNK,2,6,493,16248,16741,0
Curated Web|Finance|Recruiting,18000.0,USA,1,1,0,14498,14498,0
Analytics|Databases|Finance|FinTech|Services,4068000.0,USA,3,13,647,15340,15987,0
Apps|Artificial Intelligence|Machine Learning|Mobile,12500000.0,USA,2,23,567,15309,15876,1
Search Marketing|SEO|Social Media Marketing|Web Design|Web Development,700000.0,USA,2,1,2626,11753,14379,0
Software,19800000.0,USA,4,12,1427,13039,14466,0
Clean Technology,10000000.0,CAN,2,3,733,15023,15756,0
Hardware + Software,3400000.0,USA,2,1,54,14615,14669,0
Apps|Hospitality|Mobile|Technology,40000.0,IRL,1,1,0,16051,16051,0
Mobile Security|Security,309838430.0,USA,3,4,1161,15588,16749,0
Real Estate,500000.0,USA,1,5,0,16644,16644,0
Energy,550000000.0,USA,1,1,0,12159,12159,0
Health Care,28277366.0,USA,8,1,2366,13739,16105,1
Curated Web|Entertainment|Internet|Internet Marketing|Media|Mobile,220000.0,CHN,2,3,395,11048,11443,1
Enterprise Software,14650000.0,CHN,1,1,0,14537,14537,0
Curated Web,1300000.0,USA,1,7,0,15658,15658,0
Software,131190000.0,USA,8,16,3635,12784,16419,0
Biotechnology,37476197.0,USA,3,1,324,15845,16169,1
Software,3030000.0,USA,1,1,0,13241,13241,0
Business Services|Internet|Investment Management,16300000.0,USA,2,1,162,16435,16597,0
Enterprises|Messaging,92500000.0,USA,5,14,1978,12600,14578,0
Mobile,2200000.0,CHN,1,1,0,14914,14914,0
Biotechnology,297263531.0,USA,8,28,2926,12998,15924,1
Mobile,120000.0,USA,1,3,0,16222,16222,0
Manufacturing,36040675.0,USA,7,4,1428,14669,16097,0
Education,4820000.0,USA,4,2,932,14301,15233,1
Sports,330000.0,USA,1,1,0,15765,15765,0
Software,3900000.0,USA,1,1,0,13088,13088,1
Advertising|Internet Marketing|SEO,50809.0,CAN,1,1,0,15461,15461,0
Biotechnology,15000000.0,USA,1,1,0,15229,15229,0
Software,10451998.0,USA,1,1,0,14854,14854,1
Web Hosting,7000000.0,USA,1,3,0,12934,12934,0
Gamification|Software,4700000.0,USA,2,5,362,15218,15580,1
Software,60000000.0,USA,1,1,0,14523,14523,0
Health Care,29942849.0,USA,4,4,1745,13670,15415,0
Real Estate,10000000.0,USA,1,1,0,13545,13545,0
Web Hosting,32400000.0,USA,1,5,0,11410,11410,0
Advertising,5800000.0,USA,2,2,807,13514,14321,1
Web Hosting,40530000.0,ZAF,2,2,2024,14438,16462,1
Enterprise Software|Hardware + Software|Pervasive Computing|Technology,82821087.0,CAN,6,16,2487,12772,15259,0
Manufacturing,13200000.0,USA,2,3,87,15209,15296,0
Biotechnology,40000.0,USA,1,1,0,15777,15777,0
Manufacturing,60000000.0,GBR,1,1,0,11695,11695,0
B2B|Information Technology|Internet of Things,18192.0,DEU,1,1,0,16436,16436,0
Semiconductors,63047100.0,USA,4,18,1283,13473,14756,1
Software,10400000.0,USA,2,4,1481,13038,14519,0
Analytics|Big Data Analytics|E-Commerce|Real Time|SaaS,4922427.0,CAN,2,1,978,13986,14964,0
Biotechnology,6700000.0,USA,2,2,530,14048,14578,0
Software,23416000.0,USA,16,6,2876,13573,16449,0
Design|Distribution|Manufacturing,23500000.0,USA,3,6,833,12467,13300,0
Manufacturing,15500000.0,GBR,2,6,1364,15365,16729,0
Biotechnology,148500000.0,USA,4,8,1927,11773,13700,1
Internet,20000000.0,USA,2,5,578,16130,16708,0
Services|Telecommunications|Wireless,10800000.0,USA,1,4,0,11936,11936,0
Curated Web,140000.0,IND,1,1,0,16595,16595,0
Business Analytics|Education|Social Media Monitoring|Software|Web CMS,3365635.0,IRL,2,5,1918,14616,16534,0
Advertising|Advertising Platforms|B2B,1800000.0,USA,1,6,0,16727,16727,0
Real Estate,635000.0,USA,2,1,324,16223,16547,0
Enterprise Software,2873000.0,USA,2,2,302,15259,15561,1
Digital Media|Internet Marketing|Social Media Marketing|Video,395000.0,USA,1,2,0,16583,16583,0
Security,8000000.0,USA,1,7,0,12887,12887,0
Automotive|Electric Vehicles|Environmental Innovation,10000000.0,JPN,1,5,0,16205,16205,0
Software,28999999.0,USA,4,10,1846,12575,14421,1
Collaboration|Software,24843426.0,USA,7,10,2344,13649,15993,0
Hardware + Software,11500000.0,USA,1,4,0,16013,16013,0
Manufacturing,44938335.0,USA,7,7,1808,14690,16498,0
Mobile,16050000.0,USA,2,1,769,15679,16448,0
Clean Technology|Consulting|Renewable Energies,5800000.0,USA,1,2,0,13677,13677,0
Games,6994007.0,SWE,2,5,1092,12156,13248,1
Software,6000000.0,USA,1,1,0,14671,14671,0
Messaging,38000000.0,USA,2,3,610,13892,14502,0
College Recruiting|Networking|Recruiting|SaaS|Social Recruiting,6000.0,CHL,1,1,0,15796,15796,0
Energy,2000000.0,USA,2,2,217,16455,16672,0
Biotechnology|Health Care,252000000.0,USA,3,6,1013,14757,15770,1
Enterprises|Industrial|Internet of Things|Mobile Security,372455.0,GBR,1,3,0,16666,16666,0
Automotive|Clean Technology,823000000.0,USA,11,35,3114,12509,15623,1
Technology,16390.0,FIN,1,1,0,16529,16529,0
Consulting,27941779.0,GBR,1,1,0,15544,15544,1
Food Processing,5000000.0,USA,1,1,0,16702,16702,0
Semiconductors,5180000.0,USA,1,5,0,11109,11109,1
Games|Video Games,38484.0,MKD,1,1,0,15798,15798,0
Reviews and Recommendations|Shopping|Television,20000.0,RUS,1,1,0,15796,15796,0
Enterprise Software,2701860.0,DEU,1,1,0,16149,16149,0
EdTech|Education|K-12 Education,200000.0,IND,1,2,0,16372,16372,0
Crowdsourcing|Enterprise Software|SaaS|Testing,5000000.0,USA,2,2,1344,15413,16757,0
E-Commerce,5800000.0,SWE,2,2,458,13634,14092,0
All Students|Education|Enterprise Software|Open Source|Recruiting|SaaS|Skill Assessment|Testing,64874.0,ESP,2,2,0,15645,15645,0
Apps|Development Platforms|Mobile Games|Software|Testing,65900000.0,HKG,4,6,1355,15279,16634,0
Market Research|Usability|User Experience Design|User Testing,872242.0,CHE,1,1,0,16666,16666,0
Colleges|EdTech|Education|Finance|FinTech|Skill Assessment|Testing,3158270.0,USA,4,13,1276,15363,16639,0
Developer Tools|Mobile|SaaS|Software|Testing,1213000.0,USA,2,15,602,15922,16524,0
Mobile,1400000.0,DEU,1,2,0,15726,15726,0
Software,2564000.0,GBR,2,2,123,14130,14253,0
Software,7500000.0,USA,1,3,0,13088,13088,1
Enterprise Software,9000000.0,FRA,3,10,998,12853,13851,0
Biotechnology,30400000.0,USA,3,9,1470,13087,14557,0
Biotechnology,2945000.0,USA,4,8,784,15897,16681,0
Biotechnology|Health Care,73000000.0,USA,6,11,995,14692,15687,1
Biotechnology|Health Care,80040000.0,USA,4,16,1282,13479,14761,1
Software,2350000.0,USA,1,2,0,16435,16435,0
Clean Technology,9168528.0,USA,2,3,683,14213,14896,1
Semiconductors,2750000.0,ISR,1,7,0,13707,13707,0
Mobile,23195725.0,USA,3,1,804,15343,16147,0
Semiconductors,25500000.0,USA,3,2,1452,12996,14448,1
Medical|Publishing|Technology,1435149.0,GBR,1,1,0,15518,15518,0
Enterprise Software,3000000.0,USA,1,1,0,14173,14173,0
Universities,415000.0,CAN,1,1,0,15912,15912,0
E-Commerce,40000.0,BRA,1,1,0,15566,15566,0
Search,5800000.0,USA,2,4,734,13544,14278,0
Collaboration|Document Management|Enterprise Software,1500000.0,SWE,2,1,676,14245,14921,0
Messaging,650000.0,USA,1,3,0,14822,14822,0
Software,1500000.0,USA,1,4,0,16468,16468,0
Mobile,450000.0,USA,2,2,576,15936,16512,0
Content|Curated Web|Digital Media|Translation,8361887.0,BEL,3,11,948,15663,16611,0
Android|Communities|iPad|iPhone|Messaging|Mobile,53229009.0,USA,5,13,2671,13848,16519,0
Mobile,525000.0,USA,1,1,0,15995,15995,0
Hardware + Software,5000000.0,USA,1,3,0,12949,12949,0
Analytics,250000.0,IND,1,1,0,14048,14048,0
Ad Targeting|Advertising|Apps|Consumer Goods|Facebook Applications|Mobile|Networking|Sales and Marketing|SMS|Social Media|Web CMS,650000.0,USA,1,6,0,14972,14972,0
Big Data|Cloud Computing|Collaborative Consumption|Logistics|Public Transportation|Transportation,285837.0,GBR,1,23,0,13461,13461,0
Financial Services,1800000.0,USA,1,1,0,16233,16233,0
Infrastructure|Services|Technology,3000000.0,USA,1,2,0,12698,12698,0
Biotechnology,2240000.0,AUS,1,1,0,12990,12990,0
Fitness|Healthcare Services|Intellectual Asset Management|Medical Devices|Tracking,1500000.0,USA,1,1,0,13056,13056,0
Algorithms|Information Technology,650000.0,USA,1,3,0,16246,16246,0
Banking|Manufacturing|Retail,4848804.0,GBR,1,1,0,16062,16062,0
Android|Incentives|iPhone|Loyalty Programs|Mobile,6000000.0,USA,2,8,872,15506,16378,0
Biotechnology,9608656.0,USA,5,2,1716,14599,16315,0
Games,12500000.0,USA,2,4,712,15505,16217,0
FinTech|Legal|Marketplaces,5250000.0,USA,2,10,496,16198,16694,0
Social Media,12989120.0,CHN,2,2,1703,14123,15826,0
3D|B2B|Retail|Shopping,28753.0,NOR,1,2,0,15870,15870,0
Education,750000.0,KEN,1,2,0,16253,16253,0
E-Commerce,25000.0,USA,1,1,0,12935,12935,0
Education|High Schools,11900000.0,USA,2,3,953,14593,15546,0
Analytics|Big Data|Business Intelligence|Cloud Data Services,100000.0,NLD,1,3,0,16157,16157,0
Software,46007.0,JPN,1,1,0,15769,15769,0
Apps|Electronic Health Records|Health Care|Mobile|Open Source,90000.0,PRT,1,1,0,15918,15918,0
Babies|Hardware|Health and Wellness|Parenting|Wearables,1900000.0,USA,2,3,2192,13514,15706,0
Creative|Curated Web|Design|Marketplaces|Reputation,23911.0,GBR,1,1,0,15445,15445,0
Software,1300000.0,FRA,1,2,0,14862,14862,0
E-Commerce,5000000.0,JPN,2,2,203,16001,16204,0
Indians|News|Video,159000.0,IND,1,1,0,16510,16510,0
Software,2100000.0,USA,2,3,57,16692,16749,0
Fashion,40000000.0,USA,4,15,1347,15340,16687,0
E-Commerce,7100000.0,USA,3,19,366,15881,16247,0
Hardware + Software,2980000.0,GBR,1,1,0,13742,13742,0
Data Centers|Security|Services|Web Hosting,1870000.0,GBR,1,1,0,13292,13292,0
Fashion,2100000.0,GBR,2,6,802,15754,16556,0
Moneymaking|Music|Social Network Media,33840.0,GBR,1,1,0,16202,16202,0
Hardware + Software,4000000.0,FIN,2,4,457,16130,16587,0
E-Commerce|Fashion,21000000.0,GBR,1,1,0,16093,16093,0
E-Commerce|Group Buying|Online Shopping,80000000.0,AUS,1,4,0,15117,15117,0
Curated Web|Retail,500000.0,GBR,1,1,0,16245,16245,0
Lifestyle|Nightclubs|Restaurants,156508.0,GBR,1,1,0,16409,16409,0
Nonprofits,18000000.0,USA,2,1,54,16058,16112,0
Agriculture|Finance|FinTech|News|Risk Management,108800000.0,USA,4,30,1991,13514,15505,1
E-Commerce|Outdoors|Privacy|Sales and Marketing,9000000.0,USA,2,5,246,15154,15400,0
Education|Knowledge Management|Project Management,54000000.0,USA,1,3,0,12577,12577,0
Games,98470000.0,GBR,1,1,0,13678,13678,0
Clean Technology,15152514.0,GBR,1,1,0,16154,16154,0
Advertising,902612.0,USA,2,2,302,15949,16251,0
Financial Services|FinTech|Marketplaces,2000000.0,USA,1,1,0,16339,16339,0
Media|Technology,3000000.0,GBR,5,23,1589,15027,16616,0
Developer APIs|Enterprise Software|Payments,35000000.0,GBR,4,17,1197,15412,16609,0
Advertising|Gamification|Mobile|Photography|Sales and Marketing|Small and Medium Businesses|Social Media Marketing,1050000.0,USA,3,6,373,15584,15957,0
Curated Web|E-Commerce,70000.0,USA,1,3,0,15063,15063,0
Charity|Curated Web|Social Network Media,63500.0,USA,2,1,151,14610,14761,0
Digital Media|Video,18178569.0,USA,3,16,664,16084,16748,0
Networking|Professional Services|Services,2319019.82761953,GBR,1,2,0,16730,16730,0
Internet|Photo Sharing|Social Media,25000.0,USA,1,1,0,16467,16467,0
Advertising,23630000.0,CHN,3,3,1916,13149,15065,0
Developer APIs|Ediscovery|Music|Personalization|Reviews and Recommendations|Search,25609989.0,USA,4,6,1402,14131,15533,1
Advertising|Apps|Facebook Applications|SaaS|Sales and Marketing|Social Media|Social Media Marketing|Software,3344209.0,USA,2,1,136,15306,15442,1
Clean Technology,4150000.0,USA,4,2,776,15426,16202,0
Web Hosting,141410.0,GBR,1,2,0,15065,15065,0
Advertising|Games|Social Media|Virtual Worlds,7000000.0,USA,1,2,0,13570,13570,0
Nanotechnology,410737.0,GBR,1,1,0,15052,15052,0
Consulting|Project Management|Sales and Marketing,502640.0,ESP,1,1,0,15488,15488,0
Apps|Business Services|Internet|iPhone|Mobile|Social Media,1100000.0,USA,1,7,0,14733,14733,0
Mobile|Software|Tablets,4100000.0,DNK,3,3,510,15568,16078,0
Web Hosting,10500000.0,USA,1,2,0,16012,16012,0
Advertising|Facebook Applications|Social Media Marketing,25000.0,ARG,1,1,0,15218,15218,0
Agriculture|Hospitality,20000.0,USA,1,1,0,16191,16191,0
Public Relations,69300000.0,USA,7,35,2878,11191,14069,1
Customer Service|E-Commerce,5000000.0,GBR,1,1,0,13573,13573,1
Accounting|Finance|News|Software,166677.0,GBR,1,1,0,15959,15959,0
Cloud Data Services|Enterprise Software|Internet of Things|SaaS|Software,6427926.0,USA,3,5,427,15187,15614,0
Nonprofits,209800.0,USA,1,1,0,16107,16107,0
Soccer|Social Media|Social Network Media|Sports,860760.0,FRA,2,1,800,14432,15232,0
Social Media,3000000.0,USA,1,1,0,16021,16021,0
Wine And Spirits,1000000.0,SGP,1,1,0,16230,16230,0
Event Management,9542943.0,GBR,1,1,0,16226,16226,0
E-Commerce|Entertainment|Facebook Applications|Gift Card|Private Social Networking|Social Commerce|Social Network Media,1000000.0,ISR,2,4,387,14579,14966,1
Distributors|Graphics|Manufacturing,4500000.0,USA,1,1,0,15869,15869,0
App Marketing|Consulting|Enterprise Software|Media|Music|Sales and Marketing|Social Media,1000000.0,USA,1,1,0,15019,15019,0
Brand Marketing|Recruiting,603000.0,USA,5,6,1136,15495,16631,0
Curated Web,2267343.0,GBR,1,1,0,14669,14669,0
Mobile|Photography,174815.0,ESP,3,3,942,15614,16556,0
Digital Media|Fitness|Health and Wellness|Media,6112828.0,USA,5,8,559,15575,16134,0
Internet,4600000.0,USA,4,7,1534,14975,16509,0
Media|News|Publishing,3000000.0,USA,1,1,0,16601,16601,0
Art|Artists Globally|E-Commerce|Retail,5500000.0,USA,2,3,308,13571,13879,0
Services|Software,5500000.0,USA,1,3,0,12627,12627,0
Health and Wellness,200000.0,USA,1,1,0,16112,16112,0
Media|Software|Technology,2000000.0,USA,1,4,0,16743,16743,0
E-Commerce,222000000.0,USA,4,18,1239,15422,16661,0
E-Commerce,16200000.0,USA,4,12,556,15614,16170,0
Beauty|Fashion,21612355.0,GBR,1,4,0,14714,14714,0
Fashion,72000000.0,AUS,2,3,556,15340,15896,0
Fashion|Retail|Shopping,1791946.0,GBR,2,1,138,16199,16337,0
Apps|Mobile|Restaurants,1000000.0,USA,1,2,0,16222,16222,0
Advertising|Curated Web|Fashion,115000.0,GTM,2,2,172,15993,16165,0
Social Media,40000.0,CHL,1,1,0,15939,15939,0
Curated Web|Internet Marketing|iPhone|Mobile|Networking|Social Commerce,200344.0,GBR,2,2,137,15720,15857,0
Advertising|Internet|Real Estate,100000000.0,AUS,1,1,0,16282,16282,0
EdTech|Education,40000.0,USA,1,1,0,15939,15939,0
EdTech|Health and Wellness|Health Care|Software,750000.0,USA,1,1,0,16094,16094,0
E-Commerce,525000.0,USA,2,1,412,15755,16167,0
Biotechnology,59929933.0,USA,3,1,1580,15077,16657,0
Consumer Goods|Leisure|Sports,2652724.0,GBR,1,1,0,13088,13088,0
Security,2460000.0,GBR,1,1,0,14056,14056,0
Apps|Software,2180000.0,USA,2,13,235,16222,16457,0
Education,454575.0,GBR,1,3,0,15915,15915,0
Career Management|Communities|Professional Networking|Publishing,8000000.0,USA,2,6,697,15415,16112,0
Consulting|Recruiting|Sales and Marketing|Search,250000.0,USA,1,1,0,15065,15065,0
Mobile,150000.0,USA,1,5,0,16588,16588,0
Advertising|Media|News,3933513.0,SWE,3,2,1278,13787,15065,0
Hospitality,396966.0,GBR,1,1,0,15425,15425,0
E-Commerce|Lifestyle|Retail,2800000.0,ARE,3,7,809,15717,16526,0
Photography|Video,1540943.0,USA,2,5,544,15483,16027,0
Software,8500000.0,USA,1,1,0,16002,16002,0
Diagnostics|Health Care|Hospitals,2350000.0,USA,2,1,436,16188,16624,0
Colleges|EdTech|Education,95000000.0,USA,2,5,925,15433,16358,0
Clinical Trials|Health and Wellness|Non Profit,20000000.0,USA,1,1,0,16322,16322,0
Freemium|Games|iPhone|Mobile|Mobile Games,2263475.0,SGP,5,4,1660,13514,15174,0
Ad Targeting|Advertising|Advertising Platforms|Big Data|Brand Marketing|Digital Media|Media|Mobile|Mobile Video|Technology,10340000.0,USA,3,3,832,15400,16232,0
Finance,25000000.0,USA,1,2,0,14549,14549,0
Game|Games,7425000.0,USA,3,1,636,13620,14256,0
Career Management|Career Planning|Content|Curated Web|Digital Media|Employment|Human Resources|Recruiting|SaaS,12800000.0,USA,3,23,841,15727,16568,0
Creative|Music,200000.0,AUS,1,1,0,15340,15340,0
Nonprofits,500000.0,USA,1,1,0,16175,16175,0
Business Services|Document Management|Information Services|Software,15550000.0,USA,3,5,1409,13374,14783,0
Consumer Goods|Kids|Organic Food,500100.0,USA,1,3,0,15340,15340,0
E-Commerce,577783.0,GBR,2,1,687,15443,16130,0
Clean Technology,8500000.0,GBR,2,1,367,14151,14518,0
Clean Technology,17881980.0,NLD,5,25,2448,14245,16693,0
Curated Web,4300000.0,USA,2,9,1996,12528,14524,0
Social Media|Social Media Marketing|Software,3050000.0,USA,2,14,174,16031,16205,1
Communities|Design|Social Media|Web Design,2000000.0,USA,1,8,0,16209,16209,0
Security,23000000.0,USA,1,1,0,15132,15132,0
Internet|Subscription Businesses|Web Tools,2000000.0,RUS,1,1,0,15918,15918,0
Career Management|Consumer Internet|Data Mining|Human Resources|Marketplaces|Recruiting|SaaS|Software,21400000.0,USA,5,10,1055,15431,16486,1
Flash Storage|Homeland Security|Storage|Web Hosting,8423293.0,NOR,1,1,0,15323,15323,0
Cooking|Hardware + Software|Internet of Things,5400000.0,USA,2,21,486,16108,16594,0
Games|Mobile Games|Social Games,425000.0,CRI,1,2,0,15706,15706,0
News,500000.0,USA,1,1,0,13215,13215,0
Blogging Platforms|Social Media|Sports,18000000.0,USA,3,2,474,16261,16735,0
Curated Web,7300000.0,USA,2,1,92,13818,13910,0
Incubators|Office Space|Startups|Venture Capital,930000.0,MEX,3,2,515,15774,16289,0
Internet|Logistics|Startups,6000000.0,IND,2,3,72,16538,16610,0
Curated Web|Design|Lifestyle|Local|Travel,200000.0,USA,3,2,826,15894,16720,0
3D|Mobile|Photography|Video,150000.0,GBR,1,1,0,16197,16197,0
Art|Creative|Design|E-Commerce|Photography|Printing|Social Media,60824.0,USA,1,1,0,15796,15796,0
Design|Engineering Firms|Manufacturing,25000.0,USA,1,1,0,15455,15455,0
Software,42800000.0,USA,2,2,413,15230,15643,0
E-Commerce|Fashion|Green|Women,82974359.0,USA,5,30,1194,15340,16534,0
E-Commerce|Finance|Finance Technology,39750000.0,USA,4,11,2093,13787,15880,0
Health Care,1474090.0,CAN,2,3,219,16182,16401,0
Auctions|Entertainment|Finance|Investment Management|Music|Renewable Energies|Solar,3427090.0,USA,4,2,676,15674,16350,0
Fashion,1658338.0,USA,2,7,36,15911,15947,0
Customer Service|Restaurants,2364814.0,GBR,2,2,517,15279,15796,0
Software,15000.0,USA,1,2,0,15368,15368,0
Brand Marketing|Entrepreneur|Finance|Software|Technology,2662179.73738861,GBR,3,4,883,15522,16405,0
Education,46350000.0,USA,5,5,699,16000,16699,0
Search|Shopping,50000.0,USA,2,2,602,15233,15835,0
Curated Web|Finance,350000.0,USA,3,10,94,14914,15008,1
E-Commerce|Universities,300000.0,CAN,1,1,0,15946,15946,0
Photography,3000000.0,CHN,1,1,0,13665,13665,0
Internet,20360.0,ESP,1,1,0,15986,15986,0
Education|Ticketing|Training,15000.0,USA,1,2,0,15576,15576,0
Fashion|Media|News,7829577.0,USA,2,12,246,16174,16420,0
Manufacturing,75000.0,USA,1,1,0,15406,15406,0
Corporate Wellness|Enterprise Software|Internet of Things|Smart Grid,48580.0,ESP,3,1,640,15796,16436,0
Facebook Applications|Music|Social Media|Twitter Applications,215000.0,USA,3,3,162,15218,15380,0
Governments|High Tech|Internet|Software,500000.0,USA,1,1,0,15569,15569,0
Ad Targeting|Advertising|Big Data|Location Based Services,1000000.0,USA,1,3,0,16668,16668,0
Product Design|Recycling,225000.0,CHN,1,2,0,16653,16653,0
Analytics|CRM|Reputation|Social Network Media,482786.0,SGP,1,2,0,15675,15675,0
E-Commerce,2887633.0,USA,4,1,1778,14042,15820,0
Games|Location Based Services|Mobile|Social Games,1562000.0,USA,5,13,1214,15034,16248,0
Hospitality,88145.0,GBR,1,1,0,15670,15670,0
Advertising,67500000.0,USA,4,14,1729,14691,16420,0
Health and Wellness,30305028.0,GBR,1,1,0,15987,15987,0
iPhone|Mobile|Navigation|Public Transportation|Transportation|Travel,477269.0,CAN,2,1,320,15810,16130,0
Fashion|Retail,12444994.0,USA,4,5,483,14742,15225,1
Home Automation|Human Computer Interaction|Internet of Things|Natural Language Processing,1317577.0,CAN,3,1,566,15565,16131,0
Education,300000.0,USA,1,1,0,15867,15867,0
Education|Life Sciences|Medical|Medical Professionals,8800000.0,USA,2,1,109,16303,16412,0
Advertising|Classifieds,250000.0,SWE,1,3,0,15887,15887,0
Entertainment|Film|Music,2100000.0,USA,1,2,0,16584,16584,0
Apps|Entertainment|Games,20000.0,USA,1,1,0,15985,15985,0
Games,1631321.0,CHN,1,1,0,15949,15949,0
Blogging Platforms|Entertainment|Media|News|Politics|Video|Video Streaming,4000000.0,USA,1,1,0,16176,16176,0
Auto|Cars|Comparison Shopping|Insurance|Insurance Companies|Price Comparison|Search,6025063.0,USA,4,12,665,15380,16045,0
Communities|News|Publishing,3270000.0,SGP,1,1,0,16513,16513,0
Mobile|Wearables,8800000.0,USA,1,1,0,16308,16308,0
Social Media,20000000.0,USA,1,5,0,15663,15663,1
Financial Services|FinTech|Mobile|Wealth Management,2300000.0,USA,2,1,144,15840,15984,0
Crowdsourcing|Social Business|Social Media,13308556.0,ESP,4,5,670,13453,14123,0
Analytics|Automotive|Cars,200000.0,USA,2,2,16,16559,16575,0
Games,40000.0,NLD,1,1,0,15796,15796,0
Online Dating|Social Media|Social Search,1720000.0,USA,2,8,292,15431,15723,0
Crowdfunding|Design|E-Commerce|Home & Garden|Social Commerce,400000.0,CHN,1,2,0,14944,14944,0
Startups,1000000.0,FRA,2,2,285,15928,16213,0
Curated Web|Fashion|Internet,2100000.0,GBR,2,2,346,16040,16386,0
Personalization|Reviews and Recommendations,9700000.0,GBR,3,9,1024,13269,14293,0
Coupons|E-Commerce|Lifestyle Products|Local|Mobile|Online Shopping|Search|Shopping,26000000.0,USA,3,9,891,12815,13706,1
Enterprise Software,7250000.0,USA,1,1,0,14251,14251,0
Recruiting,1383220.0,GBR,2,1,330,16315,16645,0
Transportation,240000.0,IND,1,1,0,16583,16583,0
Curated Web|Employment,7250000.0,USA,1,1,0,12730,12730,0
Biotechnology|Health and Wellness,477133.0,PRT,2,2,518,14426,14944,0
E-Commerce,1125000.0,USA,1,1,0,16045,16045,0
News,8205600.0,FRA,1,1,0,15265,15265,0
Finance,30000000.0,USA,1,5,0,13706,13706,1
Marketplaces,120000.0,USA,1,1,0,16405,16405,0
Trading,7000000.0,USA,1,4,0,11540,11540,0
Games,8000000.0,USA,1,1,0,13160,13160,1
News|Social Media,6900000.0,USA,2,6,555,14215,14770,0
E-Commerce,2640000.0,GBR,2,6,91,15431,15522,0
Biotechnology,17850000.0,USA,2,2,327,16421,16748,0
Biotechnology,35000000.0,FRA,1,4,0,16708,16708,0
Biotechnology|Health Care|Therapeutics,30164603.0,USA,5,16,1877,14685,16562,0
Biotechnology|Pharmaceuticals,7000000.0,ISR,1,1,0,15846,15846,0
Manufacturing,21121298.0,FRA,3,18,1979,10957,12936,0
Games|Reviews and Recommendations|SEO|Social Media,4000000.0,ESP,1,1,0,14975,14975,0
Biotechnology|Health Diagnostics,5480000.0,USA,7,1,1499,15116,16615,0
Bio-Pharm|Medical Devices|Services,50000.0,USA,1,1,0,15271,15271,0
Health and Wellness|Health Care|Social Media|Social Network Media,6300000.0,USA,3,5,512,15512,16024,0
Biotechnology,1250000.0,USA,1,1,0,14616,14616,0
Biotechnology,12000000.0,USA,1,1,0,14586,14586,0
Health Care|Medical|Medication Adherence,2780319.0,BEL,1,2,0,16457,16457,0
Health Care,9000000.0,USA,2,7,120,13530,13650,0
Biotechnology|Health Care,129375000.0,USA,1,1,0,14942,14942,1
Biotechnology,3372501.0,USA,4,7,1532,14615,16147,0
Biotechnology,30449358.0,FRA,3,6,874,15587,16461,0
Software,50000.0,USA,1,1,0,15776,15776,0
Biotechnology,13504894.0,USA,3,2,635,14796,15431,0
Clean Technology,6617250.0,FIN,1,1,0,14505,14505,0
EdTech|Education,1350000.0,USA,2,2,1247,12427,13674,0
Development Platforms,1367119.0,ITA,1,1,0,16213,16213,0
Health Care|Medical|Therapeutics,39000000.0,USA,1,5,0,12303,12303,0
Nanotechnology,7500000.0,USA,1,1,0,16026,16026,0
Semiconductors,10060000.0,USA,1,2,0,13105,13105,0
Biotechnology,16570991.0,USA,6,2,1582,14697,16279,0
Health Care|Health Diagnostics,3508462.0,USA,2,3,708,14579,15287,0
Lasers|Technology,1700000.0,USA,1,2,0,13263,13263,1
Clean Technology,41500000.0,USA,1,3,0,13987,13987,0
Biotechnology,7000000.0,USA,2,3,421,15419,15840,0
Health and Wellness|Medical Devices|Pharmaceuticals|Services,11000000.0,USA,2,3,190,16441,16631,0
Clean Technology,19310005.0,USA,4,1,714,14834,15548,0
Energy Management|Service Providers|Technology,2750000.0,USA,1,2,0,16630,16630,0
Energy Efficiency|Technology,6352533.0,DEU,3,9,636,15903,16539,0
Public Safety|Services,4039403.0,GBR,1,1,0,15979,15979,0
Online Travel|Public Transportation|Weddings,81018.0,ESP,1,1,0,15248,15248,0
Health Care|Medical Devices,57075746.0,USA,5,5,2747,13910,16657,0
Finance,40000.0,CAN,1,1,0,15940,15940,0
Commercial Real Estate|Office Space|Real Estate,2465000.0,USA,4,4,828,15712,16540,0
Entertainment,2000000.0,USA,1,2,0,16321,16321,0
Cloud Management|Film|Film Production,40000.0,RUS,1,2,0,16055,16055,0
Big Data Analytics|Security,15000000.0,ISR,5,9,1064,15706,16770,0
Developer APIs|Internet of Things|M2M,297345.0,ESP,2,7,371,16252,16623,0
Clinical Trials|Medical|Pharmaceuticals,7405730.0,USA,2,2,494,15198,15692,0
Blogging Platforms|Entertainment|News,3500000.0,USA,3,2,624,14102,14726,0
Analytics,2357962.0,GBR,2,2,1035,15387,16422,0
Health Care,225000.0,USA,3,2,608,15478,16086,0
Internet of Things|NFC,69000000.0,NOR,3,1,664,15954,16618,0
3D Technology|Portals|Web Hosting,82029.0,ITA,1,1,0,16059,16059,0
Software,3685000.0,USA,2,8,507,14039,14546,1
Social Media,2025000.0,FIN,2,5,216,15945,16161,0
Hardware + Software|RFID,40500000.0,USA,3,13,1048,13027,14075,1
Software,12999977.0,USA,2,1,721,15021,15742,1
Analytics|Big Data|Consulting|Software,4200010.0,USA,2,2,202,15539,15741,1
Software,7000000.0,CAN,1,3,0,11515,11515,1
Finance|FinTech|Personal Finance,90000000.0,USA,2,2,1767,13108,14875,0
Freemium|Games|Mobile Games,120000.0,USA,1,1,0,16267,16267,0
Customer Service|Market Research|Sales and Marketing|Social Media|Technology,25630000.0,USA,4,10,1514,13374,14888,0
Software,158730.0,CHN,2,1,153,15187,15340,0
Education,10200000.0,USA,2,7,913,15040,15953,0
Education,798050.0,KOR,2,2,578,14975,15553,0
EdTech|Education|Startups|Technology,4700000.0,USA,3,11,946,15559,16505,0
Software,168918.0,CHL,3,4,487,15796,16283,0
EdTech|Education|Web Design|Web Development,9500000.0,USA,3,9,686,15762,16448,0
Collaboration|Enterprises|Enterprise Software|Finance,532000.0,USA,2,10,143,14914,15057,1
Corporate Training|Human Resources,15000000.0,USA,2,2,532,16161,16693,0
Consulting,1600000.0,IND,1,1,0,16077,16077,0
Advertising|Technology,1630000.0,USA,2,15,224,14975,15199,1
Analytics|Finance|Finance Technology|FinTech|Software,1000000.0,USA,1,8,0,16279,16279,0
Financial Services|FinTech,27500000.0,USA,2,2,1516,11048,12564,1
Analytics|Enterprises|Enterprise Software|Gamification|Incentives|SaaS|Sales and Marketing,3436185.39871243,USA,2,1,2028,14241,16269,1
Software,1000000.0,USA,1,1,0,13200,13200,0
Investment Management|Trading,1400000.0,RUS,1,1,0,15584,15584,0
Education,2000000.0,IND,2,1,481,16100,16581,0
Analytics|Digital Media|Optimization|Sales and Marketing|Services|Software,12000000.0,USA,3,7,866,15349,16215,0
Enterprise Software|Mobile|Software|Web Development,36200000.0,USA,4,10,1946,10129,12075,0
Security,16294493.7894764,CAN,2,7,251,12880,13131,1
Biotechnology,25000000.0,USA,1,1,0,13857,13857,1
Games,11000000.0,USA,2,1,383,14917,15300,0
Advertising,800000.0,FIN,1,2,0,15443,15443,0
Advertising,8000000.0,USA,2,4,224,12976,13200,1
Education|Social Innovation|Technology,4329819.0,GBR,4,10,615,16010,16625,0
Content|Content Discovery|Delivery|E-Commerce|Mobile|Mobile Commerce|Wine And Spirits,1100000.0,USA,1,1,0,16513,16513,0
Video,3439960.0,USA,2,11,139,16337,16476,0
Web Tools,610000.0,USA,1,4,0,16658,16658,0
Entertainment|Game Mechanics|Online Gaming,5000000.0,CAN,1,1,0,16534,16534,0
Software,7525000.0,USA,2,2,1722,13937,15659,0
Audio|Entertainment|Games|Internet|News|Television|Video|Video Streaming,300000.0,USA,1,3,0,14744,14744,0
Cloud Computing|Curated Web|File Sharing|Photography|Privacy|Storage|Video,2750000.0,USA,1,6,0,15513,15513,1
Internet Marketing|Software,51979578.0,USA,8,13,2479,13879,16358,0
Social Buying|Social Media,8699999.0,USA,4,2,1488,13149,14637,0
Big Data|Cloud Data Services|Embedded Hardware and Software|Internet of Things|Sensors|Services|Software,14500000.0,USA,3,11,1317,15279,16596,0
Health Care|Medical|Therapeutics,50000.0,USA,1,1,0,16008,16008,0
Entertainment|Media|Services,500000000.0,FRA,1,1,0,12621,12621,0
Curated Web|News,1000000.0,USA,1,2,0,13665,13665,0
Crowdsourcing|Curated Web,4169942.0,CAN,1,1,0,13941,13941,0
Consumer Goods,73408.0,GBR,1,1,0,16222,16222,0
Identity Management|Mechanical Solutions|Technology,15000000.0,USA,1,5,0,12437,12437,1
Content|Information Services|Visualization,50199.0,COL,1,1,0,15522,15522,0
Content|Digital Media|Enterprise Software|Entertainment|Film|Licensing|Media|Video,55500000.0,USA,3,2,1367,15202,16569,0
Education|iPad|Mobile|Software,150519.0,IRL,3,3,700,15218,15918,0
Web Design|Web Development|Web Hosting,4000000.0,GBR,1,1,0,11338,11338,0
Software,390000.0,SGP,1,2,0,15055,15055,0
Software,7000000.0,CAN,1,2,0,16713,16713,0
Artificial Intelligence|Machine Learning|Natural Language Processing,125000.0,USA,2,1,443,16049,16492,0
Big Data|Business Intelligence|Enterprise Software|Software,40700000.0,USA,2,7,732,15507,16239,0
Consulting|Software,28000000.0,USA,1,2,0,11241,11241,0
Enterprise Software|Networking,25662500.0,USA,3,5,1148,15265,16413,0
Biotechnology,56000000.0,CAN,2,9,887,15638,16525,0
Environmental Innovation|Material Science|Recycling,3500000.0,USA,2,4,572,16030,16602,0
Algorithms|E-Commerce|Fashion|Internet|Machine Learning,10500000.0,GBR,3,7,995,15675,16670,0
E-Commerce,21100000.0,USA,3,13,821,15448,16269,0
Messaging,6300000.0,USA,2,2,985,13965,14950,1
Cloud Security|Finance|SaaS|Security,11899495.0,USA,5,8,934,15719,16653,0
Animal Feed|Cyber Security|Data Security|Homeland Security|Information Security|Network Security|Security|Theatre,12.0,USA,1,1,0,16553,16553,0
Network Security,22000000.0,USA,3,3,376,16394,16770,0
Cyber|Mobile Security|Security,56351387.0,USA,5,14,1636,14520,16156,0
Cyber Security|Data Security|Enterprise Security|Information Security|Network Security|Security,12200000.0,USA,2,6,218,16553,16771,0
Security,26300000.0,USA,3,8,702,15706,16408,0
Social + Mobile + Local|Social Network Media,5000000.0,USA,1,7,0,15966,15966,0
E-Commerce|Fashion|Retail,131120000.0,USA,6,16,2024,14664,16688,0
Bridging Online and Offline|Networking|Online Dating,1570000.0,USA,3,3,504,15706,16210,0
Games,600000.0,ARG,1,1,0,14327,14327,1
Enterprise Software,5300000.0,CHN,1,3,0,13514,13514,0
EdTech|Education,2275000.0,USA,2,4,303,16036,16339,0
Games,7000000.0,USA,2,6,427,13514,13941,0
Natural Resources|Oil & Gas|Services,500000000.0,USA,1,1,0,16534,16534,0
Fantasy Sports|Games|Social Games|Sports|Virtual Goods,500000.0,USA,1,1,0,14524,14524,0
E-Commerce,6000000.0,CHN,1,2,0,15887,15887,0
Supply Chain Management,2200000.0,USA,1,3,0,11372,11372,0
Curated Web,9500000.0,USA,2,1,627,15431,16058,0
Biotechnology|Health and Wellness|Health Care,96000000.0,USA,3,8,3010,12431,15441,1
Fashion|Lifestyle|News|Technology|Travel,54000000.0,USA,1,1,0,16708,16708,0
Curated Web,290000.0,IND,3,5,649,15315,15964,0
Analytics|Life Sciences|Technology,4000000.0,USA,1,12,0,16665,16665,0
Beauty|Consumer Goods|Health and Wellness,30000000.0,USA,2,15,575,16071,16646,0
Advertising|Email Marketing|Internet Marketing|Local Advertising|Local Search|Marketing Automation|Small and Medium Businesses|Telecommunications,4000000.0,USA,3,18,1144,15518,16662,0
Health and Wellness,4400000.0,USA,2,5,513,15857,16370,0
Biotechnology,4000000.0,USA,1,1,0,13769,13769,0
Cloud Computing|Enterprise Software|File Sharing|PaaS|SaaS|Software,15215000.0,USA,4,14,3967,11829,15796,0
Cloud Computing|File Sharing|Games|Media|Mobile|Music|Photography|Video,51000019.0,USA,6,16,1980,12740,14720,1
Advertising|Mobile|Social Television|Television,50000.0,USA,1,1,0,15431,15431,0
Curated Web|Service Providers,273200000.0,USA,6,31,1938,14769,16707,0
Film Production|TV Production,10550458.715596301,CAN,1,1,0,16210,16210,0
Enterprise Software,15424164.5244216,CHN,2,3,1253,15126,16379,0
Ediscovery|Mobile|Sports|Television,4200000.0,USA,1,3,0,15608,15608,0
Advertising Platforms|Brand Marketing|Information Technology|SaaS,14500000.0,USA,4,8,1128,15581,16709,0
iPhone|Mobile|Photography|Photo Sharing|Video,2000000.0,USA,2,3,365,14245,14610,0
Android|Developer APIs|iOS|Mobile|Online Scheduling|Optimization|Task Management,20000.0,USA,1,1,0,15706,15706,0
Consumer Electronics,13000000.0,USA,2,2,525,15826,16351,0
Health and Wellness|Medical|Therapeutics,20000000.0,USA,2,4,0,16335,16335,0
Nanotechnology,16227.0,NLD,1,1,0,16525,16525,0
E-Commerce,5000000.0,CHN,1,1,0,13514,13514,0
Biotechnology,30000000.0,CHN,1,2,0,16742,16742,0
Biotechnology,23450000.0,CHN,2,6,1005,13939,14944,0
Enterprise Software,1631321.0,CHN,2,2,92,15857,15949,0
E-Commerce,10000000.0,CHN,1,1,0,13634,13634,0
E-Commerce,784929.0,CHN,2,3,153,15400,15553,0
Fashion,3001500.0,CHN,1,1,0,14944,14944,0
Apps|Mobile|Ride Sharing,13000000.0,CHN,3,3,316,16222,16538,0
Enterprise Software,5040000.0,CHN,2,2,1216,11323,12539,0
Information Technology|Networking|Services,9500000.0,USA,1,3,0,11547,11547,0
Services,350000.0,ITA,1,2,0,16598,16598,0
Finance|Incentives|Monetization|Publishing,296804.0,GBR,2,1,637,15979,16616,0
E-Commerce,390000.0,USA,1,1,0,12797,12797,0
Health Care,18038630.0,USA,4,4,898,14649,15547,1
Software,5200000.0,USA,2,2,598,14883,15481,0
E-Commerce|Mobile|Music|Theatre,65000.0,ARG,2,2,18,15931,15949,0
E-Commerce,10959636.0,KOR,2,4,162,14822,14984,1
Art|Mobile|RFID|Software|Sports|Ticketing|Web Development,1164531.0,IRL,2,3,514,14313,14827,0
Bitcoin|Credit Cards|Events|Ticketing,500000.0,USA,1,1,0,15939,15939,0
E-Commerce|Events|Ticketing,25973150.463089,ESP,9,7,2294,14245,16539,0
Events|Software|Ticketing,1200000.0,USA,1,1,0,15057,15057,0
E-Commerce|Events|Ticketing,5730000.0,ESP,3,5,1430,14422,15852,0
Enterprise Software|Music|Social Media Marketing|Ticketing,87000000.0,USA,6,18,2296,14335,16631,1
Curated Web|Events|Internet,3000000.0,GBR,1,1,0,15671,15671,0
Online Travel|Travel,7413693.0,IND,3,1,520,15636,16156,0
Analytics|Music Services|Social Commerce,120000.0,CAN,2,2,219,16267,16486,0
Consulting,10000000.0,RUS,1,1,0,16043,16043,0
E-Commerce|Events|Ticketing,10252185.0,USA,9,3,2129,13684,15813,0
Event Management|Events|Social Media|Ticketing,11730685.0,GBR,1,1,0,16218,16218,0
Auctions|E-Commerce,34000000.0,USA,1,4,0,13514,13514,1
Auctions|E-Commerce,3840000.0,JPN,3,5,806,15482,16288,0
Concerts|E-Commerce|Hardware|Search|Sports|Ticketing,15000.0,USA,1,1,0,14031,14031,0
Mobile|Ticketing|Transportation,193939.370361713,BGR,2,2,31,16556,16587,0
Advertising|Games|Publishing|Video|Web Tools,1600000.0,ISR,1,1,0,15155,15155,0
Curated Web,32567560.0,USA,5,15,1336,15309,16645,0
Advertising Exchanges|Content|Content Syndication|Marketplaces|Publishing|Sales and Marketing|Social Media,500000.0,USA,2,2,1858,14245,16103,0
Computers|Data Mining|Software,11791613.0,USA,3,7,636,15743,16379,0
Analytics|Cloud Computing|Enterprises|PaaS|SaaS,118370901.0,USA,8,22,1713,14889,16602,0
Curated Web,1500000.0,USA,1,3,0,15464,15464,0
Software,27000000.0,GBR,3,6,1955,12022,13977,1
Information Technology|Services,5800000.0,GBR,1,1,0,12544,12544,0
Education,160010.0,GBR,1,1,0,16111,16111,0
Internet,588402.969735166,AUS,1,1,0,16520,16520,0
Semiconductors,8280000.0,FRA,3,2,656,14421,15077,0
Consulting|Outsourcing|Software,2200000.0,USA,2,1,2907,13655,16562,0
Assisitive Technology,40000.0,CHL,1,1,0,16222,16222,0
Online Scheduling|Social Media,150000.0,ARG,3,2,468,15876,16344,0
E-Commerce|Online Shopping,1032500.0,ARG,4,4,1511,15218,16729,0
Advertising|Internet|Sales and Marketing,1111811.99918897,ESP,3,11,731,15248,15979,0
Software,750000.0,USA,1,2,0,13098,13098,0
Cloud Computing|Enterprise Software|IaaS|PaaS,18500000.0,USA,2,5,575,15042,15617,1
Hospitality,21910356.0,USA,3,2,755,15910,16665,0
Biotechnology,68285881.8492276,BEL,6,5,4437,12327,16764,1
Advertising|Social Media Marketing,5100000.0,AUS,3,4,924,15477,16401,0
Advertising|Analytics|Apps|Facebook Applications|Social CRM|Twitter Applications,1300000.0,FRA,1,3,0,15097,15097,0
Enterprise Software,11000000.0,GBR,1,1,0,15173,15173,0
Software,750000.0,USA,1,1,0,12874,12874,0
Data Security|Messaging|Text Analytics,81100000.0,USA,4,17,1871,14880,16751,0
Apps|Education|Hardware + Software|Toys,5000000.0,USA,4,3,479,15857,16336,0
Telecommunications,15000000.0,GHA,1,2,0,12979,12979,0
Clean Technology,103662749.0,USA,17,7,2679,14022,16701,0
Biotechnology,22500000.0,USA,2,7,1350,13530,14880,0
E-Commerce,1000000.0,VNM,2,2,542,15402,15944,0
Mobile,7400000.0,USA,3,7,972,15364,16336,0
Internet|Internet Service Providers|Wireless,45000000.0,IND,1,4,0,16391,16391,0
Consumer Electronics|Internet of Things|Mobile,18600000.0,USA,2,13,481,15910,16391,0
Semiconductors,127522596.0,USA,7,16,2593,12947,15540,1
Business Analytics|CRM|Internet|Lead Management|SaaS|Sales Automation|Tracking,646774.0,FRA,1,2,0,16325,16325,0
Apps|Retail|Small and Medium Businesses|Software,40898.0,IRL,1,1,0,16111,16111,0
Analytics|Big Data|Real Time|SaaS|Search,1020000.0,USA,2,4,524,15826,16350,0
Software,2900000.0,USA,2,2,405,16036,16441,0
Finance|FinTech,2400000.0,GBR,1,1,0,15649,15649,0
Apps|Concerts|Ediscovery|iOS|Mobile|Music|Ticketing,360000.0,USA,1,3,0,15743,15743,1
Apps|Education|Games|iPad|Kids|Parenting|Publishing|Tablets|Textbooks|Toys,570000.0,USA,3,4,608,15522,16130,0
Freemium|Games|Mobile Games|Real Time,20395.0,EST,1,1,0,15737,15737,0
Enterprise Software|Software|Tracking,170000.0,USA,3,1,1887,14040,15927,0
Delivery|E-Commerce|Hospitality|Restaurants,152500.0,USA,3,4,365,15737,16102,0
Collaboration|Curated Web|Meeting Software|Online Scheduling,12400000.0,USA,3,5,1406,12969,14375,1
Software,600000.0,KOR,1,1,0,16251,16251,0
Social Media,162364.0,CHN,1,1,0,15887,15887,0
Software,25000.0,PHL,1,1,0,15800,15800,0
Analytics|Productivity Software|Task Management,7000000.0,USA,1,6,0,16206,16206,1
Finance|Photography,14118000.0,USA,4,17,1298,14975,16273,0
Semiconductors,7500000.0,USA,1,2,0,12784,12784,0
Content|Real Time,617000.0,USA,2,1,509,15877,16386,1
Online Reservations|Service Providers,50000.0,RUS,1,1,0,15340,15340,0
Consumers|Curated Web|Events|Networking|Web Development,3000000.0,USA,1,2,0,13848,13848,0
Curated Web|Event Management|Events|Internet,250000.0,RUS,2,2,671,15400,16071,0
E-Commerce|Fitness|Health and Wellness|Internet|Spas,119066.0,BEL,2,2,0,15614,15614,0
CRM,40000.0,CHL,1,1,0,16222,16222,0
Curated Web|Home Renovation|Marketplaces|Service Providers,2200000.0,IND,2,5,309,16357,16666,0
Security,6549170.0,USA,5,2,1277,14173,15450,0
Databases|Security|Software,11330863.924417699,CAN,1,4,0,12810,12810,1
Software,15500000.0,USA,1,6,0,11757,11757,0
Consumer Internet,500000.0,RUS,1,1,0,15584,15584,0
Apps|Online Scheduling|Shopping,5000000.0,USA,1,1,0,13780,13780,0
Apps|Customer Service|Internet|Software,126457.0,ESP,1,2,0,16344,16344,0
iPhone|Social Network Media|Sports|Web Hosting,565007.0,ESP,7,1,1299,15187,16486,0
Finance|Messaging,18000.0,USA,1,1,0,14462,14462,0
Charity|Communities|Mobile|Non Profit,100000.0,FRA,1,1,0,16344,16344,0
CRM|Document Management|Enterprise Software|Presentations|SaaS|Sales and Marketing|Sales Automation|Software,12100000.0,USA,3,6,965,15761,16726,0
Marketplaces,1700000.0,USA,2,7,0,15691,15691,1
High Tech|Internet|Security,100000.0,USA,3,4,84,15187,15271,0
Internet of Things|Kids|Mobile|Telecommunications,2141000.0,SWE,4,3,388,16213,16601,0
Curated Web,4000000.0,SWE,1,2,0,16324,16324,0
3D|CAD|Hardware + Software,1000000.0,FIN,1,5,0,15286,15286,1
Education,500000.0,USA,1,4,0,16569,16569,0
Finance,90000000.0,RUS,2,2,153,15461,15614,0
Mobile,20000000.0,RUS,1,2,0,15510,15510,0
Games,3000000.0,USA,1,1,0,13689,13689,0
Enterprise Software|Storage|Virtualization,260000000.0,USA,6,17,1595,15057,16652,0
Enterprise Software,15580440.0,FRA,1,1,0,15286,15286,0
Games,20395.0,LTU,1,1,0,15737,15737,0
Mobile|Photography,11200000.0,USA,3,5,1006,12904,13910,1
Curated Web|Guides|Location Based Services|Mobile|Reviews and Recommendations,300000.0,USA,2,1,123,15248,15371,1
Apps|Education|iOS|Kids|Life Sciences|Media|Software,6000000.0,USA,2,6,568,15645,16213,0
Games,600000.0,CHL,1,2,0,16222,16222,0
Chat|Curated Web,1500000.0,USA,1,7,0,14999,14999,1
Analytics|Big Data|CRM|Sales and Marketing,1900000.0,FRA,1,2,0,16021,16021,0
Games,38000000.0,USA,2,5,993,15030,16023,0
Apps|Mobile|Specialty Foods,27665775.0,IND,4,8,434,16304,16738,0
E-Commerce|Payments|SaaS|Software,3000000.0,USA,1,3,0,15870,15870,0
E-Commerce|Marketplaces|Sales and Marketing|Social Media,1000000.0,USA,1,1,0,15210,15210,0
Consulting|Enterprises|Services,3500000.0,USA,1,2,0,16435,16435,0
Apps|Babies|Creative|Education|Entertainment|Hardware|Health and Wellness|iPad|Kids|Photography,1500000.0,ISR,3,2,471,15659,16130,0
Finance,1005975.0,CAN,2,1,2517,14184,16701,1
Clean Technology,45000000.0,USA,4,14,927,13669,14596,0
Biotechnology,57000000.0,USA,5,9,2285,13157,15442,0
Health Care|Medical|Technology,100000.0,USA,1,1,0,15422,15422,0
Games,2000000.0,USA,1,2,0,15546,15546,0
E-Commerce|Payments,13000000.0,USA,1,2,0,16365,16365,0
Apps|Software,5950000.0,USA,2,3,295,15847,16142,0
Charity|Payments,1000000.0,USA,2,4,267,13879,14146,0
Clean Energy|Crowdfunding|Education|Enterprise Software|Entrepreneur|Environmental Innovation|Humanitarian|Networking|Nonprofits|Social Media,72000.0,USA,2,1,334,14335,14669,0
Apps|Brewing|Mobile,54068.0,IRL,1,1,0,15979,15979,0
Finance|SEO|Stock Exchanges,3000000.0,ISR,1,2,0,16273,16273,0
E-Commerce|Ticketing,4000000.0,USA,3,7,749,15372,16121,0
Software,23500000.0,CAN,4,12,1727,11976,13703,0
Web Hosting,87600000.0,GBR,1,1,0,13735,13735,0
Analytics,750000.0,USA,1,2,0,16572,16572,0
Human Resources,750000.0,USA,1,1,0,12382,12382,0
Biotechnology,13332002.0,USA,3,1,984,15590,16574,0
Health Care,1349658.0,GBR,1,2,0,13515,13515,0
Biotechnology,4000000.0,BRA,2,4,598,13123,13721,0
Biotechnology|Health Care|Medical,37790000.0,USA,5,6,982,15628,16610,0
Games,250000.0,USA,1,2,0,15642,15642,0
Games|Social Network Media,1000000.0,USA,1,19,0,14747,14747,0
Content|Enterprise Hardware|Hardware|Networking,1300602.0,GBR,1,2,0,16585,16585,0
Advertising,15000000.0,CAN,1,1,0,15978,15978,0
Cloud Computing|Data Security|Enterprise Software|Security,1355827.0,CAN,2,3,409,15215,15624,0
Manufacturing,28957627.0,SWE,1,1,0,15777,15777,0
Android|Apps|Databases|Identity|Internet|iOS|Social Media|Social Network Media|Startups,220000.0,USA,1,1,0,15896,15896,0
Networking|Sports,18000.0,USA,1,1,0,15474,15474,0
Biotechnology,1000000.0,USA,1,1,0,15344,15344,0
Electronics|Lighting|Semiconductors,250000.0,USA,1,1,0,15522,15522,0
Services,689908.0,FRA,1,1,0,16150,16150,0
Finance|FinTech,24000000.0,CHN,1,2,0,13363,13363,0
Enterprise Software,26300000.0,USA,4,13,1246,12675,13921,1
E-Books|SaaS|Security|Software,850000.0,USA,2,2,489,13634,14123,0
Enterprise Software|Recruiting,668100.0,ROM,3,4,1229,14975,16204,0
Collaboration|Enterprises|Skill Assessment,2756950.0,USA,3,3,481,13545,14026,0
Content Creators|Document Management|Legal,681223.0,AUS,2,2,686,15400,16086,0
Human Resources|Recruiting|Staffing Firms,40000.0,USA,1,1,0,15408,15408,0
Software,1230000.0,FRA,1,2,0,13000,13000,0
Blogging Platforms,4400000.0,RUS,1,1,0,15918,15918,0
Biotechnology|Health Diagnostics,13000000.0,CAN,2,2,370,13110,13480,0
Software,660000.0,DEU,2,3,300,14825,15125,0
Clean Technology,1600000.0,USA,2,1,493,15824,16317,0
Manufacturing,2508623.0,GBR,1,1,0,15308,15308,0
Biotechnology,4600000.0,USA,1,5,0,16107,16107,0
Health Care|Manufacturing|Medical Devices,3364680.94412947,DEU,1,1,0,16715,16715,0
Online Rental,41250.0,HKG,1,1,0,16252,16252,0
Biotechnology,29580831.0,NLD,5,3,2553,13700,16253,0
E-Commerce,417783.315082575,FRA,2,1,976,15584,16560,0
Consulting|Home Decor|Social Media,216480000.0,CHN,2,5,387,16119,16506,0
Enterprise Software|SaaS|Software,96200000.0,USA,3,11,1869,14033,15902,1
Software,1500000.0,KOR,1,1,0,13363,13363,1
Hardware + Software|Health Diagnostics,71779200.0,SWE,4,6,2698,13598,16296,1
Biotechnology,85999999.0,USA,5,10,2524,13727,16251,1
Cloud Infrastructure|Cloud Management|Enterprise Software|Virtual Desktop|Virtualization,850000.0,DEU,1,2,0,15675,15675,0
Advertising,4350000.0,ISR,4,4,1785,13726,15511,0
Concerts|Mobile Commerce|Software|Ticketing,6682500.0,USA,2,11,493,15901,16394,0
Photography,713434.0,GBR,2,6,575,16110,16685,0
Information Technology|Services|Software,20000000.0,USA,1,1,0,11382,11382,1
Photography,1754347.0,CHN,2,2,974,14822,15796,0
Consumer Electronics|Social Television|Software|Sports|Television,2652000.0,USA,3,3,805,15461,16266,0
Enterprise Security|Security|Web Development,25025.0,MEX,1,1,0,16010,16010,0
Biotechnology,100499993.0,USA,4,6,1436,14404,15840,1
Biotechnology,274902.0,GBR,1,2,0,15053,15053,0
Archiving|Messaging|Video Conferencing,26000000.0,USA,3,12,1055,13873,14928,1
Information Technology,950252.0,AUS,1,4,0,16527,16527,0
News,16340000.0,JPN,4,13,776,15551,16327,0
Customer Service|Discounts|E-Commerce|Internet|Storage,40000.0,ESP,1,1,0,15180,15180,0
Biotechnology,12323710.0,USA,6,6,2284,14046,16330,0
Biotechnology,25734560.0,USA,2,1,831,15548,16379,0
Biotechnology,114500000.0,USA,4,23,3325,11619,14944,0
E-Commerce|Language Learning|Messaging|Translation,600000.0,DEU,3,5,1026,14092,15118,0
Fashion,20000.0,USA,1,1,0,16468,16468,0
Mobile,1700000.0,USA,2,10,198,15735,15933,0
Education,40000.0,CHL,1,1,0,15448,15448,0
E-Commerce|Fashion|Retail,300000.0,USA,1,1,0,13269,13269,0
Music,9750000.0,ISR,3,12,1564,14975,16539,0
Design,6400000.0,IND,1,1,0,15922,15922,0
Augmented Reality|Consumer Electronics|Content|iPhone|Mobile|Virtual Worlds,16000000.0,JPN,2,5,296,14586,14882,0
Financial Services,1000000.0,IND,1,1,0,16657,16657,0
Design|Developer Tools|Web Tools,100000.0,USA,1,1,0,16650,16650,0
Advertising|Crowdsourcing|Curated Web|Entertainment|Sales and Marketing,21246000.0,USA,3,3,2326,14031,16357,0
Finance,60000000.0,CHN,3,5,630,15706,16336,0
Software,2175115.0,CHN,2,2,1492,10773,12265,0
Education|Educational Games|Edutainment|Language Learning,316457.0,GBR,4,3,184,16191,16375,0
Internet|Software|Technology,4130000.0,USA,1,5,0,12443,12443,1
3D Technology|Chat|Messaging|Real Time|Social Media,200000.0,USA,1,1,0,16040,16040,0
Advertising|Social Media,1225000.0,SGP,4,12,798,15643,16441,0
Fitness|Health and Wellness|Services,28059.0961978054,EST,1,1,0,16715,16715,0
Entertainment|Services|Video,2333799.0,CYP,5,3,1592,14484,16076,0
Advertising|Graphics|Optimization|Software,2500000.0,ISR,1,1,0,16265,16265,0
Content|Entertainment|Games|Photography|Social Media,125000.0,NLD,1,1,0,15340,15340,0
Mobile|Security|Software,2990599.0,USA,4,3,768,15736,16504,1
Aerospace,1750000.0,USA,1,3,0,16766,16766,0
Travel,12400000.0,GBR,3,10,894,15237,16131,0
News,3500000.0,USA,1,2,0,13451,13451,1
Music,1000000.0,CHN,1,1,0,14797,14797,0
Education,80000.0,CHN,1,1,0,14518,14518,0
Energy|Engineering Firms|Oil,75000000.0,ARE,1,1,0,16302,16302,0
Biotechnology,80606.0,GBR,1,1,0,15169,15169,0
Software,3800000.0,USA,1,1,0,14040,14040,0
Financial Services|Price Comparison|Services,1262266.0,NGA,2,8,206,16466,16672,0
Hardware + Software,9980000.0,BEL,1,1,0,13027,13027,0
Databases|Digital Media|Facebook Applications|Graphics|Music|Video Streaming,53478.0,SVN,1,1,0,15400,15400,0
Clean Technology,16307200.0,NLD,2,3,1515,13987,15502,0
3D|Health Care|Medical|Medical Devices,31518531.0,USA,3,1,345,15475,15820,1
E-Commerce|Fashion|Shopping|Social Media|Video,6000000.0,USA,1,4,0,15629,15629,0
Enterprise Software,2000000.0,USA,1,6,0,14931,14931,0
Biotechnology,58519071.0,USA,2,3,601,15265,15866,0
Pharmaceuticals,24147784.844274398,CAN,2,11,313,12753,13066,1
Enterprise Software,26000000.0,USA,3,8,1248,12081,13329,1
Health Care,19328350.0,GBR,2,6,768,15314,16082,0
Local Based Services|News,15000000.0,USA,2,6,615,12843,13458,0
Games,25000000.0,USA,1,1,0,15882,15882,0
Software,377358.0,CAN,1,2,0,16051,16051,0
E-Commerce,5000000.0,UKR,1,1,0,15797,15797,0
Apps|Communities|Mobile,355114.0,RUS,2,1,0,16006,16006,0
Analytics|Big Data|CRM|Mobile|News|Sales and Marketing|Sales Automation|Software,5550000.0,USA,4,8,540,16146,16686,0
Mobile|Mobile Games|Photo Sharing,370000.0,USA,2,2,121,15736,15857,0
Analytics|Software,250000.0,USA,1,1,0,15706,15706,0
Education,14200000.0,IND,4,7,904,15834,16738,0
Real Estate,315000.0,DEU,1,2,0,14761,14761,0
Education,20700000.0,USA,4,7,1367,14047,15414,0
Security,12000000.0,CHN,1,3,0,12570,12570,0
Public Relations,20000000.0,USA,1,5,0,12366,12366,1
Health Care Information Technology,16500000.0,ISR,1,6,0,12045,12045,0
Analytics|Real Time|Search|Social Media|Twitter Applications,35200000.0,USA,6,14,1735,13879,15614,1
Curated Web,7500001.0,USA,2,2,557,14063,14620,0
Curated Web,900001.0,USA,1,3,0,15817,15817,1
Health Care,75699997.0,USA,6,9,3104,12962,16066,0
Automotive|Cloud Computing|Web Development|Web Hosting,584988.0,USA,1,1,0,15223,15223,1
Software,60000.0,CAN,1,2,0,12809,12809,0
Biotechnology,14743453.0,CAN,4,2,1401,14922,16323,0
Creative|Crowdsourcing|Design|Public Relations,251859.0,MEX,3,2,608,15614,16222,0
Manufacturing,14192160.0,DEU,2,3,798,14620,15418,0
Android|iPhone|Mobile|Web Development,300000.0,USA,2,1,170,15006,15176,0
Collaboration|Communications Infrastructure|Enterprise Software|Messaging,2250000.0,KOR,2,2,186,16384,16570,0
Enterprise Software,15000000.0,USA,1,3,0,15462,15462,0
News,16000000.0,USA,3,5,660,13573,14233,1
Apps|E-Books|Internet|Software,500000.0,ISR,1,1,0,15706,15706,0
Games,553238.0,GRC,1,1,0,15972,15972,0
Software|Virtual Worlds,11220000.0,FRA,2,7,1778,13279,15057,0
Lifestyle|News|Publishing|Social Network Media,1000000.0,GBR,1,1,0,14215,14215,0
Curated Web,150000.0,USA,1,1,0,13787,13787,0
Advertising|Analytics|Customer Service|SaaS,19300000.0,USA,3,6,1496,14610,16106,0
Mobile Commerce,1800000.0,USA,2,5,355,15959,16314,0
Babies|Discounts|E-Commerce|Kids|Parenting,29500000.0,USA,4,6,1104,14434,15538,0
Clean Technology,40000.0,USA,2,2,385,15939,16324,0
Biotechnology,9058042.76049378,GBR,3,4,616,14639,15255,0
Kids|Online Education|Tablets,534701.0,ESP,4,4,396,15826,16222,0
Data Centers|Networking|Unifed Communications,4999672.0,USA,1,1,0,15889,15889,0
Mobile|Mobile Commerce|Sales and Marketing,118000.0,USA,1,1,0,16388,16388,0
Software,10270293.0039867,USA,3,6,516,16023,16539,0
Analytics|E-Commerce,12750000.0,USA,2,5,253,13500,13753,0
Semiconductors,13150000.0,USA,1,4,0,13119,13119,1
Advertising,46672800.0,CHN,4,10,2010,13361,15371,0
Analytics|Application Platforms|Internet|Mobile,250000.0,HKG,1,1,0,15503,15503,0
Curated Web|Design|E-Commerce|Fashion|Furniture|Marketplaces,17000000.0,USA,3,8,1449,14791,16240,0
Contact Management|Mobile|Software,25000000.0,CHN,3,6,1569,14761,16330,0
App Marketing|Apps|App Stores,474586.650336803,USA,1,1,0,16265,16265,0
Enterprise Software|Real Time|Social Network Media|Telecommunications|VoIP,2000000.0,KOR,1,2,0,14245,14245,0
FreetoPlay Gaming|Gambling|Mobile Games|Social Games,1150000.0,ISR,3,3,638,15857,16495,0
Semiconductors,12000000.0,USA,1,2,0,15148,15148,1
Brand Marketing|Market Research|Technology|Video,12000000.0,USA,5,2,2193,14090,16283,0
Art|Creative|Design|Social Media,710000.0,IND,2,6,493,15737,16230,0
Advertising|Entertainment|Games|Music,45000000.0,USA,1,2,0,15203,15203,1
Android|Artificial Intelligence|iPhone|Mobile|Software,21591233.0,GBR,4,17,1078,14874,15952,0
Guides|Maps|Offline Businesses|Tourism|Travel|Travel & Tourism,475000.0,ESP,3,7,1009,14641,15650,1
Hotels|Online Travel|Social Media|Social Travel|Travel|Travel & Tourism,40000.0,IND,2,2,421,15561,15982,0
Bridging Online and Offline|Marketplaces|Mobile|Travel,1800000.0,USA,1,22,0,16548,16548,0
Marketplaces|Tourism|Travel,40000.0,USA,2,1,64,16252,16316,0
Advertising|E-Commerce|Search|Technology|Tourism|Travel,500000.0,AUT,3,8,694,15866,16560,0
Cloud Computing|Mobile|Mobile Devices|Software|Web Development,6662526.0,CAN,6,1,832,15162,15994,0
News|Video,24109500.0,USA,4,15,656,14958,15614,0
Software,19620000.0,USA,5,24,1388,15109,16497,0
Big Data|Data Centers|Networking,100000000.0,CHN,1,2,0,16224,16224,0
E-Commerce|Finance,93000.0,USA,2,2,275,14700,14975,0
Mobile,90000.0,USA,1,1,0,15706,15706,0
Enterprise Software,109046753.0,USA,4,22,1407,14536,15943,0
Mobile,300000000.0,IND,1,1,0,13910,13910,0
Finance|Financial Services|Insurance,322282099.0,GBR,1,1,0,15006,15006,0
Semiconductors,95000000.0,ISR,2,2,1589,14468,16057,1
Health and Insurance|Health Care|Medication Adherence|Pharmaceuticals,200000.0,USA,1,1,0,16512,16512,0
Educational Games|K-12 Education|Kids,25025.0,MEX,1,1,0,16010,16010,0
E-Commerce,3889364.0,USA,3,5,1095,14000,15095,1
Business Services|Collaboration|Communities|Local Businesses|Professional Networking|Social Media|Software,5260000.0,USA,1,2,0,16130,16130,0
Advertising|Apps|Events|Guides|Internet|Local|Local Based Services|Mobile|Restaurants|SaaS|Subscription Businesses|Web CMS,247436.0,USA,2,2,380,15156,15536,0
Photography|Video,11250000.0,CHN,1,3,0,13453,13453,0
Games,31200000.0,USA,3,11,1145,15268,16413,0
Enterprise Software,643300.0,FRA,1,4,0,15910,15910,0
Engineering Firms|Manufacturing|Telecommunications|Tracking,12543000.0,DNK,1,3,0,13432,13432,1
Clean Technology,48000000.0,USA,2,8,783,13798,14581,0
Biotechnology,12200000.0,GBR,1,1,0,14809,14809,0
Automotive|Fleet Management|Public Safety|Risk Management,484308.0,GBR,1,1,0,15686,15686,0
Advertising,31700000.0,USA,2,6,368,14371,14739,1
Games|Software,100000.0,CHL,1,1,0,15706,15706,0
Analytics,481837.0,GBR,2,4,531,14322,14853,0
Enterprise Software,40000.0,CHL,1,1,0,16051,16051,0
Development Platforms|Sports|Technology|Tracking,2690000.0,SWE,1,1,0,13033,13033,0
Hardware + Software|Tracking|Video Streaming,9500000.0,USA,2,4,211,16420,16631,0
Big Data|Gamification,1680000.0,GBR,2,4,1929,13599,15528,0
Software,2926842.0,GBR,2,2,0,16538,16538,0
Software,29359751.0,USA,4,5,875,15609,16484,0
Enterprise Software|Web Tools,5800000.0,USA,2,8,140,15281,15421,1
Apps|Curated Web|Mobile|Software,335747.0,ESP,1,1,0,15744,15744,0
Risk Management|Security,8000000.0,USA,1,1,0,13752,13752,0
Advertising|Email|SaaS|Sales and Marketing|Semantic Search|SEO|Software,5673200.0,DNK,3,3,2684,10957,13641,0
Legal,412000.0,GBR,1,1,0,13704,13704,0
B2B|Big Data|Government Innovation|Mobile|SaaS,1060000.0,USA,9,12,643,15735,16378,0
B2B|Business Services|Curated Web|Design|Enterprise Software|Information Technology|Project Management|Reviews and Recommendations|SaaS|Small and Medium Businesses|Subscription Service|Technology|Tracking|Web Design|Web Development,270320.0,LTU,2,3,260,15874,16134,0
Curated Web,11500000.0,USA,2,17,365,14061,14426,0
Consumer Internet|Curated Web|Email Marketing|Personalization|Price Comparison|Retail Technology,10190000.0,USA,4,8,795,15870,16665,0
Delivery|Software,120000.0,USA,1,1,0,16405,16405,0
Hardware + Software,33200492.0,USA,2,3,248,16055,16303,0
Analytics,21750000.0,USA,4,19,559,15854,16413,0
Music,88000.0,USA,2,18,61,15553,15614,0
E-Commerce|Fashion|Lifestyle,5699999.0,USA,2,7,391,16274,16665,0
Software,2500000.0,CAN,2,3,385,16162,16547,0
Application Platforms|Manufacturing|Mobile|Mobile Software Tools|Software,11384493.0,USA,5,12,2815,13691,16506,0
Software,1230000.0,ARG,1,2,0,13172,13172,0
Software,1500000.0,USA,2,1,97,15407,15504,0
Biotechnology,52040000.0,USA,4,6,2705,13630,16335,1
Analytics|Finance|Stock Exchanges,470000.0,USA,2,2,438,15765,16203,0
Business Services|Optimization|Professional Services,3299122.0,GBR,1,1,0,15125,15125,0
Billing|Cloud Computing|Enterprise Software|SaaS|Software|Subscription Businesses,47000000.0,USA,2,2,942,15431,16373,0
Marketplaces,120000.0,USA,1,1,0,16267,16267,0
Advertising|Brand Marketing,1500000.0,USA,2,7,253,16071,16324,0
Gps|Hardware + Software|Pets|Tracking,500000.0,AUT,2,1,182,15614,15796,0
Advertising|Analytics|Brand Marketing|Publishing|Social Commerce|Social CRM|Social Media Management|Social Media Monitoring,25900000.0,USA,3,6,1082,15386,16468,0
Analytics|Enterprise Software|SaaS,13500000.0,USA,2,3,52,16553,16605,0
Non-Tech,300000.0,USA,1,1,0,13384,13384,0
Advertising,18950000.0,USA,5,11,1476,14685,16161,0
Finance,18900000.0,ISR,2,4,1076,15371,16447,0
Enterprise Software,565000.0,GBR,1,1,0,13368,13368,0
Enterprise Software,45850000.0,USA,3,15,2316,12192,14508,1
Bitcoin|Financial Services,2800000.0,USA,1,8,0,16267,16267,0
Enterprise Software|SaaS|Supply Chain Management,54925050.0,USA,3,2,3773,12006,15779,1
Enterprise Software|Software|Supply Chain Management,7710000.0,SGP,4,8,1182,15364,16546,0
E-Commerce,40000.0,USA,1,1,0,15940,15940,0
All Markets|Fantasy Sports|Finance|Investment Management|Mobile|Simulation|Stock Exchanges|Trading,10464859.0,SGP,2,4,268,15706,15974,0
Finance,6000000.0,USA,1,3,0,13361,13361,0
Software,390000.0,IND,1,1,0,16558,16558,0
Software,3500000.0,USA,1,2,0,16197,16197,0
Advertising|Apps|Mobile|Sales and Marketing,15000000.0,DEU,1,3,0,15651,15651,0
Communities|E-Commerce|Marketplaces,327352.0,GRC,1,1,0,15714,15714,0
Software,9800000.0,USA,2,2,358,14257,14615,0
Software,7634742.0,USA,3,1,2248,13682,15930,0
Cloud Computing|Enterprise Software|Software,128999992.0,USA,4,7,1088,15110,16198,0
Brokers|FinTech|Investment Management|Risk Management|Trading,4562140.0,GBR,2,3,936,15419,16355,0
B2B|E-Commerce|Shipping|Social Commerce|Social Media|Trading|Wholesale,500000.0,CHN,3,3,809,15442,16251,0
E-Commerce|Fashion|Internet|Marketplaces|Retail,44500000.0,USA,3,20,825,15637,16462,0
Bitcoin|Finance Technology|Financial Services|Trading,100000.0,GBR,1,1,0,16314,16314,0
E-Commerce,1100000.0,USA,1,2,0,16104,16104,0
Finance|Finance Technology|Financial Services|FinTech,3100000.0,USA,1,1,0,16185,16185,0
Music,1289709.0,GBR,3,4,588,15908,16496,0
Software,4000000.0,USA,1,1,0,13634,13634,0
Finance|Internet|Software,4000000.0,USA,2,3,271,16415,16686,0
All Markets|Android|Business Services|Cloud Computing|Education|Finance|Internet|iPad|iPhone|Social Media|Stock Exchanges|Trading,3650000.0,USA,3,14,641,15991,16632,0
Clean Technology,200000000.0,USA,1,1,0,15182,15182,0
Technology,1000000.0,USA,1,3,0,16737,16737,0
Services|Shipping,251012.182220843,KOR,1,1,0,16671,16671,0
E-Commerce,2855800.0,DEU,1,2,0,14628,14628,1
Computers|Software|Technology,2000000.0,USA,1,1,0,11932,11932,1
E-Commerce,2600000.0,USA,1,1,0,14054,14054,0
E-Commerce|Sales and Marketing,100000.0,USA,1,1,0,14853,14853,0
Analytics,3750000.0,USA,2,5,386,13514,13900,0
Advertising|Internet|Services,2000000.0,USA,1,1,0,12437,12437,0
Games|Social Games,700000.0,USA,3,3,577,15340,15917,0
Advertising|Marketplaces|Media,18000000.0,USA,3,7,1434,13397,14831,0
Web Hosting,8400000.0,ISR,3,6,2093,13187,15280,1
Apps|Information Technology|Mobile|Public Transportation|Startups|Transportation|Travel|Travel & Tourism,7000000.0,GBR,2,5,582,15992,16574,0
Biotechnology,63259984.0,USA,5,10,3093,13587,16680,0
Finance|Financial Services|Risk Management,15000000.0,USA,1,4,0,13065,13065,1
Digital Entertainment|Mobile|Social Media,750000.0,USA,1,9,0,16149,16149,0
Education,155376.070217271,BGR,4,4,334,16314,16648,0
Analytics|Big Data|Curated Web|Reputation,4700000.0,USA,2,12,702,15552,16254,0
Analytics,1000000.0,USA,1,1,0,16029,16029,0
Analytics|Big Data Analytics|CRM|Customer Support Tools,150000.0,GBR,1,1,0,16167,16167,0
Big Data Analytics|Cloud Computing|Cloud Data Services|Embedded Hardware and Software|Innovation Engineering|Internet of Things|Location Based Services|Radical Breakthrough Startups|Smart Building|Social Innovation|Social Network Media|Wireless,16390.0,NLD,1,1,0,16529,16529,0
Cloud Data Services|Intellectual Property|Software,350000.0,USA,1,1,0,16307,16307,0
Hardware + Software,2627533.0,USA,5,4,1111,14838,15949,0
Manufacturing|Mobile|Sports,7500.0,USA,1,1,0,16205,16205,0
Apps|Finance|Services,40000.0,CHL,1,1,0,16222,16222,0
Advertising|Networking|Wireless,68536.0,ITA,1,1,0,16206,16206,0
Enterprise Software|Natural Language Processing|Search|Visualization,7658779.53398283,GBR,5,6,2618,12326,14944,0
Gift Card|Mobile,4250000.0,USA,2,4,464,14123,14587,0
Information Services|Tracking|Venture Capital,1361038.0,PRT,1,1,0,16219,16219,0
Software,36700000.0,USA,9,17,2758,13545,16303,1
Advertising,1200000.0,USA,1,5,0,14530,14530,0
Clean Technology,5463000.0,USA,3,6,985,15491,16476,0
Biotechnology,1500000.0,ISR,1,1,0,14165,14165,0
Biotechnology,1635240.0,ESP,1,2,0,15024,15024,0
Manufacturing,3000000.0,USA,1,1,0,15608,15608,0
Logistics|Public Transportation|Transportation,50000.0,HUN,1,1,0,15949,15949,0
Health Care,4156262.0,DEU,3,4,1353,14438,15791,0
Health Care,80000000.0,USA,4,17,2700,13462,16162,0
Biotechnology|Pharmaceuticals,40000000.0,USA,1,8,0,13580,13580,1
Software,3000000.0,USA,1,1,0,13500,13500,0
Design|Semiconductors|Sensors,19000000.0,ISR,1,5,0,12459,12459,0
iPhone|Software,1350000.0,USA,2,8,174,15475,15649,0
Biotechnology|Robotics,14370000.0,USA,5,17,813,15672,16485,0
Health Care,385891470.0,USA,10,8,2077,14524,16601,1
Analytics|Cloud Computing|SaaS|Software,37000000.0,USA,3,10,1303,13012,14315,0
Education,3500000.0,CHN,3,3,731,15309,16040,0
Credit|Mobile,3000000.0,USA,1,1,0,14531,14531,0
Cars|Collaborative Consumption|Enterprise Software|Marketplaces|Navigation|SaaS|Travel,611000.0,NZL,3,2,2649,13896,16545,0
Consumers|Finance|Financial Services|FinTech|P2P Money Transfer|Small and Medium Businesses|Virtualization,90372075.0,GBR,5,24,1273,15187,16460,0
Crowdsourcing|Curated Web|Local|SaaS|Services|Translation,3288300.0,FIN,3,1,911,15187,16098,0
Software,2500000.0,USA,1,1,0,13000,13000,1
Games,500000.0,CAN,1,1,0,14511,14511,1
Biotechnology|Health Diagnostics,13789760.0,USA,4,1,1281,15352,16633,1
Nonprofits,85000.0,USA,1,2,0,16375,16375,0
Clean Technology,565000.0,SWE,2,5,577,13462,14039,0
Crowdsourcing|Developer Tools|SaaS|Translation,6500000.0,USA,2,8,378,16245,16623,0
Enterprise Software|Networking|Search,589850.0,DEU,1,1,0,13149,13149,0
Commercial Real Estate|Displays|Internet of Things|Public Transportation|SaaS|Software|Transportation,675000.0,USA,2,1,177,16329,16506,0
Biotechnology,41800000.0,CAN,2,2,294,15933,16227,1
Software,10000000.0,USA,1,2,0,12115,12115,1
Web Tools,120000.0,USA,1,2,0,16405,16405,0
Public Transportation,19026410.0,USA,2,1,818,14096,14914,0
Software,2900000.0,JPN,2,3,207,16146,16353,0
Software,7300000.0,USA,1,1,0,16307,16307,0
Health Care|Medical Devices,158178559.0,USA,10,28,4255,12444,16699,0
Analytics|Big Data|Business Intelligence|Logistics|Predictive Analytics|Shipping|Transportation,670000.0,BGR,2,1,0,16216,16216,0
Brand Marketing|Sales and Marketing|Software,450000.0,ISL,1,1,0,14942,14942,0
Music|SaaS|Software,125800.0,GBR,1,1,0,15370,15370,0
Web Hosting,4780000.0,SWE,1,1,0,13202,13202,1
Biotechnology,33200000.0,USA,1,12,0,12478,12478,1
Clean Technology,32000000.0,USA,2,4,1996,13656,15652,0
Software,12050000.0,USA,2,4,835,12860,13695,0
Accounting|Comparison Shopping|Credit Cards|E-Commerce|Financial Services|Payments|Startups,1835000.0,USA,4,8,256,14730,14986,1
Electronics|Manufacturing,20000000.0,USA,1,2,0,11743,11743,0
Mobile,19540002.0,USA,4,14,1045,13717,14762,1
Biotechnology,18000000.0,ISR,1,7,0,13353,13353,0
Clean Technology,221200001.0,USA,9,16,1874,14734,16608,0
Software,1500000.0,USA,1,3,0,16566,16566,0
Biotechnology,74500000.0,USA,2,4,2678,12090,14768,0
Semiconductors,2729500.0,USA,2,1,12,15939,15951,0
Biotechnology|Medical|Therapeutics,20000000.0,USA,2,11,902,12916,13818,0
Security|Wireless,61120000.0,USA,3,17,515,12873,13388,1
Content Discovery|Curated Web|Enterprise 2.0|Marketing Automation|Personalization|Social Media Marketing,20116592.0,USA,5,4,1518,14895,16413,0
Games,1877403.17120592,FIN,2,6,400,16371,16771,0
Information Technology|Travel & Tourism,792460.0,ESP,1,2,0,16477,16477,0
Computer Vision,14000000.0,USA,2,6,206,16420,16626,0
Clean Technology|Recycling,17000.0,USA,1,1,0,15584,15584,0
Life Sciences,150000.0,USA,1,1,0,13920,13920,0
Travel & Tourism,10500000.0,DEU,2,3,334,16010,16344,0
Biotechnology,7500000.0,USA,1,2,0,13356,13356,0
Online Travel|Social Travel|Travel,138000.0,NOR,4,1,220,16108,16328,0
Mobile,100000.0,USA,2,1,168,15656,15824,0
Curated Web|Events|Hotels|Mobile Payments|Online Scheduling|Online Travel|Price Comparison|Social Travel|Travel,2215000.0,USA,4,14,846,15706,16552,0
Travel,30500000.0,USA,3,2,2848,12053,14901,1
Analytics,107955.0,ITA,2,3,479,16048,16527,0
Customer Service|Technology|Travel,15000000.0,USA,1,6,0,12773,12773,0
Consumer Goods,25000.0,USA,1,1,0,16191,16191,0
Apps|Travel,40000.0,USA,2,1,233,16293,16526,0
Travel,5000000.0,RUS,1,1,0,16052,16052,1
Mobile|Online Travel|Travel,500000.0,USA,1,1,0,16283,16283,0
Travel,12500000.0,RUS,3,6,616,15645,16261,0
Curated Web|Hotels|Travel,10000.0,USA,1,1,0,15775,15775,1
E-Commerce|Online Travel|Travel & Tourism,2000000.0,NGA,1,1,0,16755,16755,0
Travel,40891652.0,NLD,2,1,238,16155,16393,0
Customer Service|Services|Technology,4500000.0,TUR,1,7,0,16581,16581,0
Travel,1000000.0,ARE,1,2,0,15747,15747,0
Career Planning|Curated Web|Transportation|Travel,15000000.0,IND,1,2,0,13481,13481,1
Marketplaces|Travel & Tourism,870000.0,USA,1,6,0,16694,16694,0
Marketplaces|Online Shopping|Software,1000000.0,IND,3,5,782,15982,16764,0
Internet|Travel,7100000.0,RUS,4,4,2266,13149,15415,0
Collaborative Consumption|Real Estate|Travel|Vacation Rentals,1000000.0,SGP,1,1,0,15621,15621,1
Travel,5600000.0,USA,3,4,762,13634,14396,1
Online Reservations|Ticketing|Travel,200000.0,SGP,1,1,0,15601,15601,0
Mobile,813000.0,CHN,1,1,0,16303,16303,0
E-Commerce|Local Based Services|Personalization|Travel|Travel & Tourism,9900000.0,USA,3,7,1062,15492,16554,0
E-Commerce,11660000.0,HKG,3,1,365,14610,14975,0
Biotechnology,7000000.0,USA,2,4,428,13913,14341,0
Biotechnology,100000.0,USA,1,2,0,16230,16230,0
Web Hosting,8500000.0,USA,1,4,0,12828,12828,1
Leisure|Travel|Travel & Tourism,343554.0,DEU,2,3,89,16570,16659,0
Big Data|Big Data Analytics|Business Analytics|Cloud Data Services|Consulting|Finance Technology|FinTech|Logistics|SaaS|Software|Supply Chain Management,15000000.0,USA,2,2,1871,13879,15750,1
Logistics,1646066.44987362,FRA,1,1,0,16743,16743,0
Loyalty Programs|Social Media|Tracking|Travel|Web Development,5740000.0,USA,2,3,481,15492,15973,0
B2B|Business Services|Finance|Payments,19000000.0,DEU,2,7,819,15517,16336,1
Browser Extensions|Cloud Computing|Software|Utilities,2800000.0,GBR,2,10,896,15645,16541,0
Biotechnology,9007512.0,USA,4,2,2053,13901,15954,0
Social Media,40000.0,CHL,1,1,0,15663,15663,0
Analytics|Big Data|Cloud Computing|Software,35050000.0,USA,5,15,1069,15611,16680,0
Big Data|Business Intelligence|Cloud Computing|Enterprise Software|Payments|SaaS|Software,5539808.0,DEU,1,2,0,16191,16191,0
Biotechnology,1003918.0,PRT,1,1,0,15911,15911,0
Curated Web,5400000.0,USA,1,1,0,15083,15083,0
Gift Registries|Location Based Services|Restaurants|Social Commerce,150000.0,USA,1,1,0,15156,15156,1
Health Care,372090.0,GBR,1,1,0,16514,16514,0
Big Data|Health and Wellness|Health Care|Health Care Information Technology|Natural Language Processing|Neuroscience|Pharmaceuticals|Social Media,14500000.0,ISR,1,5,0,15818,15818,0
Health Care|Health Care Information Technology|Mobile Health|Social Media,25000.0,USA,2,2,459,15638,16097,0
Agriculture|SaaS,2615209.0,DEU,1,1,0,16387,16387,0
Automotive|E-Commerce|Finance|Social Commerce,4500000.0,USA,5,14,1402,15187,16589,0
Hospitality,6000000.0,IND,1,2,0,16609,16609,0
Communications Infrastructure|Gps|Marketing Automation,565000.0,USA,2,3,75,15645,15720,0
Android|EdTech|Education|iOS|Web Design|Web Development,12350000.0,USA,3,11,541,15264,15805,0
Retail,16000000.0,USA,1,1,0,16653,16653,0
Hardware|Mobile,2550000.0,USA,1,1,0,13787,13787,0
All Students|EdTech|Education|High Schools|Personalization|Social Media,7600000.0,USA,3,7,1642,14853,16495,0
Business Services|Collaboration|Enterprise Software|SaaS|Software,304818.0,ESP,3,3,516,16010,16526,0
Analytics|Finance|Stock Exchanges,2130000.0,USA,2,4,578,14184,14762,0
Finance,24120000.0,ARG,4,4,1498,9496,10994,1
SaaS|Software|Tourism|Travel,3432290.0,CHE,4,15,625,15931,16556,0
Curated Web|Delivery|Restaurants,447240.0,LKA,3,2,852,15562,16414,0
Enterprise Software,8800000.0,CAN,3,5,1470,12793,14263,1
Biotechnology,21950708.0,USA,3,4,1729,13558,15287,0
Apps|Project Management,10300000.0,USA,1,3,0,16275,16275,0
Real Estate|Services|Technology,18000.0,USA,1,1,0,16600,16600,0
Biotechnology,3750000.0,USA,2,1,73,15796,15869,0
Software,10510000.0,GBR,1,4,0,12845,12845,1
Advertising|Digital Media|Online Video Advertising,116400000.0,USA,8,20,2021,13208,15229,1
Analytics,40000.0,USA,3,4,721,15729,16450,0
Communities|Social Media|Tourism,30000.0,CAN,1,1,0,16495,16495,0
Games,40000.0,CHL,1,1,0,15911,15911,0
Software,20100000.0,USA,4,14,799,15938,16737,0
Advertising,29702.0,CAN,1,1,0,15826,15826,0
Analytics|Governments|Politics,200000.0,USA,1,2,0,15873,15873,0
Events|Messaging|Mobile|Private Social Networking|Professional Networking,110000.0,CAN,1,1,0,15949,15949,0
Financial Services,1000000.0,CHE,1,1,0,16252,16252,0
Consumer Goods|Fashion|Online Shopping,4000000.0,RUS,1,3,0,15737,15737,0
Fashion,90000.0,ARG,3,3,352,14975,15327,0
Business Intelligence|Mobile,125000.0,USA,2,2,213,15187,15400,1
E-Commerce|Fashion|Mobile,1000000.0,DEU,1,4,0,16069,16069,0
Fashion,1200000.0,USA,2,6,116,16619,16735,0
Fashion,200000000.0,CHN,1,1,0,15383,15383,0
E-Commerce|Fashion|Shopping,36940188.0,TUR,3,3,364,14813,15177,0
Design|Discounts|E-Commerce|Identity,182300.0,MEX,2,2,113,16041,16154,0
Design|Designers|Fashion|Marketplaces|Retail,270862.0,ESP,1,1,0,16233,16233,0
Software,10000000.0,USA,1,1,0,13609,13609,1
Clean Technology,12000000.0,USA,1,1,0,15336,15336,0
Brand Marketing|Games|Marketing Automation|Mobile Advertising,8999985.0,USA,4,5,995,15544,16539,0
Cloud Security|Collaboration,4700000.0,HUN,2,7,851,15340,16191,0
Consumer Behavior|Employer Benefits Programs,4000000.0,USA,1,2,0,12573,12573,1
Biotechnology,174000000.0,USA,5,9,2440,13939,16379,1
Biotechnology|Health Diagnostics,4400000.0,USA,1,1,0,15967,15967,0
Biotechnology,47564102.0,USA,3,3,751,15692,16443,0
Energy|Energy Management|Technology,40000000.0,USA,2,5,2121,13654,15775,0
E-Commerce,277226267.0,USA,12,22,2695,13657,16352,0
Software,887000.0,CAN,1,1,0,13447,13447,1
Software,2100000.0,USA,1,3,0,13633,13633,0
Semiconductors,14000000.0,USA,2,1,1592,15132,16724,0
Business Services|Collaboration|Finance,320000.0,USA,1,1,0,16526,16526,0
Enterprise Software|Productivity Software|SaaS,1000000.0,USA,1,5,0,16213,16213,0
Medical,10000000.0,USA,1,5,0,12284,12284,0
Bio-Pharm|Pharmaceuticals|Software,8425730.0,SWE,3,3,1292,15222,16514,0
Advertising|Payments,58900000.0,USA,4,22,1875,13495,15370,1
Clinical Trials|Health and Wellness|Health Care|Health Care Information Technology|Internet|Pharmaceuticals|Search,17900000.0,GBR,3,6,1196,15275,16471,0
Clinical Trials,10000000.0,USA,1,3,0,16225,16225,0
Curated Web,1500000.0,USA,2,3,134,14683,14817,0
Games|Kids|Virtual Worlds,2493889.0,CAN,1,2,0,14350,14350,0
Social Media,9350000.0,USA,2,6,821,12382,13203,1
Internet|Productivity Software|Software,300000.0,USA,1,2,0,16622,16622,0
Human Resources|SaaS|Social Media|Software,3500000.0,CAN,2,3,371,15182,15553,1
Recruiting|Social Media,560000.0,SGP,2,4,391,15398,15789,0
Hardware + Software,1600000.0,IND,1,1,0,13917,13917,0
Software,3400000.0,USA,1,3,0,16226,16226,0
Manufacturing|Material Science|Medical Devices|Mining Technologies|Oil & Gas|Recycling,19700000.0,USA,3,7,1288,15313,16601,0
Software,28120000.0,GBR,3,7,1293,12965,14258,1
Manufacturing,15980000.0,USA,2,4,766,13014,13780,0
Software,24100000.0,USA,1,1,0,14914,14914,0
News,5500000.0,USA,2,2,528,13910,14438,1
Software,3282000.0,USA,1,2,0,16660,16660,0
Health Diagnostics|Medical,18100000.0,USA,2,5,195,16268,16463,0
Biotechnology|Health Diagnostics,3000000.0,USA,1,2,0,16036,16036,0
Biotechnology|Pharmaceuticals,44514244.0,USA,3,6,398,16100,16498,0
Enterprise Software,40100000.0,USA,4,20,1778,12828,14606,1
Clean Technology|Design|SaaS|Simulation|Software|Sustainability,2175000.0,USA,5,5,2557,11688,14245,0
Clean Technology,668048.0,GBR,2,3,120,15666,15786,0
Software,41300000.0,USA,3,10,602,15617,16219,0
Biotechnology,5204967.0,USA,3,1,1272,14601,15873,0
Software,15100000.0,USA,4,5,1377,12173,13550,1
Enterprise Software|Mobile,1604400.0,USA,5,16,1477,13879,15356,0
Apps|Software,2600000.0,CAN,2,3,336,16162,16498,0
Advertising|Email Marketing|Finance|Marketing Automation|Software,28219452.0,USA,4,7,974,15797,16771,0
Android|Hardware|Hardware + Software|iOS|Mobile|Photography,77000.0,GBR,3,1,1230,15186,16416,0
Advertising|Auctions|Internet,18450000.0,USA,5,7,2268,13573,15841,1
Distributors|Information Technology|Retail Technology|Software,26000000.0,USA,2,9,784,11540,12324,1
Design|Interior Design|Internet,1442676.0,ESP,3,1,397,15368,15765,0
Internet|Lifestyle|Mobile|Social Network Media,800000.0,USA,1,5,0,16344,16344,0
Mobile,7700000.0,USA,2,3,1917,13879,15796,0
Hardware + Software|Smart Grid,146000000.0,USA,3,13,854,14110,14964,0
Crowdfunding,825207.0,GBR,1,1,0,16555,16555,0
Travel,100000.0,ITA,1,1,0,15765,15765,0
Healthcare Services,26000000.0,USA,1,3,0,12542,12542,0
Automotive|Semiconductors|Sensors,18250000.0,USA,4,8,1586,14883,16469,0
Health Care|Services|Therapeutics,6087761.16495398,USA,1,2,0,12955,12955,0
Hardware + Software,8281830.0,BEL,2,6,1288,14169,15457,0
Biotechnology,30000000.0,USA,3,11,2606,11955,14561,0
Real Estate,13000000.0,USA,1,1,0,15982,15982,0
Developer Tools|Education|K-12 Education,425000.0,USA,2,1,2,15945,15947,0
Biotechnology|Health and Wellness|Health Care|Therapeutics,11579400.0,IRL,1,2,0,15853,15853,0
Clean Technology,8362900.0,NLD,1,1,0,15875,15875,0
Games,185000000.0,USA,3,16,1655,13703,15358,0
Content|Curated Web|Publishing|Social Media,1500000.0,USA,1,1,0,14278,14278,0
Financial Services|Innovation Management|Payments,3000000.0,IND,1,1,0,16423,16423,0
Apps,1000000.0,IND,1,2,0,16488,16488,0
E-Commerce|Startups|Tourism|Travel,3137564.0,ESP,4,6,1109,15522,16631,0
Travel,850000.0,AUS,1,1,0,16587,16587,0
Services,1100000.0,USA,1,1,0,16651,16651,0
Social Travel|Travel,740000.0,SWE,1,7,0,15419,15419,0
Artificial Intelligence|Search|Travel,2000000.0,USA,2,4,459,15257,15716,1
Travel,1000000.0,USA,1,1,0,13403,13403,0
Apps|Cars|Curated Web|Insurance|Online Rental,40000.0,NOR,1,1,0,16029,16029,0
Ride Sharing|Transportation|Travel,11000000.0,BRA,2,2,273,16191,16464,0
Career Planning|Curated Web|Travel,50000.0,USA,1,1,0,15804,15804,1
Travel,10000000.0,IND,1,3,0,16647,16647,0
Social Media|Travel,13100000.0,USA,3,6,1046,13626,14672,1
Location Based Services|Networking|Social Media|Travel,900000.0,USA,4,4,446,15114,15560,0
Enterprise Software,16000000.0,USA,2,4,958,15574,16532,0
Advertising,16625000.0,USA,4,20,1247,15350,16597,0
Startups,3000000.0,USA,1,30,0,16706,16706,0
Hospitality|SaaS|Sales and Marketing,750000.0,USA,1,2,0,14953,14953,0
Apps|EdTech|Education|Enterprise Software|Language Learning|Mobile|Travel,2349768.0,USA,6,3,1262,15131,16393,0
Doctors|Health Care|Healthcare Services|Medical,45000.0,IND,1,1,0,16428,16428,0
Travel,1001552.0,FRA,1,4,0,16377,16377,0
Travel|Vacation Rentals,1250000.0,USA,1,1,0,13514,13514,0
Travel,6000000.0,USA,2,6,977,14121,15098,0
Curated Web|Media|Mobile|Social Media|Social Travel|Travel,82112946.0,JPN,4,2,813,15110,15923,0
Android|Apps|iPhone|Location Based Services|Social Media|Social Network Media|Travel,150000.0,ARE,1,1,0,16071,16071,0
Hospitality|Networking|Software|Technology|Travel|Vacation Rentals,17000000.0,USA,3,20,1478,15166,16644,0
Travel,5250000.0,USA,2,7,896,15293,16189,0
Hotels|Tourism|Travel,762269.0,DEU,1,1,0,16523,16523,0
Travel,50230.0,GBR,1,1,0,10957,10957,0
Content|Enterprise Software|Hotels|Social Media|Travel,4270000.0,GBR,5,2,780,15705,16485,0
All Students|Hospitality|Social Network Media|Travel|Web Hosting,2100000.0,USA,4,11,509,14973,15482,0
Photography|Travel,269169.0,KOR,1,1,0,15944,15944,0
Adventure Travel|Tourism|Travel & Tourism,1000000.0,IDN,2,2,440,16310,16750,0
Cyber Security|Information Security|Security|Software|Software Compliance,8301265.0,USA,2,7,2235,12242,14477,1
Startups|Travel,2500000.0,AUT,2,3,752,13514,14266,0
Health Care,57554997.0,USA,4,6,1869,13802,15671,0
Biotechnology,10000000.0,USA,2,1,649,15952,16601,0
Sports|Technology|Wearables,1000000.0,CAN,1,5,0,16450,16450,0
Curated Web,1300000.0,JPN,2,3,819,15371,16190,0
Business Services|Innovation Management|Services,350000.0,USA,1,1,0,15710,15710,0
Energy Efficiency|Enterprises|Security|Software,6750000.0,USA,2,4,3087,13209,16296,0
Biotechnology|Health Care,69325793.0,USA,3,4,1560,13572,15132,1
Hotels|Technology|Travel,1140000.0,DEU,1,1,0,13892,13892,0
Health Care|Medical Devices,266950270.0,USA,7,29,2699,13969,16668,1
Lead Generation|Mobile Software Tools|Software|Surveys,591966.0,SWE,3,2,659,15988,16647,0
Clean Technology|Consulting,18679648.0,SWE,1,2,0,15128,15128,0
App Stores|Consumer Electronics|Games|iPad,40000.0,USA,1,1,0,15160,15160,0
Manufacturing,25000000.0,USA,1,12,0,12024,12024,0
Biotechnology,95500000.0,IND,3,3,2230,13819,16049,0
E-Commerce,18000000.0,ISR,2,9,2992,10935,13927,1
Content|Games|Social Media|Television,90077.0,ITA,2,3,569,15371,15940,0
Software|Startups|Wealth Management,3000000.0,USA,2,1,184,16377,16561,0
Content Discovery|E-Commerce|Home Decor|Mens Specific,190000.0,USA,2,2,563,15908,16471,0
Mobile,1100000.0,BRA,2,4,281,16385,16666,0
Health Care,6111350.0,FRA,1,4,0,16003,16003,0
Web Hosting,27400000.0,USA,2,10,777,12201,12978,1
Clean Technology|Renewable Energies,20000000.0,CHN,1,1,0,14180,14180,0
Cars|Curated Web|DOD/Military|Real Estate,6748692.0,USA,5,8,592,15152,15744,0
Charities|Gift Registries|Internet,15000.0,USA,1,1,0,16165,16165,0
Analytics,2899980.0,USA,2,1,154,14764,14918,0
Enterprise Software,86000000.0,CAN,3,20,839,12090,12929,1
Career Planning|Enterprise Software|Software,33850000.0,GBR,3,11,1728,12797,14525,1
Insurance|Mobile|Software,13475000.0,USA,4,2,1045,15530,16575,0
Biotechnology|Health Diagnostics,25358200.0,USA,3,2,826,15426,16252,0
Business Services|Freelancers|Marketplaces,40000.0,CHL,1,1,0,15677,15677,0
Analytics|Big Data|Business Intelligence|Predictive Analytics|Smart Grid|Software,10700000.0,USA,3,2,1384,15105,16489,0
Marketplaces|Mobile Commerce,640000.0,USA,1,2,0,16716,16716,0
3D Printing|Consumer Internet|E-Commerce,640000.0,USA,1,2,0,16716,16716,0
Curated Web|Open Source|Photography|Photo Sharing,759000.0,USA,3,2,719,15168,15887,0
Photography,2500000.0,USA,1,4,0,15911,15911,0
Cars|Classifieds|Employment|Home & Garden|Search|Vertical Search,871000.0,ESP,1,1,0,15050,15050,1
Consulting|Search,18250000.0,USA,2,5,273,13124,13397,1
Advertising|Analytics|Big Data|Cloud Computing|Digital Media|Entertainment|Media|Real Time|SaaS|Social Media|Technology,1700000.0,USA,1,4,0,16707,16707,0
Biotechnology|Health Services Industry,55600000.0,USA,3,6,2649,11839,14488,1
E-Commerce|Health and Wellness|Specialty Foods|Startups|Subscription Businesses,1400000.0,USA,2,7,526,16036,16562,0
Crowdsourcing|Logistics|Marketplaces|Mobile|Navigation|Transportation,21500000.0,USA,3,3,302,16314,16616,0
Building Products|Commercial Real Estate|Services,14500000.0,USA,2,2,1,12324,12325,0
Logistics|Logistics Company|Services,10000000.0,IND,1,1,0,16569,16569,0
Enterprises|Enterprise Software|SaaS|Transportation,393671.0,SRB,2,2,340,15856,16196,0
Health Care|Health Care Information Technology|Telecommunications,300000.0,USA,2,1,852,15478,16330,0
Clean Technology,40000.0,CHL,1,1,0,15379,15379,0
Fashion|Online Shopping,6000000.0,USA,4,18,740,15431,16171,0
Big Data|Brand Marketing|E-Commerce|Online Shopping|Personalization|Retail Technology,21846036.0,USA,4,15,1424,14798,16222,0
Finance|Fraud Detection|Senior Citizens,3400000.0,USA,3,12,691,15765,16456,0
Software,3250000.0,USA,1,1,0,13732,13732,0
Biotechnology,97000000.0,USA,3,11,534,16238,16772,0
Analytics|Apps|Banking|Financial Services|FinTech|Games|Gamification|Health Care|Law Enforcement|Legal|Pharmaceuticals|Risk Management|Training,3000000.0,USA,1,3,0,15729,15729,1
Apps|Contact Management|Search,80100000.0,SWE,4,11,1029,15322,16351,0
Certification Test|Enterprise Software|Linux|Skill Assessment|Training,2750000.0,USA,2,8,270,15645,15915,0
Finance Technology|FinTech,5250000.0,USA,3,9,652,15706,16358,0
Big Data Analytics|Optimization|Social Media Platforms,4205104.0,USA,2,2,735,15946,16681,0
Automotive,500000.0,IND,1,2,0,16587,16587,0
Automotive|Public Transportation,283165000.0,USA,7,26,3209,12842,16051,1
Software,16700000.0,USA,3,8,939,12997,13936,1
E-Commerce|Jewelry|Marketplaces,13499935.0,USA,4,9,386,16283,16669,0
Analytics,1200000.0,USA,1,9,0,15677,15677,0
Security,14535000.0,ITA,1,1,0,15198,15198,0
Mobile|Online Dating|Social Media,608167.0,GBR,3,3,487,15553,16040,0
Advertising|Online Video Advertising,49850000.0,USA,5,15,2363,13848,16211,1
Analytics,10900000.0,USA,2,2,300,16043,16343,0
Android|Curated Web|iOS|Mobile|Recruiting|Software,34623.0,BRA,2,1,546,15645,16191,0
Health and Wellness,10549151.0,USA,1,1,0,15709,15709,0
Big Data Analytics|Education|Health Care Information Technology|Software,892500.0,USA,2,6,234,15838,16072,0
Humanitarian|Human Resources|Software,4700000.0,USA,2,2,1099,13083,14182,1
Agriculture|Farming|Organic Food,2171929.0,CAN,3,2,1271,15429,16700,0
Marketplaces|Mobile|Peer-to-Peer|Real Estate,255100000.0,USA,5,14,3030,13027,16057,1
Big Data|Finance Technology|Financial Services|FinTech|Identity|Online Identity|SaaS|Security|Software Compliance|Trusted Networks,8300000.0,CAN,4,6,1530,14610,16140,0
Enterprise Software,1400000.0,USA,2,10,595,15826,16421,0
Direct Sales|E-Commerce|Fashion|Retail,8400000.0,USA,3,15,959,15628,16587,0
Software,8000000.0,USA,1,3,0,13108,13108,0
FinTech,33250000.0,USA,2,3,237,16498,16735,0
Mobile,40000.0,CHL,1,1,0,16052,16052,0
Mobile Commerce|Mobile Payments|Telecommunications,8800170.0,CHN,1,1,0,14651,14651,1
FinTech,5300000.0,BMU,2,8,584,16102,16686,0
Pets,9000000.0,USA,1,2,0,15322,15322,1
Android|Apps|iPad|iPhone|iPod Touch|Mobile|VoIP,56796093.6476219,GBR,2,8,464,13522,13986,0
Market Research|Payments|Services,4351489.42524077,GBR,1,1,0,16375,16375,0
Curated Web,28190107.0,USA,4,14,323,16035,16358,0
Mobile,23500000.0,USA,3,11,1363,13091,14454,1
Advertising,500000.0,USA,1,1,0,15309,15309,0
E-Commerce|Mobile Commerce|Retail|Reviews and Recommendations|Technology,310473.0,GBR,1,1,0,14975,14975,0
Software,2826000.0,NLD,1,1,0,14441,14441,0
Cyber Security|Security,2000000.0,USA,1,1,0,16755,16755,0
Collaborative Consumption|Enterprise Software|Identity|Trusted Networks,600000.0,USA,2,2,1673,14610,16283,0
Enterprise Software|Privacy,37000000.0,USA,3,10,1287,14075,15362,0
Consumers,930000.0,USA,1,1,0,15755,15755,0
Curated Web|Finance|FinTech|Hedge Funds|Private Social Networking|Venture Capital,5200000.0,USA,3,16,1818,14751,16569,0
Advertising|Social Commerce,300000.0,USA,1,1,0,15491,15491,0
Curated Web|Reputation,1000000.0,MYS,1,3,0,16327,16327,0
Security,25000000.0,USA,4,7,1587,13057,14644,1
Local Advertising|Networking|Social Media,1000000.0,GBR,1,1,0,13570,13570,1
Banking|Security,10100000.0,USA,2,3,720,13453,14173,1
Social Media,1150000.0,USA,2,11,669,15390,16059,0
E-Commerce|Fraud Detection|Security|Software,7826121.0,IRL,5,17,867,15750,16617,0
Security,1500000.0,USA,2,5,577,14975,15552,1
IT and Cybersecurity|Mobile|Mobile Security|Software,3000000.0,USA,3,2,642,15675,16317,0
E-Commerce|Finance|FinTech|Payments,28751437.0,SWE,1,1,0,16378,16378,0
Curated Web|Identity|Reputation|Trusted Networks,11000.0,USA,2,2,53,15081,15134,0
Curated Web|Reputation|Reviews and Recommendations,116900000.0,DNK,5,16,1581,15002,16583,0
Crowdsourcing|Reviews and Recommendations,5000000.0,USA,1,1,0,15901,15901,0
Cyber Security|Information Security|IT Management|Risk Management|Security,10000000.0,USA,1,1,0,12557,12557,1
Hospitality,5000000.0,USA,1,1,0,15237,15237,0
Mobile|Software,14500000.0,GBR,3,2,638,13057,13695,0
Messaging|Mobile,45180.0,USA,1,1,0,16161,16161,0
Manufacturing|Test and Measurement,26025507.0,USA,9,13,2921,13088,16009,0
Analytics|Health Care Information Technology|Hospitals,1350000.0,USA,2,2,1014,15496,16510,0
Health Care|SaaS,26550000.0,USA,3,9,1241,15006,16247,0
Analytics|Business Intelligence|Internet,3000000.0,USA,1,3,0,14445,14445,1
Subscription Service|Travel,25000.0,USA,1,1,0,16468,16468,0
DOD/Military|Location Based Services|Maps|Navigation|Security|Software,2500000.0,USA,3,4,1122,15469,16591,0
Consumer Goods|E-Commerce|Specialty Foods|Subscription Businesses|Technology|Travel & Tourism,3000000.0,USA,2,9,416,16302,16718,0
Brand Marketing|DIY|Project Management|SaaS,320000.0,USA,4,1,576,16071,16647,0
Games,226609.0,GBR,1,1,0,15561,15561,0
Mobile|Specialty Foods,29000000.0,USA,2,12,135,16379,16514,0
Educational Games|Knowledge Management|Self Development,454759.0,MEX,4,4,609,15309,15918,0
Health Care,86267224.0,USA,4,10,1455,14866,16321,0
Customer Service|Public Relations|Retail,200000.0,GBR,1,2,0,16289,16289,0
Analytics|Technology|Tracking,200000.0,IND,1,3,0,16581,16581,0
Entertainment,235000000.0,USA,1,1,0,16748,16748,0
Software,15000000.0,USA,1,1,0,16713,16713,0
Security,6084330.0,GBR,1,1,0,12990,12990,0
Development Platforms,500000.0,JPN,1,1,0,16262,16262,0
Biotechnology,880895.0,GBR,1,1,0,15675,15675,0
Software,54725551.0,AUT,1,3,0,16519,16519,0
Analytics|Big Data|Search,2455000.0,USA,2,3,243,15828,16071,0
Android|Cloud Computing|Local|Mobile|VoIP,1250000.0,USA,2,7,761,13453,14214,0
Mobile|Video,90000.0,USA,1,1,0,14488,14488,0
Advertising|Analytics|Content Syndication|Internet|Online Video Advertising|Software|Video,136057047.0,USA,8,20,2796,13801,16597,1
Film,6000000.0,USA,1,7,0,16761,16761,0
Enterprise Software,40000.0,USA,1,1,0,15440,15440,0
Analytics|Enterprises|Video,21770374.0,USA,5,20,936,15616,16552,0
Software,1000000.0,CAN,1,1,0,14684,14684,0
Enterprise Software,2904978.0,KOR,1,2,0,16191,16191,0
Fashion,3077011.0,USA,2,1,1331,15379,16710,0
E-Commerce,40000.0,CHL,1,1,0,15538,15538,0
Photography,126000000.0,CHN,5,16,1916,13279,15195,1
Analytics,390000.0,USA,5,3,729,15775,16504,1
Mobile|Social Network Media,12004200.0,ESP,1,1,0,14692,14692,1
Information Technology|Security|Software,32500000.0,USA,4,6,1219,15194,16413,0
Application Platforms|Automotive|Services,100000000.0,CHN,1,5,0,16658,16658,0
Education|Finance|Financial Services|Personal Finance,8150000.0,USA,5,28,1051,15706,16757,0
Advertising,585576.0,PRT,1,1,0,15859,15859,0
Travel,455000000.0,CHN,4,15,1174,15476,16650,0
E-Commerce|Mobile|Retail|Retail Technology,2400000.0,CAN,1,13,0,15981,15981,0
E-Commerce,130000.0,USA,5,2,597,15614,16211,0
Finance,1500000.0,KOR,2,4,326,16276,16602,0
Blogging Platforms|Curated Web|Opinions,125250000.0,USA,6,21,1523,13817,15340,1
Delivery|Logistics,140000.0,CHL,3,4,638,15706,16344,0
Music,524320.0,SWE,2,2,23,15860,15883,0
Advertising|Analytics|App Marketing|Data Visualization|Mobile|Performance Marketing,36400000.0,USA,2,5,618,15846,16464,0
Music,7000000.0,USA,1,1,0,14178,14178,1
Apps|B2B|Brand Marketing|Content|Digital Entertainment|Internet Marketing|Loyalty Programs|Monetization|Music|Music Services,5100000.0,AUS,1,1,0,16652,16652,0
Guides|Mobile|Music,50152231.0,USA,6,12,3528,12326,15854,0
Internet|Music|Social Media,2000000.0,GBR,1,3,0,16737,16737,0
E-Commerce|Music,15100000.0,USA,1,1,0,10742,10742,1
Games,8525000.0,USA,5,1,1860,14651,16511,0
Music,2600000.0,USA,4,3,1056,15584,16640,0
Education|Music,25000.0,USA,3,3,477,15638,16115,0
Music|Software,15600000.0,USA,4,5,639,14383,15022,0
Android|Games|iPhone|Mobile|Music|Web Tools,10000000.0,USA,2,7,678,13970,14648,0
Enterprise Software|Meeting Software|Online Scheduling|Productivity Software|Task Management,6360000.0,CAN,2,6,514,13641,14155,1
Bio-Pharm|Pharmaceuticals|Therapeutics,10000000.0,USA,1,3,0,16708,16708,0
Internet|Leisure|Online Reservations|Travel|Travel & Tourism,695000000.0,CHN,6,13,2259,14304,16563,1
Messaging,350000.0,USA,1,4,0,16161,16161,0
E-Commerce,1602564.0,CHN,1,1,0,15645,15645,0
Curated Web|Lifestyle|Local|Location Based Services|Photography|Reviews and Recommendations|Social Media,101474.0,AUT,4,3,1216,13514,14730,1
Brand Marketing|Customer Service|Customer Support Tools|Internet Marketing,40000.0,ARG,1,1,0,16030,16030,0
Games|Social Games,94600000.0,USA,4,13,2065,12401,14466,1
Manufacturing,62000000.0,USA,2,3,1573,14399,15972,0
Content|Local|Translation,20000.0,GBR,1,1,0,16040,16040,0
Finance|Property Management|Services,2300000.0,USA,2,3,169,16399,16568,0
Games,250000.0,USA,2,3,427,14610,15037,0
Linux|Open Source|Operating Systems|Software|Technology,30000000.0,JPN,1,9,0,11241,11241,0
Mobile,890000.0,USA,2,3,353,15201,15554,0
Service Providers|Telecommunications|Wireless,52500000.0,USA,1,7,0,13644,13644,1
Biotechnology|Pharmaceuticals,90000000.0,USA,1,1,0,16657,16657,0
Consumer Electronics,3000000.0,USA,1,5,0,16757,16757,0
Advertising|Software,163500000.0,USA,8,26,3632,12784,16416,0
E-Commerce,30000.0,USA,1,1,0,16102,16102,0
Application Platforms|Motors|Robotics|Technology,16691.0,FRA,1,1,0,16627,16627,0
Curated Web|Digital Media|Distribution|Film|Video,11750000.0,USA,4,5,2039,13453,15492,0
Design,2918542.0,USA,3,7,1107,15117,16224,0
Travel|Vacation Rentals,10000000.0,USA,3,14,489,15930,16419,0
Biotechnology,11300000.0,USA,1,1,0,16735,16735,0
Music|Social Media,7000000.0,USA,1,11,0,15230,15230,0
Security,750000.0,GBR,1,1,0,12053,12053,1
Games,1000000.0,USA,1,4,0,15155,15155,0
Design|Medical Devices|Nanotechnology,500000.0,USA,2,2,687,14277,14964,0
Entertainment|Events|Leisure|Travel,340000.0,IND,5,3,824,15126,15950,0
Public Relations,21850000.0,USA,2,4,399,12983,13382,0
E-Commerce|Entertainment,50000.0,COL,1,1,0,15553,15553,0
Curated Web|Opinions|Polling,30000.0,GHA,1,1,0,14791,14791,0
Collaboration|E-Commerce|Finance|Financial Services|Social Commerce|Social Media,25000.0,CHL,1,1,0,16130,16130,0
Biotechnology|Genetic Testing|Health Care|Software,7700000.0,USA,3,12,531,16071,16602,0
Collaborative Consumption|Education,1142911.0,ESP,2,3,1009,15349,16358,0
Education,13500000.0,USA,1,1,0,13634,13634,1
Education|Internet|Services|Tutoring,13500000.0,USA,1,4,0,13642,13642,1
Education|Software|Tutoring,25000.0,USA,1,1,0,15106,15106,0
Education|Knowledge Management|Marketplaces|Mobile|Q&A|Tutoring,4375000.0,USA,6,7,1186,15478,16664,0
Social Network Media|Tutoring|University Students,963895.0,ITA,3,3,282,16364,16646,0
Cloud Computing|Education|English-Speaking|Internet|Language Learning,315000000.0,CHN,4,11,1302,15455,16757,0
Education|Finance|Tutoring,12000.0,USA,1,1,0,14670,14670,0
Education|Training|Tutoring|Video,646950.0,DEU,1,1,0,15340,15340,0
EdTech|Education,1800000.0,USA,2,10,426,15328,15754,1
Education,83750000.0,IND,5,8,1565,13311,14876,0
Education|K-12 Education|Online Education|Tutoring,240000.0,COL,1,1,0,16395,16395,0
Apps|Cloud Computing|Developer Tools|Development Platforms|IaaS|PaaS|Software,2715000.0,USA,3,6,523,15778,16301,1
Customer Service,2400000.0,USA,1,4,0,16252,16252,0
Education,430000.0,USA,1,5,0,16275,16275,0
Consulting,31190000.0,USA,3,8,2164,11688,13852,1
Photography|Video,16029334.0,CHN,1,1,0,15492,15492,0
Health and Wellness|Health Care|Health Care Information Technology,27100000.0,USA,3,8,2094,14620,16714,0
Mobile,5100000.0,USA,1,1,0,13263,13263,0
Games|Internet TV|Mobile Video|Television|Video|Video Streaming,6100000.0,ISR,2,5,1344,14284,15628,1
Advertising|Analytics|Market Research,2950000.0,USA,3,2,229,16526,16755,0
Advertising|Android|Apps|iPad|iPhone|Online Reservations|Social Television|Software|Sports|Synchronization|Television,4975007.0,USA,4,1,995,14971,15966,0
Manufacturing,53000000.0,IND,1,1,0,15451,15451,0
Hotels|Travel|Video,13770000.0,FRA,2,5,582,13695,14277,0
Advertising|Apps|Consumer Electronics|Mobile|Retail|Sales and Marketing|Television,6846120.0,FRA,3,6,1437,14775,16212,0
E-Commerce|Internet TV|Media|Peer-to-Peer|Video|Video Streaming,10050071.0,USA,3,3,1603,14153,15756,0
Consulting|Design|Employment|Freelancers|Information Technology|Marketplaces|Outsourcing|Project Management|Recruiting|Service Providers|Small and Medium Businesses|Translation|Web Design,3140960.0,DEU,3,7,1832,14426,16258,0
Software|Twitter Applications,5314960.0,GBR,3,17,504,14245,14749,1
News|Politics|Twitter Applications,164863.0,GBR,1,1,0,14455,14455,0
Curated Web|Facebook Applications|Photography|Photo Sharing|Real Time|Twitter Applications,2600000.0,USA,1,7,0,14712,14712,1
Social Media|Social Television|Television|Twitter Applications,750000.0,USA,1,1,0,15426,15426,1
Events|Social Media|Twitter Applications,165000.0,USA,1,1,0,15431,15431,0
Health Care,71826025.0,USA,6,3,1499,15056,16555,1
Advertising,32902115.0,USA,6,12,1700,13419,15119,0
Advertising|E-Commerce|Lead Generation|Price Comparison|Retail Technology|Search|Social Buying,14771601.0,GBR,2,3,2736,13848,16584,0
Marketing Automation|Mobile|Photography|Photo Sharing|SaaS,9700000.0,USA,4,15,1153,15339,16492,0
Brand Marketing|Sales and Marketing|Search|SEO|Social Media|Web Design,1506.0,GBR,1,1,0,15768,15768,0
Analytics|Big Data Analytics|Demographies|Developer APIs|Facebook Applications|Social Media|Software|Tracking|Twitter Applications|Video Streaming,2000000.0,DEU,1,1,0,15898,15898,1
Apps|Curated Web|Mobile|Social Media|Social Media Marketing|Software,2500000.0,IND,1,1,0,16503,16503,0
Fashion|Online Shopping,23100000.0,USA,3,23,961,15125,16086,1
Education|Kids|Parenting|Publishing,1205000.0,USA,2,15,295,16251,16546,0
Enterprise Software,233700000.0,USA,6,35,2400,14245,16645,0
Big Data|Mobile|Technology,9500000.0,USA,1,4,0,16512,16512,0
Search,1350500.0,SWE,1,1,0,13695,13695,0
Hardware + Software,741000.0,FRA,1,3,0,13934,13934,0
Biotechnology|Health Care Information Technology|Medical,6704285.0,CAN,1,4,0,12111,12111,1
Cloud Computing|Cloud Data Services|Enterprise Software|Storage|Virtualization,19389775.0,USA,5,1,822,14438,15260,1
iPhone|Mobile,6000000.0,USA,2,6,18,15522,15540,0
Biotechnology,82110714.0,USA,4,15,484,16111,16595,0
Games,32250000.0,USA,2,2,619,13149,13768,1
Software,10500000.0,USA,2,3,1238,13420,14658,1
Enterprises|Information Technology|Services,2500000.0,USA,1,1,0,16562,16562,0
Security,3100000.0,USA,1,1,0,16562,16562,0
Broadcasting|Social Media|Video|Video Games|Video Streaming,35000000.0,USA,2,8,376,15602,15978,1
Brand Marketing|Curated Web|Messaging|Twitter Applications,150000.0,USA,1,1,0,14349,14349,1
E-Commerce|Games|Social Media|Twitter Applications|Virtual Goods,500000.0,USA,2,1,292,14683,14975,0
Advertising|E-Commerce|File Sharing|Marketplaces|Search|Social Media|Twitter Applications,2605.0,NLD,1,1,0,14822,14822,0
Information Services|Messaging|MicroBlogging|Service Providers|SMS|Software,1160166511.0,USA,8,36,1530,13695,15225,1
Mobile|Photography,21115154.0,USA,10,21,3059,13514,16573,0
Education|Entertainment|Games,6500000.0,USA,1,3,0,16736,16736,0
Curated Web,162364.0,CHN,1,1,0,15857,15857,0
E-Commerce,2700000.0,USA,2,8,218,16071,16289,0
Games,450000.0,USA,1,1,0,15257,15257,0
E-Commerce,9500000.0,USA,2,5,679,13483,14162,1
Music|Social Network Media|Software|Video Streaming,500000.0,NLD,1,1,0,14061,14061,0
Big Data|Bio-Pharm|Machine Learning|Medical,3400000.0,USA,2,4,202,16556,16758,0
Android|Apps|Gps|iPhone|Local|Location Based Services|Mobile|Mobile Emergency&Health|Security|Services|Tracking,800000.0,BRA,3,4,1187,15065,16252,0
Curated Web|MicroBlogging,25000.0,USA,1,1,0,14421,14421,0
Advertising|Sales and Marketing|Social Media|Social Media Advertising|Twitter Applications,3830000.0,USA,2,7,681,15675,16356,0
Mobile|Psychology,25000.0,USA,1,1,0,15584,15584,0
Social Media,33472800.0,CHN,2,2,1339,13118,14457,0
Biotechnology,70183280.0,FRA,4,14,3482,12692,16174,0
Hardware + Software,1290000.0,FRA,1,1,0,14851,14851,0
Market Research,50000.0,USA,1,2,0,16252,16252,0
Software,2610000.0,GBR,2,4,116,13118,13234,0
Mobile,38484.0,ROM,1,1,0,15798,15798,0
Finance|Financial Services|FinTech|Mobile|PaaS,55350000.0,USA,4,12,1121,13787,14908,1
Career Management|Identity|Recruiting|Social Media,4749335.0,ESP,3,3,749,15645,16394,0
Legal,68000.0,USA,2,2,406,16120,16526,0
Collaboration|Enterprises|Enterprise Software|Freemium|Human Resource Automation|Human Resources|SaaS|Subscription Businesses,163000.0,IND,2,3,930,15358,16288,0
Apps|Entertainment|Mobile Games,120000.0,USA,2,3,7,16251,16258,0
Banking|Cyber|Finance|Mobile|Mobile Security,11900000.0,USA,4,8,2670,13913,16583,0
Analytics|Knowledge Management|SaaS,65070.0,ITA,2,2,364,15342,15706,0
Finance,1830000.0,USA,2,5,217,15027,15244,0
Mobile,1528000.0,USA,3,8,429,15584,16013,0
Health and Wellness|Medical|Medical Devices,990000.0,USA,2,2,1391,11962,13353,1
Audio|Hardware|Hardware + Software,13000000.0,USA,1,1,0,13425,13425,0
Education,3250000.0,USA,1,7,0,15806,15806,0
Messaging,11900000.0,USA,2,7,410,14305,14715,1
Market Research|Software|Surveys,17248650.0,ESP,3,13,742,15953,16695,0
Curated Web,3200000.0,USA,2,9,467,14419,14886,1
Contact Management|Curated Web|Social Media,1938913.0,USA,2,1,0,15979,15979,0
Software,1500000.0,GBR,2,3,0,14549,14549,0
DIY|E-Commerce|Jewelry|Mass Customization|Retail|Sales and Marketing,200000.0,NLD,1,1,0,14791,14791,0
Software,17000000.0,USA,2,6,468,15106,15574,0
Software,415000.0,USA,1,1,0,16610,16610,0
Automotive,3822647.0,GBR,3,5,510,15447,15957,0
Banking|Finance|FinTech|Medical|Payments|Retail|Software,103594390.0,AUS,16,3,4685,12084,16769,0
Biotechnology,19264909.0,USA,3,1,1186,15054,16240,0
Payments|SEO|Social Media|Sports|Startups|Technology,20000.0,USA,1,1,0,15163,15163,0
Biotechnology,20000000.0,USA,1,3,0,14951,14951,1
Travel,85000.0,USA,2,1,177,15161,15338,0
Health Care|Health Care Information Technology|Medical Devices|Mobile Health,18500000.0,ISR,3,11,1108,15522,16630,0
Graphics|Services,22930.0,VEN,1,1,0,16191,16191,0
Advertising,32094.0,KOR,1,1,0,15833,15833,0
Business Services|Intellectual Asset Management|Mobile|Network Security|Retail|RFID,800000.0,USA,2,4,425,15770,16195,0
Hotels|P2P Money Transfer|Restaurants|Transportation|Travel,500000.0,PHL,1,1,0,16601,16601,0
Bridging Online and Offline|Online Education|Optimization,129222.0,CHL,2,2,153,15492,15645,0
Digital Media|Games|Software|Sports,651000.0,ESP,1,1,0,14022,14022,0
Design|Electronics|Utilities,88093.0,BGR,2,2,123,16344,16467,0
Finance,9000000.0,USA,1,2,0,13615,13615,0
Public Transportation,600000.0,USA,1,1,0,13155,13155,0
CRM|Mobile|Restaurants|SaaS|SMS|Software,60000.0,TTO,1,1,0,15706,15706,0
Health and Wellness,38364626.0,USA,4,15,1828,13691,15519,1
Hardware + Software|Telecommunications|Wireless,16000000.0,USA,1,2,0,13703,13703,0
Mobile,19300000.0,USA,3,12,740,12971,13711,0
College Campuses|Nonprofits,3000.0,USA,2,1,36,16098,16134,0
Security,28100000.0,LTU,1,2,0,14126,14126,0
E-Commerce,1500000.0,BWA,1,2,0,16205,16205,0
E-Commerce,40000.0,CHL,1,1,0,16036,16036,0
Apps|E-Commerce|E-Commerce Platforms|Payments|Shopping|Technology,1260000.0,GBR,2,2,395,15949,16344,0
Electrical Distribution|Energy Efficiency|Hardware + Software|Internet of Things,23235000.0,USA,5,39,1175,15531,16706,0
Automotive|Design|Limousines|Public Transportation|Real Time|Transportation,8207450000.0,USA,13,64,2228,14457,16685,0
Communications Infrastructure|Media|Social Network Media,7600000.0,USA,1,3,0,14025,14025,0
Enterprise Software|Local Search|Software,4800000.0,DEU,3,4,495,15675,16170,0
Music|Software,749166.0,DEU,1,6,0,16500,16500,0
Blogging Platforms|Communications Infrastructure|News|SaaS|Social Media|Software,2050216.0,AUT,6,1,1845,14610,16455,0
Advertising|Analytics|Social Media,140000.0,USA,3,9,946,15536,16482,1
Apps|iPhone|Local|Location Based Services|Mobile|Social Media|Social Network Media,1580000.0,GBR,1,1,0,14944,14944,0
Ad Targeting|Advertising|Apps|Location Based Services|Social Media,34600000.0,USA,5,16,1485,14710,16195,0
Exercise|Finance|Fitness|Mobile|Sports|Web Tools,1150000.0,USA,3,6,329,15271,15600,1
Medical,1175000.0,USA,3,1,413,16267,16680,0
Analytics|Social Media|Software,585745.0,USA,2,2,151,14123,14274,1
Software,90620386.0,USA,8,18,2649,12527,15176,1
Technology,2200000.0,BEL,1,1,0,16724,16724,0
Hardware + Software,58500000.0,USA,2,6,1449,13027,14476,0
Software,647657.0,DEU,2,4,669,14285,14954,0
Analytics|Android|CRM|iPhone|Mobile|SaaS,388780.0,FRA,2,3,426,14365,14791,0
Mobile,9500000.0,ISR,2,5,636,15945,16581,0
Big Data|Health Care|Machine Learning|Quantified Self,4971193.0,USA,3,4,640,15660,16300,0
Cloud Computing,870000.0,RUS,2,1,122,15765,15887,0
Biotechnology,757625.0,GBR,1,3,0,15966,15966,0
Mobile,81000000.0,GBR,6,24,2169,13398,15567,1
Clean Energy,7775000.0,USA,4,6,886,15400,16286,0
Consulting,8000000.0,USA,2,2,438,15584,16022,0
Enterprises|iPad|Mobile|Mobile Payments|Point of Sale|Retail|SaaS|Software,129303.0,JPN,2,1,450,15095,15545,0
Enterprise Software,3000000.0,GBR,1,2,0,13235,13235,0
Security,4336000.0,DEU,2,5,717,13480,14197,1
Software,17000000.0,TWN,2,2,1120,14718,15838,0
Analytics|Cloud Computing|Real Time,4050000.0,USA,4,4,733,15716,16449,0
Events|Software|Universities,100000.0,GBR,2,1,151,16436,16587,0
Software,22066483.0,USA,4,1,1775,13057,14832,1
Mobile,7000000.0,USA,1,1,0,11346,11346,0
Education|Finance|Games|iOS|iPad|iPhone|iPod Touch|Mobile|Toys,2638000.0,USA,3,13,774,15477,16251,1
Consumer Goods|Customer Service|Service Industries,85000000.0,CHN,1,2,0,16647,16647,0
Marketplaces,17000.0,USA,1,1,0,15796,15796,0
Biotechnology,100787628.0,BEL,2,1,1968,14600,16568,0
Education|Internet|Video,280338.0,ITA,1,1,0,15712,15712,0
Education,1000000.0,USA,1,4,0,16307,16307,1
Cloud Data Services|Enterprise Software,160000000.0,CHN,3,9,499,16036,16535,0
Education|K-12 Education|Online Education,1700000.0,USA,1,6,0,16509,16509,0
E-Commerce Platforms,597642.0,DNK,2,2,597,15798,16395,0
EdTech|Education,38064.0,USA,2,1,167,15944,16111,0
Software,5278800.0,FRA,1,4,0,12849,12849,0
Education,69133.0,LVA,1,1,0,16175,16175,0
EdTech|Education,160000000.0,USA,4,19,1410,15340,16750,0
Education|Marketplaces|Technology,113000000.0,USA,5,24,1736,14852,16588,0
Enterprise Software,5000000.0,GBR,1,3,0,12864,12864,1
Curated Web,500000.0,USA,1,1,0,14404,14404,0
Medical Devices,3000000.0,USA,1,3,0,16692,16692,0
E-Commerce,727000.0,SGP,1,1,0,13956,13956,0
Android|iOS|Mobile|Peer-to-Peer|Software,4500000.0,CHE,2,5,735,15378,16113,0
Application Platforms|Apps|Mobile,33078.0,GBR,1,1,0,16071,16071,0
Curated Web,5000000.0,USA,1,2,0,13455,13455,0
Biotechnology,3974850.0,AUT,2,1,2203,13650,15853,0
E-Commerce,130000.0,UKR,2,2,17,15932,15949,0
Hardware + Software|Robotics|Toys,23250000.0,USA,3,6,771,13269,14040,0
Construction|Manufacturing,15625723.0,TUR,1,1,0,16455,16455,0
College Campuses|Education|Peer-to-Peer|Tutoring,100000.0,USA,1,1,0,16283,16283,0
Content|Mobile|Services,3330000.0,SGP,1,2,0,13860,13860,0
Mobile|Mobile Software Tools|Software,31699996.0,USA,4,6,3617,12433,16050,1
Games,15000000.0,CHN,2,4,667,13483,14150,0
Musicians|Promotional|Service Providers,100000000.0,GBR,1,2,0,14676,14676,0
Travel,80319.0,GBR,1,1,0,15712,15712,0
E-Commerce|Finance|FinTech|P2P Money Transfer|Payments,14400000.0,GBR,1,1,0,14151,14151,0
Cloud Computing|Curated Web|Mobile|Photo Sharing,16876.0,USA,1,1,0,16493,16493,0
Application Platforms|Identity Management|Location Based Services|Mobile Social|Privacy|Reputation|Security|Social Media Monitoring,6295000.0,USA,4,8,1300,14944,16244,0
Advertising|Optimization,815830.0,USA,2,6,455,15015,15470,0
Discounts|E-Commerce|Groceries|Retail,6557613.0,ESP,2,6,1451,15132,16583,0
E-Commerce|Mobile,110878477.0,CHN,2,3,1519,14610,16129,0
Guides|Maps|Mobile|Offline Businesses|Travel,1600000.0,AUT,1,1,0,16140,16140,0
Health Care,39650150.0,USA,4,5,1883,13130,15013,0
B2B|Business Productivity|Enterprise Software|Professional Services|Software|Technology,10000000.0,USA,1,1,0,12480,12480,0
Biotechnology,5150000.0,USA,1,2,0,16721,16721,0
Games|Video,23500000.0,CHN,4,8,1135,13689,14824,0
Identity Management,18000000.0,USA,1,1,0,12235,12235,0
Clean Technology|Mobile,3800000.0,USA,1,4,0,14391,14391,0
Biotechnology|Health Care,135100005.0,USA,3,11,560,15145,15705,1
Technology,15606530.0193923,GBR,1,2,0,16741,16741,0
Hardware + Software,6011727.0,GBR,3,4,1606,14276,15882,0
Energy Efficiency|Residential Solar|Solar,5400000.0,USA,2,4,344,14923,15267,0
Software,4000000.0,USA,1,4,0,13060,13060,0
Hardware + Software,881025.0,GBR,1,2,0,15714,15714,0
Business Services|Cars|Mobility,558746.0,NLD,2,2,95,16472,16567,0
Curated Web,63566.0,BGR,2,2,274,15552,15826,0
Consulting,1100000.0,AUT,1,1,0,15111,15111,0
Mobile,1775000.0,USA,2,2,233,15203,15436,0
Biotechnology,26502948.0,CAN,1,1,0,15289,15289,0
EdTech|Education,2000000.0,USA,2,1,1814,14629,16443,0
Ad Targeting|Analytics|Big Data|Digital Media|Internet Marketing|Market Research|Publishing|Social Media,24451943.0,USA,3,2,1325,15432,16757,0
Health and Wellness|Software,470000.0,USA,2,2,393,15312,15705,0
Software,1187932.0,SWE,2,1,3311,11688,14999,0
Apps,12500.0,HKG,1,1,0,16252,16252,0
Analytics,10000000.0,CHN,2,2,242,14914,15156,1
Curated Web|Graphics|Social Media,130000.0,USA,1,2,0,15796,15796,0
Enterprise Software,40000.0,PER,1,1,0,15772,15772,0
mHealth|Software,2750000.0,ISR,3,1,597,15578,16175,0
Local Based Services|Media|News|Publishing,1000000.0,ZAF,1,1,0,15218,15218,0
E-Commerce,1200000.0,IND,1,2,0,15630,15630,0
Analytics|Loyalty Programs|Mobile|Personalization|Retail,2700000.0,CAN,2,5,741,15706,16447,0
Location Based Services|Semiconductors|Software,5000000.0,USA,1,4,0,12608,12608,1
Crowdsourcing|Machine Learning|Translation,1500000.0,USA,3,19,559,16071,16630,0
Beauty|Business Services|Curated Web|Enterprises|Health and Wellness|Sales and Marketing|Services,850000.0,USA,2,1,396,14610,15006,0
Advertising|Internet Marketing|Lead Generation|Optimization|SaaS|Web Design,850000.0,CAN,1,7,0,15309,15309,0
E-Commerce,1818301.0,GBR,1,3,0,16000,16000,0
Identity Management|Mobile|Software,17000000.0,USA,3,2,2002,14215,16217,0
E-Commerce|Navigation|Software,2000000.0,IND,3,3,493,15609,16102,0
Biotechnology|Services,25000000.0,USA,1,3,0,16478,16478,0
Lifestyle|Mobile|Mobile Commerce|Restaurants,1500000.0,GBR,1,2,0,16468,16468,1
E-Commerce,1300000.0,USA,1,4,0,15846,15846,0
Messaging,1250000.0,USA,2,5,548,15826,16374,0
Internet of Things,16876.0,NLD,1,1,0,16493,16493,0
E-Commerce|Fashion,1000000.0,GBR,1,1,0,15340,15340,0
Discounts|E-Commerce|Marketplaces|Wine And Spirits,1000000.0,USA,1,1,0,16331,16331,0
Infrastructure|Utilities|Water,30000000.0,USA,1,1,0,16275,16275,0
Analytics|Big Data,1968000.0,USA,3,6,698,15492,16190,0
Advertising|Digital Media|Media|Mobile|Video,40000000.0,USA,1,2,0,13969,13969,1
Optical Communications|Systems|Technology,63968.0,LVA,1,1,0,16338,16338,0
Domains|Marketplaces|Startups,417087.0,NLD,2,1,103,16481,16584,0
Employment|Nonprofits,200000.0,USA,1,2,0,15170,15170,0
Cars|Cloud Data Services|Logistics,40000.0,CHL,1,1,0,16222,16222,0
Big Data|Enterprises|Enterprise Software|SaaS,470000.0,USA,2,1,384,14975,15359,0
Artificial Intelligence|Fraud Detection|Transaction Processing,132829.0,ITA,2,1,267,16314,16581,0
Fashion,15000.0,CAN,1,1,0,16071,16071,0
Finance,18885850.0,CHN,2,3,883,13970,14853,0
Education,83751.0,GBR,1,1,0,16224,16224,0
B2B|Internet|Portals|Shoes,358804.0,BRA,1,1,0,11535,11535,0
Lead Generation|Marketing Automation|Software,6750000.0,USA,1,2,0,10924,10924,1
Auctions|E-Commerce|Marketplaces|Online Shopping|Retail Technology|SaaS|Search|Software,10000000.0,IND,1,1,0,16381,16381,0
Games,1000000.0,SGP,1,1,0,15960,15960,0
Travel,20000.0,ARG,1,1,0,16028,16028,0
Software,31300000.0,USA,3,4,1492,14630,16122,0
Big Data Analytics|Enterprise Software|Marketing Automation|Social Media Advertising|Social Media Marketing,54000000.0,USA,3,7,1190,15498,16688,0
B2B|Big Data|Cloud Computing|Collaboration|Email|Enterprises|Enterprise Software|IaaS|Mobile|PaaS|Peer-to-Peer|Public Relations|SaaS|Sales and Marketing|Social Media|Unifed Communications,10000000.0,SGP,1,3,0,15205,15205,0
VoIP,140000.0,USA,2,2,218,16300,16518,0
Communications Infrastructure|Enterprise Software,30218779.0,USA,5,7,1152,15506,16658,0
Advertising|Big Data|Communities|Consumer Lending|Content|Curated Web|Digital Media|EdTech|Education|Financial Services|Generation Y-Z|Guides|K-12 Education|Lead Generation|Marketplaces|Reviews and Recommendations|Startups|Universities|Young Adults,3200000.0,USA,4,7,1948,13939,15887,0
Information Security|Security,7733619.02952054,USA,3,2,518,16045,16563,0
Home Automation|Internet of Things|Mobile,12925000.0,USA,6,17,1027,15513,16540,0
Games,10000000.0,USA,2,10,141,16475,16616,0
Crowdfunding|Finance Technology|Financial Services,8568200.0,FRA,1,3,0,16513,16513,0
Health Care,75328948.0,USA,3,2,1812,14538,16350,1
Cloud Infrastructure|Networking|Software|Visualization,1850000.0,USA,1,4,0,15901,15901,1
Biotechnology,5000000.0,USA,1,1,0,14518,14518,0
E-Commerce|Productivity Software,196090.0,GBR,3,3,328,15712,16040,0
Advertising|Curated Web|Property Management|Real Estate,28983554.0,PRT,5,15,1302,15440,16742,0
Curated Web|Mobile|Online Travel|Video,575000.0,CAN,1,1,0,15126,15126,0
Design|Distribution|E-Commerce|Fashion|Media|Product Development Services|Retail,50000.0,USA,1,1,0,15140,15140,0
Hardware + Software,1700000.0,TUR,1,1,0,14368,14368,0
Fashion,38318702.0,CAN,4,1,1897,14418,16315,0
EdTech|Education,63480000.0,CHN,2,3,641,16118,16759,0
Music,1000000.0,USA,1,7,0,16700,16700,0
Biotechnology|Health Care,78000000.0,NLD,2,3,357,15895,16252,1
Bitcoin|Data Security|Domains|Web Tools,60000000.0,GBR,1,1,0,14958,14958,0
Software,19826901.0,USA,5,3,1504,14435,15939,0
Enterprise Software,4700000.0,GBR,1,3,0,13579,13579,0
Enterprise Software,22200000.0,USA,4,5,1131,13384,14515,1
Advertising,25000.0,NZL,1,1,0,16175,16175,0
Cloud Computing|Cloud Management|Enterprise Software|IaaS,7300000.0,USA,2,2,609,16105,16714,0
Software,2500000.0,USA,1,2,0,12944,12944,0
Software,1077803.0,GBR,1,1,0,14861,14861,1
Social CRM|Social Media|Software,6300000.0,USA,2,7,714,15938,16652,0
Social Media,1750000.0,FRA,1,1,0,14014,14014,0
Consulting,38000000.0,USA,1,3,0,15999,15999,0
Enterprise Software,10500000.0,USA,1,1,0,13453,13453,0
Enterprise Software,116350000.0,CHN,4,4,1704,13361,15065,0
Hardware + Software,16000000.0,CHN,1,2,0,14593,14593,0
Mobile|Synchronization,1200000.0,IND,2,2,1122,14334,15456,0
Software,900000.0,ISR,1,2,0,14610,14610,0
Telecommunications,50000000.0,CHN,1,9,0,12115,12115,0
Art|Crowdfunding|Non Profit,22000000.0,USA,1,4,0,12784,12784,0
Education,250000.0,USA,1,1,0,16048,16048,0
Pets,941288.0,EST,2,4,421,13985,14406,0
Health Care,290000000.0,USA,1,2,0,13732,13732,1
Mobile,15000000.0,CHE,1,4,0,13879,13879,0
Recruiting,7500000.0,USA,1,5,0,16751,16751,0
Cloud Data Services|Data Security|Homeland Security|Software|Virtualization,21299674.0,USA,5,9,3804,12801,16605,0
Web Hosting,2200000.0,THA,1,1,0,14865,14865,0
Health and Wellness|Healthcare Services|Physicians,6006000.0,USA,1,1,0,15857,15857,0
3D|Content|Development Platforms|Games|Software,17500000.0,DNK,3,7,1631,14543,16174,0
Health and Wellness,187270.0,USA,1,1,0,16113,16113,0
Data Centers|Software,56777627.0,USA,10,22,3728,12996,16724,0
Biotechnology,3377617.6536816,BEL,1,1,0,16731,16731,0
Advertising|Promotional|Retail,11000000.0,ISR,2,4,1068,12880,13948,0
Automotive,235920.0,GBR,2,2,182,15371,15553,0
Curated Web|Video,1500000.0,USA,3,5,1338,14488,15826,0
Events|Mobile Commerce|Mobile Payments|Social Commerce|Ticketing,2500000.0,CAN,3,1,907,15309,16216,1
All Students|Curated Web|Universities,350000.0,USA,2,3,309,16040,16349,0
Education,1400000.0,USA,1,1,0,15972,15972,0
Education,19450000.0,USA,2,2,708,16048,16756,0
Education,9640000.0,USA,2,1,313,15624,15937,0
Education,750500000.0,USA,2,2,142,15965,16107,0
Education,2000000.0,USA,1,1,0,16643,16643,0
Education,7700000.0,USA,3,1,347,16030,16377,0
Education,10000000.0,USA,1,1,0,15565,15565,0
Education,10800000.0,USA,1,1,0,16251,16251,0
Education,16800000.0,USA,1,1,0,16288,16288,0
Education,10000000.0,USA,1,2,0,15966,15966,0
Education,1600000.0,USA,1,1,0,16120,16120,0
Education,477475356.0,GBR,2,2,0,16128,16128,0
Education,6000000.0,USA,1,1,0,16525,16525,0
All Students|Colleges|Education|Networking|News|SEO|Software|Web Hosting,500000.0,USA,1,1,0,14061,14061,0
Colleges|Consumers|Education|Freemium|Technology,40500000.0,USA,4,13,1028,14944,15972,0
Curated Web,500000.0,USA,1,1,0,15924,15924,0
Health Care|Hospitals|Medical,45100000.0,USA,2,1,1896,14615,16511,0
App Marketing|Mobile|Technology,2252425.0,ESP,2,3,668,12984,13652,0
Software,10300000.0,NZL,4,4,1175,15427,16602,0
Enterprises|Enterprise Software|Networking,510294.0,GBR,1,1,0,13801,13801,1
Analytics|Social Media|Social Media Monitoring,8700000.0,USA,2,3,506,15443,15949,0
Financial Exchanges,250000.0,IND,1,2,0,16293,16293,0
Mobile,3660720.0,FRA,1,1,0,14872,14872,0
Hospitality,18689487.0,USA,3,2,520,15515,16035,0
Business Intelligence|SaaS|Software,164223.0,GBR,1,1,0,16090,16090,0
Advertising|Big Data|Media|Online Video Advertising|Social Media|Social Media Marketing|Technology|Video,25000000.0,GBR,1,3,0,15342,15342,1
Natural Language Processing|Search,1000000.0,DNK,2,2,482,15492,15974,0
Curated Web,2100000.0,USA,2,13,173,14730,14903,1
Brand Marketing|Media|Promotional|Public Relations|Social Media|Software,30510526.0,USA,4,5,1499,13208,14707,0
Banking|Financial Services|FinTech|Internet|Real Time|Recruiting|Technology,5200000.0,USA,4,5,537,16009,16546,0
E-Commerce|Hardware + Software|Mobility,1788702.11029584,DEU,1,2,0,16559,16559,0
Biotechnology,77000000.0,USA,2,15,233,16364,16597,0
Contact Centers|Services|Technology,14000000.0,USA,2,4,384,12200,12584,0
Finance|FinTech,4400000.0,USA,4,8,3586,11555,15141,1
Medical Devices,2513724.0,USA,3,1,287,16244,16531,0
Crowdfunding|Crowdsourcing|Financial Services|Technology,270035.0,GBR,2,2,111,16161,16272,0
Analytics|Apps|Video,242718.0,CAN,1,1,0,15961,15961,0
E-Commerce|Loyalty Programs|Mobile|Payments,1299000.0,FRA,1,2,0,14270,14270,0
Internet of Things|Soccer|Sports|Wearables,20000.0,JPN,1,2,0,16567,16567,0
E-Commerce,2000000.0,USA,1,2,0,15835,15835,0
Cloud Computing|Content|Enterprise Software|News,48451.0,GBR,1,1,0,15614,15614,0
Curated Web,5730000.0,USA,1,3,0,14512,14512,0
Legal|Marketplaces,14000000.0,USA,4,17,848,15796,16644,0
Software,18973011.0,USA,3,2,2513,13195,15708,0
Consumer Internet|Internet|Real Estate|Software,9500000.0,USA,4,5,952,15209,16161,0
Social Media,1750000.0,USA,3,2,436,13695,14131,0
Electronic Health Records|Software,4000000.0,USA,3,3,2212,14362,16574,0
Consumer Electronics|EdTech|Education|Hardware + Software|Robotics,200000.0,USA,1,1,0,16269,16269,0
Security,31274612.0,USA,3,10,2024,12494,14518,1
Biotechnology,9200000.0,DNK,1,3,0,13780,13780,0
Cloud Data Services|Enterprises|Software,31376300.0,USA,2,2,1165,14910,16075,0
Technology,8199999.0,USA,1,3,0,16384,16384,0
Mobile|Social Media,653011.0,FRA,2,1,244,15431,15675,0
Enterprise Software|IT Management|Networking,45226149.0,USA,8,5,2865,13248,16113,0
Career Management|Employment|Enterprise Software|Human Resources|Networking|Search,3700000.0,USA,2,3,612,14591,15203,0
Active Lifestyle|Professional Services|Sports,1524250.0,GBR,1,1,0,16588,16588,0
Maps|Mobile,556799.0,USA,1,7,0,15047,15047,1
Mobile,5000000.0,USA,1,4,0,12620,12620,0
Colleges|Curated Web|Ticketing|Travel,1113000.0,USA,2,4,497,15847,16344,0
Energy,170000.0,USA,2,2,259,16008,16267,0
Collaborative Consumption|E-Commerce|Fashion|Mass Customization,1487693.0,GBR,2,2,402,16160,16562,0
Mobile,600000.0,USA,2,5,378,15406,15784,1
Apps|Mobile,622525.0,ESP,3,2,679,15635,16314,0
Application Platforms|Apps|Messaging|Social Media|Telecommunications,7417650.0,ESP,3,4,930,15055,15985,0
Artificial Intelligence|Peer-to-Peer|Software,5250000.0,USA,5,9,1366,11372,12738,0
Apps,28000.0,USA,1,1,0,15896,15896,0
Finance|Financial Services|FinTech|Investment Management,1200000.0,USA,2,11,286,15979,16265,1
Games|Internet,332000.0,USA,2,1,1282,15391,16673,0
Big Data Analytics|Business Intelligence|Data Mining|Marketing Automation|Mobile|Mobile Analytics,30043333.0,USA,6,16,1834,14708,16542,0
Finance|Finance Technology|FinTech|Personal Finance,53150000.0,USA,4,17,1072,15560,16632,0
Analytics,6250000.0,USA,5,6,1344,15061,16405,0
Advertising|App Marketing|Gamification|Internet Marketing|Mobile|Sales and Marketing,15291100.0,USA,1,1,0,14391,14391,0
Search|Travel,18781724.0,USA,4,5,1380,13473,14853,0
Analytics|Big Data|Internet of Things,45000000.0,USA,1,3,0,16735,16735,0
Biotechnology|Health Care,66416775.0,USA,5,13,1028,14384,15412,0
Games,809929.0,USA,2,1,391,15610,16001,0
Loyalty Programs|Travel & Tourism,55225.0,CZE,1,1,0,16183,16183,0
Software,6500000.0,USA,2,2,2235,13032,15267,1
Android|Curated Web|Events|iPhone|Mobile|Social Media,2924999.0,USA,2,5,621,15248,15869,0
E-Commerce,40000.0,USA,1,1,0,16055,16055,0
CAD|Electronics|Hardware|Open Source|Software,2380952.38095238,CAN,1,1,0,15887,15887,0
Education|Mobile,25000.0,USA,1,1,0,14349,14349,0
Clean Technology|Intellectual Asset Management|Renewable Energies,33800000.0,USA,3,4,715,13963,14678,0
Digital Media|Media|Social Media,12000000.0,USA,2,8,335,15629,15964,0
Mobile|Wireless,43000000.0,JPN,1,1,0,14402,14402,0
Automotive,56800000.0,USA,3,1,2107,14629,16736,1
Internet|iPhone|Messaging|Mobile,76528489.0,USA,7,28,1842,14656,16498,0
Clean Technology|Solar,26089000.0,USA,3,1,251,15924,16175,0
Finance|Manufacturing,463000.0,USA,2,2,100,15575,15675,0
E-Commerce|Furniture|Home Decor|Home & Garden|Internet|Technology,77000000.0,IND,4,11,981,15553,16534,0
Apps|Pets,118000.0,USA,1,1,0,16622,16622,0
Apps|Health and Wellness|Services|Software,1500000.0,GBR,2,5,16,16588,16604,0
E-Commerce|Organic Food|Retail,6000000.0,USA,2,4,776,15660,16436,0
Green|Life Sciences|News|Politics|Technology,105882.0,GBR,3,1,1437,14730,16167,0
SaaS|Software|Technology,6000000.0,USA,2,2,675,15248,15923,0
Apps,36600000.0,IND,3,9,217,16541,16758,0
E-Commerce|Real Estate,2000000.0,IDN,2,5,391,15470,15861,0
Business Intelligence|Curated Web,400000.0,USA,1,1,0,13269,13269,0
Home & Garden|Services,500000.0,AUS,1,1,0,16723,16723,0
Social Media,23007496.0,USA,5,10,1167,15296,16463,0
E-Commerce|Flowers|Gift Card|Local,1500000.0,USA,1,3,0,16475,16475,0
Clean Technology,5739600.0,FRA,1,1,0,14151,14151,0
Curated Web|Local Search|Travel,675000.0,USA,2,3,306,15400,15706,0
Mobile,5000000.0,USA,1,1,0,12739,12739,1
Software,8710000.0,USA,3,8,530,16177,16707,0
Health and Wellness|Medical,26950000.0,USA,6,4,1549,14702,16251,0
E-Commerce|Gift Card|Mobile|Social Network Media,203313.0,USA,2,2,274,15522,15796,0
Energy|Renewable Energies|Utilities,100000.0,IND,1,1,0,16521,16521,0
Fitness|Healthcare Services|Medical|Mens Specific,44669.0,DNK,1,1,0,15946,15946,0
Entertainment|Games,2000.0,USA,1,1,0,14798,14798,0
Medical Devices,404000.0,USA,4,6,585,15492,16077,0
Curated Web|Finance|Messaging|Polling|Surveys|Weddings,512000.0,USA,2,4,194,15156,15350,0
Curated Web|Internet|Messaging|Social Media,13400000.0,CHE,1,2,0,15847,15847,0
Digital Media|Mobile|Mobile Commerce,15100000.0,USA,4,39,331,15857,16188,0
Biotechnology|Health Care|Pharmaceuticals,1250000.0,USA,2,4,150,16196,16346,0
Advertising|App Marketing|B2B|Direct Marketing|Email Marketing|Lead Generation,1500000.0,USA,1,1,0,12081,12081,0
Biotechnology,36000000.0,USA,1,6,0,15768,15768,0
Non Profit,6000000.0,USA,1,1,0,16694,16694,0
Usability|User Experience Design,250000.0,POL,1,2,0,15819,15819,0
Collaborative Consumption|Consumers|Curated Web|Online Rental|Peer-to-Peer,50000.0,RUS,1,1,0,15872,15872,0
Advertising|Manufacturing|Product Design|Product Development Services|Promotional|Sales and Marketing,3972500.0,CHN,4,2,2637,13392,16029,0
Analytics|Cloud Computing|Media|SaaS|Software|Startups|Usability|User Experience Design,40000.0,POL,1,1,0,15522,15522,0
Cloud Computing|Enterprises|Maps|Mobile|Real Time|SaaS|Software|Synchronization|Tracking|Web Development,250000.0,USA,1,2,0,16010,16010,0
Innovation Engineering,6700000.0,USA,2,7,347,16345,16692,0
Security,6110000.0,GBR,1,3,0,13249,13249,0
User Interface,8250000.0,USA,1,4,0,11346,11346,0
Web Development,1728109.0,JPN,1,2,0,16580,16580,0
Software,5624176.0,GBR,4,6,1064,15309,16373,0
Internet|Software,1000000.0,ISR,1,1,0,15340,15340,0
Curated Web|Reviews and Recommendations|Testing|Usability|User Experience Design|Web Design,1000000.0,NLD,1,1,0,15147,15147,0
Analytics,120000.0,USA,1,1,0,16425,16425,0
Big Data|Consulting|Data Visualization,4000000.0,USA,1,2,0,16325,16325,0
Advertising|Email|Email Marketing|SaaS|Sales and Marketing,700000.0,USA,1,3,0,15340,15340,1
Marketing Automation|Mobile Software Tools|Web Tools,1200000.0,USA,1,3,0,16191,16191,0
Business Analytics|Marketing Automation|Professional Services|Sales Automation|Software,7600000.0,USA,1,3,0,15972,15972,0
App Marketing|Curated Web|Market Research|Surveys,40000.0,SGP,1,1,0,15956,15956,0
Crowdsourcing|User Experience Design|User Interface|User Testing,48500000.0,USA,2,3,874,15589,16463,0
Customer Service|Customer Support Tools|Forums|Reviews and Recommendations|Software,1800000.0,USA,2,17,913,14383,15296,0
Software|Testing|Usability|User Experience Design,36413355.0,USA,2,4,2570,14153,16723,0
Apps|Internet|Software,40798.0,COL,1,1,0,16283,16283,0
Curated Web|Social Media,38484.0,ROM,1,1,0,15798,15798,0
Art|E-Commerce|Mobile|Networking|Social Media,177139.0,GBR,1,1,0,15645,15645,0
Health Care,45048169.0,USA,3,3,976,15485,16461,0
Information Technology|Mobile Emergency&Health|Nonprofits|Open Source,2095740.0,KEN,6,4,487,14092,14579,0
Professional Networking|Social Media|Social Network Media,5994768.0,CHN,4,9,530,14730,15260,0
Public Transportation,44709996.0,NLD,6,6,2910,12958,15868,0
Finance|Hotels|Transportation|Travel,3265000.0,USA,5,4,1328,14000,15328,0
Music,289289.0,ARG,3,3,334,16010,16344,0
EdTech|Education|Internet|Language Learning,18885.0,ESP,2,1,122,15400,15522,0
Apps|Fantasy Sports|Social Media|Sports,100000.0,USA,1,4,0,16617,16617,0
Apps|Broadcasting|Games|Mobile|Video|Video Streaming,60310000.0,USA,5,11,794,13848,14642,0
Fashion,1000000.0,USA,1,1,0,15100,15100,0
Software,2000000.0,USA,1,1,0,15973,15973,0
E-Commerce|Group Buying|Social Media,5559000.0,USA,1,3,0,15431,15431,0
Messaging,20000.0,USA,1,1,0,15340,15340,0
Collaborative Consumption,4046840.0,FRA,1,2,0,15155,15155,0
Clean Technology,5000000.0,CAN,1,1,0,15016,15016,0
Networking,100000000.0,USA,1,1,0,11293,11293,0
Energy|Energy Efficiency|Smart Grid|Software|Utilities,20000000.0,USA,2,5,665,15383,16048,0
Clean Technology,658000.0,GBR,1,1,0,14571,14571,0
Hardware + Software|Health Diagnostics,29500000.0,USA,3,10,5341,11275,16616,0
Clean Technology,11280346.0,GBR,1,1,0,15771,15771,0
Health and Wellness|Medical|Services,750000.0,USA,2,1,484,15924,16408,0
Finance,40240000.0,IND,4,7,1198,15228,16426,0
Enterprise Software,50000000.0,USA,2,1,965,15471,16436,0
Enterprise Software,7500000.0,USA,1,2,0,14147,14147,1
Apps|Mobile|News|Sports|Television,76269.0,BHR,2,1,887,15655,16542,0
Photography|Social Network Media,200000.0,DEU,1,1,0,16080,16080,0
Artificial Intelligence|Ediscovery|Optimization|Travel,2000000.0,USA,3,4,880,15536,16416,0
Curated Web|Internet,180500000.0,CHN,5,7,4810,9831,14641,1
Audio|Blogging Platforms|Mobile,4000000.0,USA,1,1,0,13757,13757,0
Advertising,60000000.0,CHN,4,3,1492,14426,15918,0
Photography,43500000.0,CHN,3,10,461,13118,13579,0
Cars|Communities|P2P Money Transfer|Services,20000000.0,CHN,2,4,175,16337,16512,0
Colleges|Education|Predictive Analytics|Social Network Media,10890001.0,USA,6,8,2576,13818,16394,0
E-Commerce|Internet|Reviews and Recommendations|Social Media|Wine And Spirits,2571816.0,ESP,3,9,1616,14791,16407,0
Colleges|EdTech|Education|Enterprise Software|SaaS|Technology,500000.0,USA,1,2,0,16157,16157,1
Biotechnology,2852535.0,GBR,2,2,741,15629,16370,0
Big Data Analytics|Mobile Analytics|User Experience Design,100000.0,USA,2,2,179,16104,16283,0
Mobile,20000.0,USA,1,1,0,15218,15218,1
Auctions|Cars|Services,170000000.0,CHN,2,4,198,16314,16512,0
Software,8000000.0,CAN,1,2,0,16538,16538,0
Software,7300000.0,USA,3,16,645,15994,16639,0
E-Commerce,4000000.0,CHN,1,2,0,15126,15126,0
Information Technology,4500000.0,JPN,1,7,0,16311,16311,0
Games,1600000.0,CHN,1,1,0,16001,16001,0
Security|Software,8500000.0,USA,2,3,1409,13823,15232,0
Hardware|Manufacturing|Photography,4795915.0,USA,2,2,1111,13525,14636,0
Cloud Computing|Mobile,16000000.0,USA,2,3,783,15608,16391,0
Industrial Automation,1063286.0,FRA,1,1,0,16540,16540,0
Education|Networking|Systems,3400000.0,USA,1,1,0,12227,12227,1
Cloud Computing|Cloud Infrastructure|Small and Medium Businesses,57722.0,PER,2,3,181,15949,16130,0
Web Hosting,3530000.0,DNK,1,2,0,13503,13503,0
Enterprise Software,12700000.0,USA,2,4,3429,11913,15342,1
Collaboration|Finance|Financial Services|FinTech|Investment Management,3774717.0,DEU,2,1,334,16010,16344,0
Mobile,1075000.0,DNK,2,3,388,16152,16540,0
E-Commerce|Marketplaces|Online Travel|Timeshares|Vacation Rentals,13800000.0,USA,2,18,582,15952,16534,0
Hospitality|Marketplaces|Online Shopping|Travel|Vacation Rentals,367500.0,USA,2,1,201,15765,15966,0
Biotechnology,3490077.0,NOR,2,1,226,15656,15882,0
Biotechnology,9000000.0,USA,1,3,0,14050,14050,0
Biotechnology,277000.0,ESP,1,1,0,13514,13514,0
Media|Mobile|Video,10268000.0,USA,5,21,946,15621,16567,0
Design,847034.0,KOR,1,2,0,14518,14518,0
Beauty|Big Data|Cosmetics|E-Commerce|Health and Wellness|Personalization|Retail,45180.0,CAN,1,1,0,16161,16161,0
Clean Technology,7411357.0,GBR,1,2,0,14145,14145,0
Business Services|Construction|Online Rental|Services,100000.0,BRA,1,1,0,16375,16375,0
Online Travel|Travel|Travel & Tourism|Vacation Rentals,1300000.0,USA,1,2,0,16282,16282,0
Consumer Internet|Software,17654216.0,USA,6,3,1685,14904,16589,0
Health and Wellness|Medical Devices,8000000.0,ISR,1,1,0,15532,15532,0
Software,8500000.0,USA,1,4,0,12849,12849,1
Biotechnology,3370000.0,DNK,1,1,0,13742,13742,0
Analytics|Big Data Analytics|Insurance|Predictive Analytics|Technology,14770000.0,USA,3,4,1394,13830,15224,0
Analytics,45000000.0,USA,2,5,883,15510,16393,0
Hardware + Software|Wearables,16100000.0,USA,4,6,2128,14561,16689,0
Semiconductors,21000000.0,ISR,2,6,1451,13710,15161,0
Software,5010000.0,ISR,1,1,0,14328,14328,0
Health Care,27800000.0,USA,2,6,2163,14518,16681,0
Technology,12000000.0,USA,1,3,0,12230,12230,1
Energy,17000000.0,USA,1,2,0,12284,12284,0
Biotechnology,20000000.0,USA,1,1,0,15404,15404,0
Biotechnology|Diabetes,271951220.0,USA,3,9,1033,15229,16262,0
Charity|Internet|Non Profit,5000.0,USA,1,1,0,15913,15913,0
Mobile|Parking,1350000.0,USA,2,23,219,16251,16470,0
Apps|Big Data|Developer APIs|Enterprises|Health and Wellness|Health Care|mHealth,18358500.0,USA,5,13,1352,15201,16553,0
Biometrics|Enterprise Software,82600000.0,USA,5,25,2194,13438,15632,1
Web Hosting,11809658.0,USA,3,1,1196,13865,15061,0
Finance|Financial Services|Investment Management|Property Management|Real Estate|Real Estate Investors|Retail,20000000.0,USA,1,1,0,16478,16478,0
Mechanical Solutions|Outsourcing|Technology,18128852.0,GBR,1,1,0,15791,15791,0
Hardware + Software,10234400.0,FIN,2,8,904,14958,15862,0
Environmental Innovation|Services,10000000.0,USA,1,1,0,12594,12594,0
Automotive,27834000.0,FIN,1,2,0,14921,14921,0
Manufacturing,2044050.0,FIN,1,1,0,15279,15279,0
Cloud Computing|CRM|Estimation and Quoting|SaaS|Sales Automation|Software,1500000.0,ISR,1,1,0,16372,16372,0
Manufacturing,2573200.0,FIN,1,1,0,16027,16027,0
Enterprise Resource Planning|Enterprises|Services,40000.0,CHL,1,1,0,16497,16497,0
Big Data|Big Data Analytics|Natural Resources|Utilities,1240000.0,USA,3,4,261,16302,16563,0
Clean Technology,14470050.0,FRA,1,3,0,13710,13710,0
Health Care,17800000.0,ISR,1,1,0,14683,14683,1
Real Estate,26000000.0,IND,1,1,0,15214,15214,0
Transportation,50000.0,USA,1,1,0,16686,16686,0
Software,510000.0,USA,1,1,0,13399,13399,1
Internet|SaaS|Social Media|Software|Technology,2550000.0,USA,4,2,838,14608,15446,0
Hardware + Software,3500000.0,USA,1,1,0,15162,15162,0
Fashion,10000000.0,IND,1,2,0,15744,15744,0
Travel,1600000.0,USA,1,26,0,15904,15904,0
Enterprise Software,1659006.0,GBR,1,1,0,14470,14470,0
Consumer Goods|Craft Beer|Wine And Spirits,50977.0,GBR,1,1,0,16240,16240,0
Finance,10700000.0,USA,1,1,0,15006,15006,0
Enterprise Software,754000.0,DEU,1,2,0,13325,13325,1
E-Commerce,570000000.0,CHN,5,16,1411,14700,16111,0
Biotechnology|Health Diagnostics,2424999.0,USA,3,2,1706,13035,14741,1
Software,100000.0,GBR,1,1,0,14579,14579,0
Health Care,22300000.0,USA,3,2,507,16119,16626,0
Consumer Electronics|Home Automation|Home Decor,65478.0,MEX,2,2,242,16010,16252,0
Auto|Automotive|Clean Technology|Manufacturing|Search,15750000.0,USA,2,1,1659,14515,16174,0
Audio|Enterprise Software,5000000.0,USA,2,2,785,13444,14229,0
Art|E-Commerce|Internet|Marketplaces|Startups|Visualization,2345000.0,USA,3,8,878,15705,16583,0
Software,100000.0,USA,1,2,0,15434,15434,0
Bicycles|Design|Product Design,1600000.0,CAN,2,6,368,16130,16498,0
Beauty,16535302.0,DEU,1,1,0,16646,16646,0
Android|Apps|Entertainment|Games|iOS|iPhone|Mobile|Social Media,1778447.0,KOR,1,1,0,15034,15034,0
Communities|Forums|SaaS|Software,982873.0,CAN,2,6,166,14462,14628,0
Beauty|Health and Wellness|Lifestyle,3500000.0,SGP,1,5,0,16772,16772,0
Advertising,5000000.0,LUX,1,1,0,14755,14755,0
Biotechnology,5000000.0,USA,1,4,0,12859,12859,0
Analytics|Marketing Automation|Predictive Analytics,1100000.0,CAN,1,4,0,16301,16301,0
Data Center Infrastructure|Data Centers,275000000.0,USA,2,1,1565,14610,16175,0
Advertising|Advertising Platforms|Auctions|Internet Marketing|Performance Marketing|Sales and Marketing,70000000.0,USA,1,4,0,13572,13572,0
Health and Wellness|Health Care|Hospitals,37500000.0,USA,2,9,959,12592,13551,0
Consulting,900000.0,MYS,1,1,0,13874,13874,0
Analytics|Sports,4300000.0,USA,3,10,450,16198,16648,0
Software,1300000.0,USA,1,2,0,13690,13690,0
Biotechnology,6500000.0,GBR,1,3,0,15161,15161,0
Enterprise Software,18508487.0,USA,4,6,2197,12986,15183,0
Mobile,46255828.0,CAN,9,16,3770,12796,16566,0
Software,42150000.0,USA,3,4,1140,13699,14839,0
Chemicals,23245840.075828303,CAN,1,4,0,13824,13824,0
Fitness|Health Care|Medical,7200000.0,USA,2,3,72,16427,16499,0
Telecommunications,1659615.0,USA,2,2,19,16505,16524,0
Hardware + Software,6119894.0,USA,3,3,1561,14515,16076,0
Biotechnology,119750000.0,USA,6,21,2952,13818,16770,0
Enterprise Software,2500000.0,USA,1,1,0,13708,13708,1
Consumers|Software,68000000.0,CAN,5,17,993,15765,16758,0
Fashion,5000000.0,IND,1,1,0,15903,15903,0
Clean Technology,41916889.0,USA,5,7,1527,15226,16753,0
Hardware + Software,3833534.0,USA,5,7,634,15492,16126,0
Semiconductors,4800000.0,USA,1,1,0,15012,15012,1
Enterprise Software,35000000.0,CAN,1,1,0,14518,14518,1
Hardware + Software,20377000.0,FRA,1,5,0,13263,13263,0
Software,42000000.0,USA,3,9,582,15720,16302,0
Software,11000000.0,USA,2,5,615,15181,15796,1
Big Data Analytics|Software,28787685.0,USA,5,7,2103,13276,15379,1
Sports,8316271.0,USA,4,18,1288,15393,16681,0
Consumer Internet|E-Commerce|Mobile Commerce|Video Chat,57000000.0,USA,2,5,531,16218,16749,0
Architecture,16000000.0,USA,1,9,0,12058,12058,1
B2B|Healthcare Services|Hospitals|Medical Devices,4800000.0,ISR,4,3,1127,14975,16102,0
Biotechnology,7000000.0,USA,1,1,0,15392,15392,0
Biotechnology,19000000.0,USA,2,8,1331,14914,16245,0
Biotechnology,26000000.0,USA,3,3,902,15595,16497,0
Biotechnology,400000.0,USA,1,1,0,14273,14273,0
Diagnostics|Health and Wellness|Image Recognition|Medical,380000.0,USA,1,1,0,14453,14453,0
Mobile,22000000.0,USA,2,4,688,15095,15783,0
Health Care,3494340.0,USA,2,2,1136,13578,14714,1
Biotechnology,24300000.0,DEU,4,6,3421,12459,15880,0
Software,24000000.0,USA,2,7,792,12926,13718,0
Art|Design|Insurance|Networking,148476.0,GBR,2,1,1215,15365,16580,0
Fashion,1650000.0,USA,3,10,1026,15340,16366,0
Finance|Finance Technology|SaaS,24000000.0,ISR,1,1,0,16657,16657,0
Semiconductors,32000000.0,USA,3,17,698,12831,13529,1
Apps,120000.0,USA,1,3,0,16267,16267,0
Curated Web|Marketplaces,9000000.0,USA,2,4,138,10739,10877,0
Consumers,91500.0,SGP,2,1,56,15890,15946,0
Security,19000000.0,USA,4,11,2210,14245,16455,0
Mobile,32000000.0,USA,1,6,0,11386,11386,0
Mobile,6000000.0,USA,1,3,0,13910,13910,1
E-Commerce|Fashion|Lifestyle|Marketplaces|Social Commerce,2220000.0,USA,2,4,376,15553,15929,0
Biotechnology,52668419.0,USA,5,5,2091,13832,15923,0
Biotechnology|Health Care|Life Sciences|Pharmaceuticals,6100000.0,USA,5,2,683,15848,16531,0
Biotechnology,8000000.0,CHE,1,1,0,14986,14986,0
Biotechnology|Clinical Trials|Health and Wellness|Health Care|Pharmaceuticals|Testing,16000000.0,USA,1,4,0,16483,16483,0
Biotechnology,129258455.0,USA,7,17,4217,12489,16706,0
Collaborative Consumption|Marketplaces|Travel,2100000.0,USA,4,4,506,15320,15826,0
E-Commerce,40000.0,USA,1,1,0,16069,16069,0
Software,1330000.0,IND,2,1,1673,13483,15156,0
Travel,2800000.0,USA,1,7,0,16413,16413,0
Aerospace|Drones|Innovation Engineering|Logistics|Manufacturing|Medical Devices|Mobile Emergency&Health|Radical Breakthrough Startups,250000.0,USA,2,1,391,16071,16462,0
Mobile,10000000.0,USA,1,3,0,13227,13227,0
3D|Mobile|Sensors,12000000.0,ISR,1,4,0,15553,15553,0
Consulting|Enterprise Software,35652584.0,USA,5,3,1568,14578,16146,0
Artificial Intelligence|Content Discovery|Face Recognition|Image Recognition|Monetization|Video,800000.0,USA,2,5,143,16171,16314,0
Enterprise Software,19500000.0,USA,3,4,2578,14181,16759,0
Entertainment,4512999.0,USA,1,3,0,16526,16526,0
EdTech|Supply Chain Management,800000.0,USA,2,1,1181,15328,16509,0
Energy|Energy Efficiency|Energy Management|Energy Storage,4420000.0,USA,5,7,1030,14966,15996,0
Mobile|SNS|Software,10494514.0,KOR,4,9,873,15330,16203,0
Recruiting,1000000.0,RUS,1,1,0,15522,15522,0
Financial Services,2000000.0,RUS,1,1,0,15737,15737,0
Advertising Exchanges|Mobile|Mobile Advertising|Mobile Video,13091862.0,USA,4,4,2115,14137,16252,0
Content|iPad|iPhone|Media|Mobile|News|Publishing|Tablets,200000.0,USA,1,1,0,14822,14822,0
Enterprises|Hospitality|SaaS,1030000.0,USA,2,4,258,16436,16694,0
Broadcasting|Hardware + Software|Mobile|Mobile Software Tools|Portals|Proximity Internet|Sensors|Software,350000.0,TUR,1,1,0,16027,16027,0
Education,218722.0,ITA,1,2,0,16061,16061,0
Watch|Wearables,7039604.0,GBR,2,1,506,16258,16764,0
Medical Devices,5000000.0,ISR,1,3,0,16492,16492,0
Curated Web,24000000.0,USA,1,1,0,15188,15188,0
Network Security|Security,77840000.0,USA,5,18,2098,14610,16708,0
Manufacturing|Storage,16000000.0,IND,1,1,0,16240,16240,0
Biotechnology,3300000.0,USA,1,1,0,15555,15555,0
EdTech|Education|Mobile|Technology|Tutoring,5550000.0,IND,3,2,661,15901,16562,0
Software,455000.0,USA,1,1,0,16007,16007,0
Web Hosting,2820000.0,FRA,1,1,0,14629,14629,0
Colleges|EdTech|Education|Universities,1250000.0,BRA,2,9,242,15737,15979,0
Social + Mobile + Local|Software,1000000.0,IND,1,1,0,16380,16380,0
E-Commerce,14383389.0,USA,2,2,806,15923,16729,0
Food Processing,6000000.0,IND,1,2,0,16587,16587,0
Hardware + Software,6000000.0,GBR,1,7,0,14894,14894,0
Hardware + Software,4800000.0,USA,1,1,0,15012,15012,1
Internet|Online Travel|Video,25000.0,GBR,1,1,0,16495,16495,0
Marketplaces|Video,1020000.0,USA,2,1,712,15779,16491,0
Messaging,2500000.0,USA,1,2,0,13559,13559,0
Advertising|Video,2489970.0,USA,4,16,1145,15299,16444,1
Cloud Computing|E-Commerce,2706565.0,GBR,7,5,719,15784,16503,0
Content|CRM|Enterprise Software|Life Sciences|Software,4000000.0,USA,1,1,0,14035,14035,1
Apps|Software,110655.0,GBR,2,3,37,16034,16071,0
Finance,3209407.0,GBR,1,1,0,15021,15021,1
Hospitality,20000000.0,USA,1,1,0,15733,15733,0
Architecture|Automotive|Mobility,160000000.0,USA,1,1,0,14102,14102,1
Software,2706380.2915372998,FRA,1,2,0,16598,16598,0
E-Commerce|Internet Marketing|Startups|Technology|Web Development,1500000.0,IDN,1,1,0,16472,16472,0
Construction|iPad|Mobile|Software,23831328.0,USA,4,8,1585,13269,14854,1
Medical Devices,5700000.0,USA,2,4,84,16387,16471,0
Manufacturing,161812.0,ITA,2,3,197,16330,16527,0
Communications Infrastructure|Media|Telecommunications,95000000.0,USA,3,5,722,10804,11526,1
Mobile,9000000.0,NLD,2,3,740,15190,15930,0
Clean Technology|Collaborative Consumption|Energy|Hardware|Hardware + Software|Internet of Things|Transportation,20000.0,USA,1,1,0,16265,16265,0
Analytics,13620414.0,USA,4,3,790,15904,16694,0
B2B|CRM|Enterprise Software|Lead Management|SaaS|Sales and Marketing|Sales Automation|Software,18250000.0,USA,2,3,1575,13798,15373,0
Health Care|Medical|Medical Devices,34500000.0,USA,2,7,447,12236,12683,1
Hospitality|Mobile|Mobile Payments,16416139.0,GBR,3,5,539,16161,16700,0
Software,3690000.0,GBR,1,2,0,14711,14711,0
Content Delivery|Games|Video,70000000.0,GBR,3,10,592,13339,13931,1
Networking,21000000.0,USA,1,3,0,16238,16238,0
Biotechnology,19000000.0,USA,3,3,819,14559,15378,0
Advertising|Analytics|Health Care|Information Technology|Optimization,5875000.0,USA,4,10,1125,14630,15755,1
Computers|Data Centers|Virtualization,14000000.0,USA,3,4,428,16217,16645,0
Android|Bicycles|iOS|Mobile,30000.0,RUS,2,2,119,16191,16310,0
Semiconductors,6000000.0,USA,1,3,0,12914,12914,0
Software|Virtualization|Web Development,2000000.0,USA,1,1,0,14805,14805,0
App Marketing|Mobile,32034118.0,USA,3,2,1437,14396,15833,1
E-Commerce,1000000.0,IND,1,4,0,16398,16398,0
Software,3000000.0,CAN,1,1,0,15642,15642,0
Data Security|Enterprise Software,66999997.0,USA,4,8,3151,13465,16616,0
Oil and Gas,1498515340.0,USA,1,4,0,16274,16274,0
Contact Management|Content,10200000.0,GBR,1,1,0,11372,11372,0
E-Commerce,26000000.0,USA,2,4,775,13495,14270,1
E-Commerce|SaaS,5100000.0,USA,1,1,0,11516,11516,0
Software,10877634.317757001,CAN,2,3,1680,14102,15782,0
B2B|Enterprises|Software,21000000.0,USA,4,12,3518,12461,15979,1
E-Commerce,40000.0,PRT,1,1,0,14931,14931,0
Enterprises|Point of Sale|Retail|SaaS|Software,37500000.0,NZL,5,8,956,15198,16154,0
Financial Services|Hardware + Software|Mobile Payments|Vending and Concessions,10000.0,RUS,1,1,0,16276,16276,0
Mobile|Social Media,200000.0,CHL,1,1,0,15732,15732,0
Automated Kiosk|Hardware + Software|Retail Technology,160000.0,CHL,2,2,490,15911,16401,0
B2B|Reviews and Recommendations,1100000.0,USA,1,2,0,16533,16533,0
Information Technology,25000.0,USA,1,4,0,16128,16128,0
Network Security|Security|Small and Medium Businesses,845556.0,USA,4,4,1429,13880,15309,1
E-Commerce|Networking|Social Commerce|Social Media,559904.0,IRL,2,1,229,15130,15359,0
Hardware + Software,32500000.0,USA,4,5,752,15340,16092,0
Entertainment|Games|Video Games,7000000.0,USA,1,2,0,12115,12115,1
Business Intelligence|Loyalty Programs|Mobile|Restaurants,1000000.0,USA,3,7,685,15400,16085,0
Brand Marketing|Digital Media|Manufacturing|Media|News|Point of Sale|Retail,3000000.0,USA,3,20,412,15755,16167,0
Communications Infrastructure|Internet of Things|Transportation|Wireless,4900000.0,USA,1,3,0,16406,16406,0
Biotechnology,40220856.0,USA,3,5,1464,15040,16504,0
Finance|Mobile|Payments,1300000.0,USA,3,12,595,14592,15187,1
Cloud Computing|Development Platforms|Enterprise Software|Marketing Automation,20000.0,USA,1,1,0,16269,16269,0
Telecommunications,500000.0,GBR,1,3,0,16254,16254,0
Biotechnology,1127972.0,DEU,1,2,0,16689,16689,0
Brand Marketing|Business Development|SaaS|Software,3300000.0,USA,2,4,351,16134,16485,0
Automated Kiosk|Software|Technology,250000.0,CAN,1,1,0,14309,14309,0
Biotechnology,25508000.0,USA,3,1,1289,15427,16716,0
Analytics|Retail|Sales and Marketing|Software,74796.0,MEX,2,1,60,15980,16040,0
E-Commerce|Fashion|Flash Sales,600000.0,ARG,1,1,0,15827,15827,0
Clean Energy|E-Commerce|Events,50000.0,USA,1,1,0,16191,16191,0
E-Commerce,1690000.0,DEU,1,1,0,14809,14809,0
Biotechnology|Health Care|Pharmaceuticals,104502514.0,USA,4,12,3187,13149,16336,0
Manufacturing,10963708.0,USA,3,2,826,14428,15254,0
Clean Technology,1363726.0,GBR,1,2,0,15854,15854,0
Advanced Materials|Biotechnology|Genetic Testing|Hardware + Software|Life Sciences|Medical Devices|Nanotechnology|Specialty Chemicals|Specialty Foods,40000.0,PRT,1,1,0,15138,15138,0
Technology,20000000.0,NGA,1,1,0,16658,16658,0
Education,1550000.0,USA,2,1,1645,14791,16436,0
Software,20000000.0,IND,1,2,0,13837,13837,1
Electric Vehicles,6000000.0,USA,1,2,0,13742,13742,0
Apps|Services,2000000.0,USA,1,2,0,16617,16617,0
Internet|Media|News,3598474.0,USA,2,9,2345,13920,16265,0
EdTech|Education|Startups,25000.0,USA,1,2,0,15933,15933,0
Adventure Travel|Curated Web|Internet|iOS|Mobile|Outdoors,260000.0,USA,4,5,699,14488,15187,0
Education,295000.0,IND,2,8,637,15933,16570,0
Mobile,11460000.0,USA,5,6,2913,11312,14225,0
Career Management|Employment|Entrepreneur|Human Resources|Recruiting|Search,700000.0,USA,1,3,0,15904,15904,0
Computers|Events|Internet|Search,190000.0,USA,1,2,0,15253,15253,0
Curated Web|Marketplaces|SaaS,2000000.0,USA,1,6,0,16275,16275,0
Events,60000.0,USA,2,1,132,16287,16419,0
Career Planning|Curated Web|Events|Portals,41250.0,HKG,1,1,0,16405,16405,0
Events|Music Venues|Search|Weddings,1448741.0,AUS,3,4,643,15657,16300,0
Event Management,9000000.0,USA,1,3,0,16610,16610,0
B2B|Bridging Online and Offline|E-Commerce|Events|Marketplaces,60000.0,CAN,2,1,301,15796,16097,0
Beauty|Biotechnology|Medical Devices,30000000.0,CAN,2,2,530,16212,16742,0
Security,19220000.0,CHN,2,3,792,13118,13910,0
Search,650591.0,FIN,2,4,548,16126,16674,0
Enterprise Software|Local Search|Marketplaces|Online Reservations|SaaS|Sports,353586.534667675,AUT,2,1,166,16071,16237,0
Hardware + Software,2920103.0,USA,5,2,1686,14547,16233,0
Cloud Computing|Consumer Electronics|Data Centers|Enterprise Software|Networking|Security|Web Hosting,25000000.0,USA,1,1,0,14929,14929,0
E-Commerce|Manufacturing|Supply Chain Management,1235000.0,USA,2,3,197,16467,16664,0
Apps|B2B|SaaS,354262.0,SVK,2,1,633,15862,16495,0
Software|Video|Video Streaming,8300000.0,USA,1,2,0,14011,14011,0
Content|Databases|Games|Startups|Television|Video,70750000.0,USA,4,20,1068,12965,14033,1
Curated Web,1950000.0,USA,2,3,770,13634,14404,1
Medical Devices,250000.0,USA,1,1,0,15400,15400,0
Software,80000000.0,USA,1,1,0,15427,15427,0
Cyber|Mobile Security|Security,114260328.0,USA,6,26,3116,13208,16324,0
Biotechnology|Health Care|Health Diagnostics,70950000.0,USA,3,11,1113,14771,15884,1
Data Security|Enterprise Software,14000000.0,USA,1,3,0,16392,16392,0
Security,65500000.0,CAN,2,1,1704,14501,16205,0
Health Care,25233333.0,USA,4,6,2251,13442,15693,0
Health Care,81952864.0,USA,7,8,2225,14482,16707,0
Enterprise Software,47275000.0,USA,3,11,1464,12205,13669,0
Biotechnology|Health Care,70000000.0,USA,4,14,611,14929,15540,1
Big Data|Big Data Analytics|Cloud Data Services|Data Privacy|Health Care Information Technology|Information Services|Personal Data|SaaS,12500000.0,USA,1,2,0,16463,16463,0
Biotechnology,28217263.0,USA,7,4,2771,13685,16456,0
Web Hosting,10000000.0,USA,1,9,0,13552,13552,1
Information Technology,2300000.0,USA,1,15,0,16602,16602,0
Crowdsourcing|Curated Web|Developer APIs|Finance|FinTech|Language Learning|Messaging|Mobile|Translation|Travel,2448000.0,USA,3,3,879,15477,16356,0
EdTech|Education,3720000.0,USA,4,27,1321,15095,16416,0
Software,15640000.0,NOR,3,8,2170,13460,15630,0
Analytics,1514205.0,USA,2,4,503,15169,15672,1
Biotechnology,67000000.0,USA,5,20,2451,13706,16157,0
Clean Technology|Enterprise Software|Software,16542968.0,USA,4,14,1596,13017,14613,0
Clean Technology|Consumers|Residential Solar|Solar,42285194.0,USA,4,1,1478,14987,16465,0
Biotechnology,97309564.0,USA,2,1,1596,14097,15693,1
Health Care,4000000.0,USA,1,6,0,16737,16737,0
Health Care,8745000.0,USA,2,1,968,13997,14965,0
E-Commerce|Electronics|Internet|Manufacturing|Marketplaces,6386422.0,USA,4,2,1243,13391,14634,1
Health and Wellness,19000000.0,USA,4,6,2643,13468,16111,0
Software,20500000.0,USA,2,5,1252,12823,14075,1
Hospitals,15840000.0,USA,2,2,7,16616,16623,0
E-Commerce|Online Identity|Payments|Security,1350934.64746717,GBR,2,5,546,16176,16722,0
Finance|FinTech,13884996.0,USA,6,5,1984,13459,15443,0
EdTech|Education,1750000.0,USA,1,1,0,16091,16091,0
Databases|Drones|Manufacturing,2120253.0,IRL,1,1,0,16537,16537,0
Software,46799996.0,USA,7,15,4119,10957,15076,0
Software,3000000.0,USA,1,1,0,15972,15972,0
Health and Wellness,58250000.0,USA,3,3,938,14532,15470,1
Android|Apps|iOS|Mobile|Services|Web Development,800000.0,USA,1,10,0,15124,15124,0
Cloud Computing|Manufacturing,100948403.0,USA,10,22,4141,12112,16253,0
Software,2205565.0,GBR,1,1,0,12576,12576,0
Hospitals,1200000.0,USA,1,4,0,16729,16729,0
Games,17000000.0,USA,1,1,0,14929,14929,0
Mobile,22058331.0,USA,13,3,2069,14435,16504,1
Legal,20000000.0,USA,1,1,0,14840,14840,0
Application Platforms|Cloud Computing|Information Technology|Media,15000000.0,USA,1,3,0,16266,16266,0
Hardware + Software,819500.0,USA,1,1,0,15075,15075,0
Energy Efficiency|GreenTech|Oil and Gas,2500000.0,USA,1,1,0,15881,15881,0
Curated Web,266806.0,USA,1,1,0,14975,14975,0
Enterprise Software,29900000.0,USA,5,10,3034,13035,16069,0
Communications Infrastructure|Content Delivery|Networking|Video on Demand|Video Streaming,85000000.0,USA,3,10,863,13633,14496,1
Mobile,18500000.0,USA,2,7,401,12949,13350,1
Analytics,12700000.0,USA,1,3,0,13191,13191,0
Communications Infrastructure|Information Technology|Mobile,30079503000.0,USA,5,1,1494,14635,16129,1
Biotechnology|Diagnostics|Health Care,84392358.0,USA,4,2,1806,14621,16427,1
Networking|Network Security|Product Design,10000000.0,USA,1,3,0,12620,12620,0
Analytics|Big Data|Business Intelligence|Enterprise Software,550000.0,USA,1,2,0,16387,16387,0
Games|Web Design,1600000.0,CAN,2,3,1114,15181,16295,1
Biotechnology,11500000.0,GBR,1,1,0,15376,15376,0
Artificial Intelligence|Identity Management|Video,20000.0,PER,1,1,0,16071,16071,0
Enterprise Software,17500000.0,USA,4,10,700,15553,16253,0
Advertising|Digital Media,2000000.0,USA,3,10,785,15315,16100,1
Software,57350000.0,USA,2,4,1078,15671,16749,0
Computers|Software|Technology,2500000.0,USA,1,5,0,16749,16749,0
Brand Marketing|Event Management|Events,1000000.0,IND,1,1,0,16247,16247,0
Health Care,144499999.0,USA,6,22,1723,14397,16120,1
Software,7698003.0,USA,6,1,1674,14865,16539,0
Project Management|Software,26500000.0,USA,2,2,2680,13706,16386,0
Education,400000.0,USA,1,1,0,16734,16734,0
Analytics,2800000.0,USA,2,1,592,15957,16549,0
Clean Technology|Communities|Environmental Innovation|Internet|Risk Management|Social Media,155379.0,FRA,2,1,162,13869,14031,0
Analytics|Databases|Enterprises|Enterprise Software,30500000.0,USA,3,8,684,12874,13558,1
Semiconductors,7000000.0,USA,1,2,0,12794,12794,0
Business Services|Telecommunications|Wireless,58000000.0,USA,4,2,3561,12662,16223,1
Analytics,8875000.0,USA,1,1,0,16066,16066,0
Big Data|Entertainment|Marketplaces|Music|Sports|Startups,3000000.0,USA,1,1,0,16085,16085,0
Media|Publishing,778425.0,DEU,1,8,0,15670,15670,1
Clean Technology,1285623.0,GBR,1,3,0,14928,14928,0
SaaS,4000000.0,USA,2,1,448,13599,14047,0
Health Care,66798160.0,USA,8,3,3097,13535,16632,0
Engineering Firms|Optical Communications|Sensors,4350240.0,DEU,1,2,0,13235,13235,0
Business Intelligence|Cloud Computing|Telecommunications,7800000.0,USA,2,3,145,16184,16329,0
Biotechnology,78241437.0,USA,10,11,3305,13263,16568,0
Health and Wellness|Health Care|Pharmaceuticals,78000000.0,USA,1,7,0,12943,12943,0
Advertising|Advertising Platforms|Location Based Services|Mobile|Mobile Analytics,36896077.0,USA,7,5,2146,14162,16308,0
Health Care|Medical|Medical Devices,49195616.0,GBR,5,14,3310,13139,16449,0
Real Estate|Rental Housing,270000.0,USA,1,1,0,16386,16386,0
Hospitality,2624280.0,FRA,2,3,308,15832,16140,0
Consulting,40000000.0,RUS,1,2,0,13586,13586,0
Cloud Data Services|Hardware + Software|Internet of Things|M2M|Mobile,70391.0,TUR,2,2,241,15990,16231,0
Analytics,100000.0,USA,3,7,577,15706,16283,1
Content|Content Creators|Internet|Video,132500000.0,USA,2,9,297,16245,16542,0
Health Care,27700000.0,USA,2,5,286,14903,15189,1
Consumer Lending|Electronics|Payments,20000000.0,USA,1,1,0,12368,12368,0
Health and Wellness,18850000.0,USA,3,7,743,15944,16687,0
Biotechnology,24200000.0,USA,4,15,2556,13815,16371,0
Software,7900000.0,CAN,2,2,124,15615,15739,0
Financial Services,5000000.0,USA,1,1,0,16566,16566,0
Health and Wellness,10000000.0,USA,1,1,0,16247,16247,0
E-Commerce|Fashion|Marketplaces,68725050.0,FRA,4,12,1897,14784,16681,0
Crowdsourcing|Real Estate,25000.0,USA,1,1,0,16191,16191,0
Software,1200000.0,USA,1,1,0,16665,16665,0
Biotechnology,17500000.0,USA,2,6,2876,12033,14909,1
Cloud Computing|Enterprise Software|Finance,969471.0,GBR,6,5,730,15706,16436,0
DOD/Military|Social Media,150000.0,USA,1,1,0,15140,15140,0
Pets|Veterinary,120000.0,USA,1,1,0,16405,16405,0
E-Commerce,10500000.0,USA,2,4,376,15497,15873,0
Electronics|Manufacturing,27000000.0,GBR,1,4,0,13578,13578,0
Cloud Computing|Freemium|Health and Wellness|Health Care|Health Care Information Technology|Healthcare Services|SaaS|Software|Veterinary,2025000.0,USA,2,9,397,16158,16555,0
Software,15000000.0,USA,1,1,0,13573,13573,1
Software,6000000.0,USA,2,2,1897,11555,13452,1
Biotechnology,2785000.0,USA,2,1,215,15765,15980,0
Health and Wellness,8292558.0,USA,2,1,262,16013,16275,0
Biotechnology,3600000.0,USA,1,1,0,15901,15901,0
Advertising|Consulting,4938727.0,CHN,2,2,61,16049,16110,0
Enterprise Software,10250000.0,USA,1,4,0,12859,12859,1
Apps|Mobile|Photo Sharing|Video,3150000.0,USA,2,6,28,16191,16219,0
Photography|Real Estate|Services,4225000.0,USA,3,1,784,13684,14468,0
Curated Web|File Sharing|Internet|Television|Video|Video Streaming,10250000.0,USA,3,17,1030,15510,16540,0
Travel,5000000.0,IND,1,1,0,13670,13670,0
Hardware + Software,5380000.0,DEU,1,1,0,14783,14783,0
Apps|Real Time|Software|Technology|Transportation,37064136.0,USA,2,9,372,16155,16527,0
Curated Web,400000.0,USA,2,1,437,15422,15859,0
Finance,1630000.0,DNK,1,1,0,15544,15544,0
Hardware + Software|Information Security|Mobile Payments|SaaS,13956072.0,USA,4,2,1294,15216,16510,0
Biotechnology,20000000.0,USA,1,1,0,12419,12419,1
Health Care,19009671.0,USA,3,2,2981,11942,14923,0
Biotechnology,48000000.0,USA,1,6,0,11275,11275,0
Biotechnology,97600000.0,USA,6,15,3053,13271,16324,0
Transportation,25000.0,PRY,1,2,0,16427,16427,0
Social Media,57003656.0,FRA,5,11,2951,13300,16251,0
Curated Web|Databases|E-Commerce,65000000.0,USA,6,25,1437,12843,14280,0
Services|Telecommunications|Wireless,15000000.0,USA,1,4,0,11462,11462,1
Travel,19000000.0,BRA,3,7,974,14883,15857,0
Advertising,40000000.0,USA,2,3,663,16057,16720,0
Biotechnology,91149997.0,USA,5,15,3569,13021,16590,1
Collaboration|Retail|Sales and Marketing,30000.0,USA,1,1,0,16314,16314,0
Analytics,2016300.0,FRA,1,1,0,15313,15313,0
Data Centers|Services|Web Hosting,65000000.0,USA,1,1,0,15434,15434,1
Curated Web,4800000.0,USA,1,2,0,13149,13149,0
Hardware + Software|Internet of Things|Mobile Software Tools,111000.0,USA,5,3,701,15582,16283,0
App Marketing|Messaging,15000000.0,USA,1,1,0,14126,14126,0
Enterprise Software,800000.0,ISR,1,2,0,14483,14483,0
Social Media|Video,100000.0,USA,1,1,0,15826,15826,0
Health and Wellness|Wearables,1359471.0,USA,1,1,0,16296,16296,0
Clean Technology,2920000.0,GBR,1,1,0,14043,14043,0
Advertising|Content Delivery|Mobile Advertising|Online Video Advertising,17000000.0,USA,2,2,1949,11139,13088,0
Health Care,18750000.0,USA,2,3,1736,13746,15482,0
E-Commerce,3956447.0,DEU,2,5,544,15967,16511,0
Software,72000000.0,USA,5,30,1144,15522,16666,0
News|Television|Video|Video Streaming,570000000.0,USA,3,3,399,15918,16317,0
Biotechnology|Medical,16000000.0,USA,1,4,0,14790,14790,1
Social Media,600000.0,USA,1,1,0,15706,15706,0
Technology,6250000.0,USA,4,2,366,16375,16741,0
Cloud Computing|Customer Service|Customer Support Tools|SaaS|Software|Tech Field Support|Virtualization|Virtual Workforces,4383764.0,ESP,5,4,2042,13695,15737,0
Software,3600000.0,USA,1,3,0,14523,14523,0
Big Data|Internet|Publishing|Visualization,900000.0,USA,1,3,0,16467,16467,0
Customer Service|Online Reservations|Price Comparison|Resorts|Travel & Tourism,25600000.0,GBR,5,2,1288,15342,16630,0
Content Creators|Internet|Software|Video,25000000.0,USA,2,20,531,15706,16237,0
Enterprise Software|Fraud Detection|Mobile|Security|Software,5000000.0,USA,1,1,0,14957,14957,0
Consulting,1000000.0,CAN,1,2,0,15216,15216,0
E-Commerce|E-Commerce Platforms,1300000.0,USA,1,5,0,16386,16386,0
Biotechnology,2800000.0,USA,3,1,1961,14405,16366,0
Health and Wellness|Health Care|Health Care Information Technology|Healthcare Services,5000000.0,USA,1,8,0,16371,16371,0
Software,592000.0,ESP,1,2,0,13148,13148,0
Biotechnology,2550000.0,CAN,2,2,76,15820,15896,0
E-Commerce|Promotional|Video,525000.0,USA,3,2,283,15656,15939,1
Crowdsourcing|Digital Entertainment|Families|Parenting|Video Streaming,600000.0,USA,2,3,188,16085,16273,0
Software,1200000.0,USA,1,4,0,16177,16177,0
Consulting|Employment|Hospitality|Human Resources|Restaurants|Retail|Search|Video,2250000.0,USA,3,4,823,15095,15918,0
Corporate Training|Enterprise Software|Internet Marketing|Marketing Automation|Video,2500000.0,USA,2,4,396,15720,16116,0
Education|Internet|Video,100000.0,USA,1,1,0,16650,16650,0
Advertising|Mobile|Mobile Games|Monetization|Social Games|Video,1386731.0,FRA,2,3,689,15706,16395,0
Data Security|Security,18083087.0,USA,2,5,362,16190,16552,0
Corporate Training|Education|Training|Video,344638.0,USA,2,1,793,14643,15436,0
Media|Video Streaming,2340000.0,SGP,2,2,1002,15706,16708,0
E-Commerce|Fashion|Marketplaces|Retail,7545000.0,FRA,4,5,1538,14245,15783,0
News|Software|Video|Video Editing,18500000.0,USA,2,3,1000,15589,16589,0
Video Streaming,600000.0,USA,2,1,36,16642,16678,0
E-Commerce,66000000.0,USA,1,7,0,11275,11275,0
Advertising|Advertising Platforms|Digital Media|Marketplaces|Online Video Advertising|Television,17200000.0,USA,2,17,334,16416,16750,0
Advertising,41157.0,NLD,2,1,178,15222,15400,0
File Sharing|Mobile|Software|Technology|Video,140138.0,IRL,2,2,151,15979,16130,0
Advertising,9600000.0,CAN,1,2,0,13856,13856,0
Video,2000000.0,USA,1,1,0,12502,12502,0
Advertising Networks|Mobile Video|Online Video Advertising|Video,2100000.0,IRL,2,11,691,15675,16366,0
Photography,40000.0,CZE,1,1,0,15687,15687,0
Analytics,37535089.0,USA,6,12,2339,13629,15968,1
News|Video,30000000.0,GBR,1,2,0,13634,13634,0
Software,3650000.0,USA,2,13,375,15551,15926,0
Advertising|Content|Marketplaces|Video|Video Streaming,600000.0,USA,2,1,334,14761,15095,0
Ad Targeting|Advertising|Analytics|Digital Media|Mobile|Video|Video Streaming,134191580.0,USA,5,12,1918,13935,15853,0
Security,7400000.0,USA,3,6,978,13119,14097,0
Curated Web,12000000.0,USA,1,1,0,13571,13571,0
Apps|Communities|Video,1625000.0,USA,1,7,0,16538,16538,0
Games|Graphics|Video|Video Editing,1100000.0,USA,2,4,363,16210,16573,0
Advertising|Technology|Video,17441786.020704597,GBR,3,5,1301,14070,15371,1
Advertising|Big Data,3401479.0,FRA,3,2,1066,15095,16161,0
Personalization|Video|Web Tools,797203.0,ISR,2,3,520,15732,16252,0
Video|Video Processing|Virtual Worlds,3275000.0,FRA,4,4,553,16071,16624,0
Hardware + Software,28000000.0,USA,1,10,0,14975,14975,1
Advertising|Content|Content Syndication|Internet|Music|Sales and Marketing|Services|Technology|Video|Video Streaming,1271300.0,DEU,1,1,0,14849,14849,0
Biotechnology,4977547.0,GBR,1,2,0,16367,16367,0
Software,500000.0,IND,1,1,0,16606,16606,0
Advertising Exchanges|Video,4450673.0,USA,2,3,44,16029,16073,1
Analytics,12000000.0,USA,1,4,0,13074,13074,0
Content|Internet|Publishing,1250000.0,CAN,1,2,0,16421,16421,0
Intelligent Systems|Robotics,18885.0,GBR,1,1,0,15522,15522,0
Advertising|Brand Marketing|Marketing Automation|SEO|Video,4000000.0,USA,3,21,362,15400,15762,0
Apps|Communities|E-Commerce|Social Media,30000.0,ARE,1,1,0,16283,16283,0
Photography|Twitter Applications,500000.0,USA,1,1,0,14484,14484,0
Collaboration|Social Media|Video,668000.0,USA,2,3,180,15340,15520,1
Android|Software|Television|Video|Video Streaming,30000000.0,ISR,1,1,0,16288,16288,0
Big Data Analytics|Curated Web|Online Video Advertising,1000000.0,IND,1,1,0,16589,16589,0
Crowdsourcing|Internet|Video,41000.0,USA,2,1,253,16436,16689,0
Ad Targeting|Online Video Advertising|Social Media,496971.595775327,GBR,3,2,386,16344,16730,0
Software,28650000.0,USA,3,5,2257,13654,15911,0
Databases|Search|Video,360183.0,IND,1,1,0,15126,15126,0
Analytics|Big Data|Cloud Computing|E-Commerce|Enterprise Software|Internet Marketing|Media|SaaS|Sales and Marketing|Video,25650000.0,CAN,4,16,1323,15126,16449,0
Messaging,136415300.0,USA,11,40,2516,13791,16307,0
Software,35000000.0,USA,2,7,1456,11358,12814,0
Clean Technology|Hardware + Software|Nanotechnology|Solar,460244466.0,USA,11,26,2254,14406,16660,0
Health Care|Lighting|Medical,100000.0,USA,1,2,0,15949,15949,0
Commercial Real Estate|Real Estate|Technology,32000000.0,USA,4,10,1112,15519,16631,0
Facebook Applications|Internet Marketing|Messaging|Music|Network Security|Photo Sharing|Social Media|Video Streaming,6100000.0,ISR,3,4,940,15468,16408,0
Business Productivity|Productivity Software|Software,6500000.0,USA,1,2,0,12010,12010,0
Analytics|Augmented Reality|Computer Vision|Mobile|Photography|Video,12000000.0,USA,3,6,925,13962,14887,1
Advertising|Digital Media|Technology,166774.0,GBR,1,1,0,15900,15900,0
Enterprise Software,28660003.0,USA,6,6,2019,13960,15979,1
Analytics|Business Analytics|Health Care,8000000.0,USA,2,8,513,15845,16358,0
Reviews and Recommendations|Software,5000000.0,USA,1,4,0,13665,13665,0
Biotechnology|Health Care,265692385.0,USA,12,36,2774,13901,16675,0
Fashion|Lifestyle|Reviews and Recommendations,448615.0,KOR,1,1,0,15944,15944,0
Health Care Information Technology,495498.0,CAN,4,3,1729,14798,16527,0
Games|Video on Demand,3500000.0,CHE,2,1,183,13970,14153,0
Business Intelligence|Enterprise Software|Sensors,698135.0,GBR,2,2,667,15434,16101,0
Film Production|Video,25000.0,ARG,1,1,0,15400,15400,0
Big Data|Curated Web|Data Mining|Reputation|Social Media|Social Media Monitoring|Social Television|Twitter Applications,2000000.0,FRA,2,5,58,16260,16318,0
Health Care,8300000.0,NZL,3,2,1087,15340,16427,0
Biotechnology,7800000.0,USA,3,2,336,16154,16490,0
Hardware + Software,394000.0,ISR,1,1,0,14033,14033,0
Customer Service|Plumbers|Service Providers,11000000.0,USA,1,3,0,11346,11346,0
Analytics,10660000.0,USA,5,4,1225,14638,15863,0
Software,4359346.0,USA,3,1,1274,13514,14788,0
Software,120000.0,USA,1,1,0,14055,14055,0
Software,8025000.0,USA,3,3,1237,13237,14474,0
Advertising|Monetization,27337143.0,USA,5,23,2003,14396,16399,0
Hardware + Software|Wearables,805000.0,USA,4,2,472,15902,16374,0
Coupons|E-Commerce,6000000.0,RUS,2,1,343,14641,14984,0
Software,2455124.0,USA,4,1,1248,15300,16548,0
Photography,8856750.0,JPN,2,4,463,16110,16573,0
Entertainment|Mobile|News|Sports,7861607.0,CAN,2,2,135,13865,14000,1
Construction,900000.0,USA,1,1,0,16515,16515,0
Crowdsourcing|Curated Web|Entertainment|Television|Translation|Video|Video on Demand,24300000.0,USA,2,19,317,14951,15268,1
Heavy Industry|Innovation Engineering|Manufacturing,554187.0,DNK,1,1,0,16156,16156,0
Health and Wellness|Health Care|Medical|Therapeutics,2500000.0,USA,1,1,0,16216,16216,1
Enterprise Software,2752400.0,FIN,1,1,0,15030,15030,0
Entertainment,480000000.0,USA,1,3,0,16692,16692,0
Health Care,36000000.0,USA,1,1,0,16695,16695,0
Technology,40000000.0,USA,1,6,0,11246,11246,0
Clean Technology|Distribution,3400000.0,IND,3,3,1025,15431,16456,0
Curated Web,1400000.0,USA,1,1,0,15537,15537,0
Advertising|Internet|Tech Field Support,85000.0,IND,1,1,0,14700,14700,0
Curated Web,125000.0,USA,1,1,0,15614,15614,0
Enterprise Software|Group Buying|Procurement|SaaS|Services,4500000.0,USA,1,1,0,15431,15431,0
Retail,100000000.0,VNM,1,1,0,16615,16615,0
Analytics|Billing|CRM|Freemium|SaaS|Sales and Marketing|Subscription Businesses,37600000.0,USA,5,10,2496,12418,14914,0
Advertising|Apps|Games|Mobile|Wireless,6100000.0,USA,1,1,0,11809,11809,1
Media|Publishing|Wine And Spirits,50000.0,USA,1,1,0,16587,16587,0
E-Commerce,9000000.0,USA,3,1,754,13735,14489,0
Social Media,1500000.0,KOR,1,3,0,15431,15431,0
Video,1050000.0,USA,1,3,0,16239,16239,0
Automotive|Development Platforms|Embedded Hardware and Software|Mobile,6500000.0,USA,1,5,0,16594,16594,0
Hospitality,7000000.0,USA,1,1,0,16057,16057,0
Wine And Spirits,1174288.0,ITA,2,4,273,16314,16587,0
E-Commerce|Fashion,20000.0,AUS,1,1,0,15431,15431,0
Apps|Fitness|Health and Wellness|Marketplaces|Peer-to-Peer|Personal Health,1800000.0,USA,2,4,5,16097,16102,0
Fashion|Marketplaces|Mobile|Peer-to-Peer|Social Buying|Social Media,32592880.0,LTU,2,3,395,15706,16101,0
Advertising,1300000.0,USA,1,1,0,15224,15224,0
Agriculture|Drones|Technology,20000.0,USA,1,1,0,16287,16287,0
Hardware + Software,3780000.0,FRA,1,1,0,13311,13311,0
Fashion,16058170.0,USA,2,6,469,16126,16595,0
Designers|Fashion|Marketplaces,315000.0,IND,1,3,0,16406,16406,0
Semiconductors|Storage|Technology,187884937.0,USA,7,9,1352,14398,15750,1
Digital Media|Technology,3000000.0,SWE,1,1,0,16478,16478,0
Information Technology|Location Based Services|Maps|Media|Search|Social Media,740000.0,USA,3,5,688,15874,16562,0
Biotechnology,27226676.0,USA,4,8,2049,12732,14781,0
Software,2482058.0,DEU,3,6,1031,13843,14874,0
E-Commerce|Fashion|Shopping,70430000.0,CHN,3,5,151,14914,15065,1
Curated Web|Loyalty Programs|SaaS,400000.0,USA,1,7,0,16495,16495,0
Education|Fitness|Health and Wellness,40000.0,CHL,1,1,0,16222,16222,0
Education|Internet|Online Education|Startups,25000000.0,CHN,3,2,895,15826,16721,0
Customer Service|E-Commerce,20000000.0,CHN,1,2,0,14921,14921,1
E-Commerce,25073206.0,CHN,6,9,2534,12958,15492,1
Networking,33500000.0,USA,1,1,0,16140,16140,0
E-Commerce|Online Shopping|Retail,4040000.0,ESP,1,1,0,13924,13924,0
Bio-Pharm,4051316.0,AUT,1,3,0,16610,16610,0
Biotechnology,9430000.0,USA,3,2,578,13041,13619,0
Advertising|Enterprise Software|Social Media Marketing|Video,2900000.0,USA,2,21,274,16008,16282,0
Enterprise Software|Predictive Analytics|Publishing|Social Media Management|Social Media Monitoring,4325000.0,USA,2,2,178,14975,15153,1
Advertising,91449.0,ARG,2,3,110,15584,15694,0
Advertising|Social Media Advertising,20000.0,IND,1,1,0,15558,15558,0
Advertising|Online Video Advertising|Video,1600000.0,ITA,4,6,988,15553,16541,0
Advertising|E-Commerce|Internet Marketing,1950000.0,USA,2,2,229,15450,15679,0
Advertising|B2B|SaaS|Software,54000.0,USA,1,1,0,16455,16455,0
Biotechnology,60075000.0,USA,2,6,688,14573,15261,0
Clean Energy|Clean Technology,110500000.0,USA,4,7,1009,14396,15405,1
Clean Technology,67400000.0,USA,2,5,1005,13763,14768,0
Aerospace|Manufacturing,1000000.0,USA,1,5,0,16010,16010,0
Apps|Curated Web|Internet|Social Network Media,750000.0,USA,1,1,0,14295,14295,0
Cyber Security|Data Security|Developer APIs|Information Security|Network Security,875000.0,USA,2,16,450,16308,16758,0
Mobile,46500000.0,COL,2,8,291,15461,15752,0
Games,3860000.0,ESP,1,1,0,14040,14040,0
Active Lifestyle|Health and Wellness|Lifestyle,92000000.0,USA,1,2,0,16582,16582,0
Financial Services,27000000.0,USA,1,1,0,16281,16281,0
Biotechnology,1410000.0,BEL,1,2,0,13808,13808,0
Clean Technology|Enterprise Software|Hardware|Technology,142332152.0,USA,8,21,2099,13634,15733,1
Clean Technology|Smart Grid,29500000.0,USA,3,4,1527,14985,16512,0
Data Centers|Environmental Innovation|Services|Software,15000000.0,USA,2,4,626,14214,14840,1
Energy,25107.0,CYP,2,2,134,16241,16375,0
Biotechnology,18300000.0,USA,3,10,1644,14623,16267,1
Biotechnology,3600000.0,CHE,1,1,0,15384,15384,0
Biotechnology,20000000.0,GBR,1,6,0,13284,13284,0
Advertising,6620000.0,USA,3,31,281,15469,15750,0
Biotechnology,10795700.0,USA,3,1,1194,14623,15817,0
Data Security|Software,7589724.0,USA,2,5,173,16240,16413,0
Cloud Computing|Software|Storage|Virtualization,24000000.0,USA,3,10,790,14421,15211,1
Infrastructure|IT Management|Technology,12000000.0,GBR,1,3,0,13909,13909,1
Enterprise Software,25078167.0,USA,4,2,1174,14617,15791,0
Cloud Computing|IaaS|SaaS|Web Hosting,1990000.0,USA,3,21,269,16440,16709,0
Software,10255000.0,USA,2,1,50,16188,16238,0
Enterprise Software|Fitness|Health and Wellness|Nutrition|Personal Health|Software,3215657.15041847,NLD,2,2,1022,15713,16735,0
Games,169000.0,FIN,1,1,0,13809,13809,0
Software|Virtualization,4000000.0,USA,1,1,0,14630,14630,0
Software,643300.0,HUN,1,1,0,15979,15979,0
Software,1000000.0,KEN,1,1,0,14867,14867,0
Software,21000000.0,USA,2,5,145,14125,14270,1
Education,3566841.0,CAN,3,7,802,12769,13571,1
Medical Devices|Robotics,25700000.0,USA,5,8,3504,13149,16653,0
Enterprise Software,76510586.0,USA,6,5,1888,14463,16351,0
Software,44500000.0,USA,3,16,855,13052,13907,1
Advertising|News|Publishing,1275277.0,CAN,1,4,0,15282,15282,0
Health Care,3700000.0,ISR,2,2,933,14550,15483,0
Software,5700000.0,USA,1,3,0,16121,16121,0
Advertising|Social Media|Software,1550000.0,USA,2,2,43,15447,15490,0
Semiconductors,20000000.0,USA,1,9,0,11729,11729,0
Security,2000000.0,USA,1,2,0,16589,16589,0
Mobile|Software|Virtualization,29288979.0,USA,5,9,2203,12418,14621,1
Augmented Reality|Health and Wellness|Lifestyle|Medical|Mobile|Software,103037.0,GBR,1,1,0,16202,16202,0
Cloud Computing|Information Technology|Small and Medium Businesses|Web Hosting,250000.0,USA,1,1,0,16184,16184,0
Biotechnology,6800000.0,USA,2,2,3355,12093,15448,0
Software,3911750.0,USA,2,3,464,15012,15476,1
E-Commerce|Fashion|Health and Wellness|Mobile|Technology,625000.0,USA,1,6,0,16168,16168,0
Software,15178424.0,USA,2,1,1366,15127,16493,0
Software,17600000.0,USA,2,5,345,13346,13691,0
Curated Web,8380000.0,USA,5,23,787,15860,16647,0
CRM|Enterprise Software|Marketing Automation|Non Profit|Social Fundraising,700000.0,USA,2,3,344,16252,16596,0
Enterprise Software,38764000.0,USA,4,7,2365,13066,15431,1
Software,81216295.0,GBR,1,2,0,16330,16330,0
Technology,20000000.0,USA,1,4,0,12537,12537,1
Advertising|Apps|E-Commerce|Retail|Technology,1548035.54289606,SWE,2,2,358,15824,16182,0
Enterprise Software,129642925.0,USA,11,24,2016,14487,16503,1
Advertising,1759797.0,USA,2,2,62,15406,15468,0
Services,1829900.0,USA,1,1,0,16541,16541,0
Data Visualization|Graphics|Presentations|Software,2150000.0,USA,1,4,0,16604,16604,0
Enterprise Software,23950000.0,USA,5,11,2284,13683,15967,0
Advertising Platforms|Finance Technology|FinTech|Human Resources,600000.0,USA,1,3,0,16631,16631,0
Services,22100000.0,USA,1,1,0,16386,16386,0
Advertising|Advertising Platforms|Digital Media|Mobile Advertising,30000.0,DEU,1,2,0,16371,16371,0
Manufacturing,7930416.0,GBR,1,1,0,15390,15390,0
Public Transportation,5146400.0,FIN,1,2,0,16055,16055,0
Biotechnology,13385418.0,USA,3,4,720,13805,14525,0
Image Recognition|SaaS|Visual Search,3500000.0,SGP,1,3,0,16119,16119,0
Software,2060000.0,FRA,1,1,0,14245,14245,0
Software,212000.0,SWE,1,1,0,14685,14685,0
Insurance|Internet|Services,7500000.0,USA,1,2,0,11779,11779,0
CRM|Social Media|Software,1150000.0,USA,1,1,0,14610,14610,0
FinTech,800000.0,USA,1,7,0,15692,15692,0
Advertising,70800000.0,USA,8,27,3224,13149,16373,0
Advertising,33000000.0,USA,2,12,1610,12373,13983,1
Messaging,4500000.0,USA,3,2,607,14580,15187,0
Business Services|Social Media|Social Network Media,28400000.0,USA,3,9,748,12460,13208,1
Analytics|Brand Marketing|Social Media|Social Media Monitoring,83302652.0,USA,10,18,2901,13361,16262,1
Analytics|Facebook Applications|Monetization|Personalization|Twitter Applications,500000.0,CAN,1,1,0,15036,15036,0
Architecture|Construction|Mobile,250000.0,USA,1,2,0,16553,16553,0
Analytics|Business Intelligence|Human Resources|SaaS,46500000.0,CAN,3,5,1009,15222,16231,0
Finance,13200000.0,USA,3,1,572,15918,16490,0
Health Care,40000000.0,USA,1,7,0,14372,14372,1
Software,4230400.0,FRA,2,5,663,15015,15678,0
Software,42500000.0,CAN,4,6,2824,13445,16269,0
Health Care,108000000.0,USA,1,1,0,15091,15091,1
Curated Web,63767.0,JPN,1,1,0,15260,15260,0
Health Care,69200000.0,USA,5,15,4096,11869,15965,0
Advertising|Photography,11500000.0,CHN,1,1,0,16591,16591,1
Advertising,9000000.0,USA,1,1,0,13231,13231,0
Software,32000000.0,USA,1,6,0,13073,13073,0
Big Data|Enterprise Software,10196400.0,USA,5,1,1848,14890,16738,0
Leisure|Nonprofits|Travel|Travel & Tourism,67967.0212884966,USA,3,1,125,16615,16740,0
Travel,3600000.0,USA,1,2,0,13311,13311,0
Security,1320000.0,GBR,1,1,0,13180,13180,0
Apps|Cloud Computing|Enterprise Software|SaaS,1500000.0,USA,3,1,1293,15126,16419,0
Information Technology|Services,174297.0,GBR,1,1,0,16314,16314,0
Business Development|Business Services|Entrepreneur,27315200.0,IND,1,3,0,16216,16216,0
Biotechnology,44750281.0,USA,6,2,2918,13735,16653,1
Advertising,2825000.0,USA,2,3,58,15769,15827,0
Computers|Software|Technology,10500000.0,USA,1,4,0,12429,12429,1
Enterprise Software,50000.0,USA,3,3,729,14426,15155,0
Biotechnology,73399699.0,USA,5,21,1760,14585,16345,0
Mobile,221400000.0,USA,6,20,2749,12226,14975,0
Hardware + Software,18500000.0,USA,1,4,0,13038,13038,0
Advertising|Analytics|Marketing Automation|Market Research|Predictive Analytics|Software|Visualization,15000000.0,USA,2,3,675,14841,15516,0
Brand Marketing|Content|Presentations,15700000.0,USA,4,24,1232,15267,16499,0
Agriculture|Farming|Information Services,1272079.0,CHL,4,4,1505,15021,16526,0
Software,11425000.0,USA,2,1,2160,13000,15160,0
Analytics|Enterprises|Media|Optimization|Predictive Analytics|Real Time|SaaS,2212000.0,USA,2,7,182,15183,15365,1
Internet|Mobile|Photo Editing|Photography|Software,70000000.0,USA,2,5,353,16196,16549,0
Broadcasting,7200000.0,CZE,1,1,0,16233,16233,0
Health Diagnostics|Semiconductors,15137842.0,USA,13,5,1880,14613,16493,1
Biotechnology,8700000.0,USA,2,3,820,14641,15461,1
Curated Web,5000000.0,USA,1,2,0,13920,13920,0
Advertising,7350000.0,ISR,3,4,1024,15431,16455,0
Parenting,11700.0,USA,1,1,0,15946,15946,0
B2B|Games|Marketplaces|SaaS|Video,1000000.0,USA,1,1,0,15771,15771,0
Software,2700000.0,USA,2,4,1390,12478,13868,0
Digital Media|Enterprise Software|Video,500000.0,USA,1,1,0,13573,13573,0
Software,260000.0,USA,2,1,1176,14615,15791,0
Advertising|Auctions,1500000.0,USA,1,1,0,15126,15126,0
Hardware + Software,799000.0,DEU,2,3,330,13487,13817,1
Legal,25000.0,POL,1,1,0,15737,15737,0
Hospitality,4607432.0,BEL,4,4,1362,12698,14060,0
Health Care,7400000.0,USA,1,1,0,16465,16465,0
Audio|Consumer Electronics|Technology,500000.0,CAN,1,1,0,14309,14309,0
Bio-Pharm|Clinical Trials|Health Care Information Technology|Social Innovation|Testing,79000000.0,USA,4,10,1973,12431,14404,1
Hospitality,40000.0,USA,1,1,0,15209,15209,0
Commercial Real Estate,170000000.0,USA,2,5,2168,14097,16265,0
Dietary Supplements|Health Care|Personal Health,1000000.0,USA,1,1,0,16314,16314,0
Health Care,18507451.0,USA,4,1,1658,14925,16583,0
Hardware + Software,550000.0,USA,1,1,0,15943,15943,0
Enterprise Software,20000000.0,CAN,1,1,0,15559,15559,0
Career Management|Document Management|Recruiting,200000.0,AZE,1,1,0,15954,15954,0
Health Care,1000000.0,USA,1,5,0,13149,13149,0
Biotechnology|Health Care,205868476.0,USA,8,5,2340,13796,16136,1
Health and Wellness|Medical,3350000.0,BRA,4,1,1493,14730,16223,0
Apps|Health and Wellness|Health Care|iPhone|Service Providers|Software,25000.0,USA,1,1,0,15273,15273,0
Biotechnology,128660000.0,GBR,1,1,0,16041,16041,0
Software,2217553.0,EST,4,9,1060,15522,16582,0
Aerospace|Enterprise Software|Google Glass|Health Care Information Technology|Hospitals|Medical,1140000.0,USA,1,3,0,16471,16471,0
Health and Wellness,45319837.0,USA,4,8,1995,13879,15874,0
Biotechnology,20228478.0,USA,5,6,1008,14550,15558,0
Consumers|Digital Media|Health and Wellness|Internet|Medical|Physicians,4350000.0,RUS,3,5,848,15126,15974,0
Software,600000.0,RUS,1,1,0,15522,15522,0
Mobile,40000.0,CHL,2,1,333,15404,15737,0
Mobile,7730000.0,ESP,1,1,0,13258,13258,0
Technology,5500000.0,USA,1,4,0,12614,12614,0
Bio-Pharm|Health Care|Therapeutics,12000000.0,USA,1,1,0,13816,13816,0
E-Commerce|Fashion|iPhone|Mobile Commerce,500000.0,BRA,1,1,0,15927,15927,0
Advertising|Enterprise Software|Sales and Marketing|Social Media|Social Media Advertising|Social Media Marketing,33000000.0,USA,4,12,1753,13269,15022,1
Brand Marketing|Curated Web|E-Commerce|Fashion|Media|Shopping|Sports|Technology|Wine And Spirits,40000.0,CHL,1,1,0,15238,15238,0
Medical Devices,10000000.0,USA,1,2,0,16724,16724,0
Curated Web|Education|Peer-to-Peer,500000.0,USA,6,10,1370,14579,15949,0
Events,811421.726782713,ESP,1,14,0,16456,16456,0
Developer APIs|Services,30000000.0,USA,3,5,272,16486,16758,0
Games,40000000.0,CHN,3,5,1745,14263,16008,0
Active Lifestyle|Fitness|Mobile Commerce,57076.0,GBR,1,1,0,16071,16071,0
Artificial Intelligence|Clean Energy|Clean Technology|Home Automation|SaaS|Security|Software,435000.0,NOR,1,2,0,16514,16514,0
Software,1000000.0,KOR,1,1,0,16291,16291,0
Curated Web|Hardware,7000000.0,USA,2,2,383,13580,13963,0
Biotechnology,606672.0,BRA,1,3,0,13706,13706,1
Semiconductors,21500000.0,CHN,2,7,113,13458,13571,0
Health Care|Health Diagnostics,18405538.0,GBR,2,8,1086,13845,14931,0
Biotechnology,3974546.0,USA,2,1,1147,13651,14798,0
Healthcare Services|Medical|Medical Devices,11536200.0,IRL,1,1,0,14279,14279,0
Mobile|Telecommunications|Wireless,44500000.0,USA,1,5,0,12226,12226,0
Manufacturing|Service Industries,5400000.0,VNM,1,1,0,13788,13788,0
Biotechnology,30530000.0,CHE,1,2,0,13879,13879,0
Health and Wellness,23000000.0,USA,1,1,0,14923,14923,0
Hardware + Software,19210000.0,USA,2,1,1151,15431,16582,0
Games,5999997.0,USA,2,1,1477,13104,14581,1
Audio|Information Technology|Robotics,350000.0,GBR,2,8,221,16516,16737,0
Analytics|Application Performance Monitoring,2673000.0,USA,3,3,299,15625,15924,0
3D|Retail|SaaS,1663183.0,FIN,1,2,0,16338,16338,0
Health and Wellness,21380732.0,USA,4,4,679,15720,16399,0
Mobile|Wine And Spirits,11300000.0,USA,3,7,597,15306,15903,0
Home Automation|Security|Solar,565000000.0,USA,1,1,0,14886,14886,0
E-Commerce,300000.0,JPN,1,2,0,16306,16306,0
Games,1000000.0,CAN,1,1,0,13879,13879,1
Photography,25000.0,USA,1,1,0,14426,14426,0
CRM|Customer Service|E-Commerce|Enterprise Software,1934400.0,ITA,1,2,0,15595,15595,0
Content|Crowdsourcing|Events|Media|Mobile|Music|Photography|Social Media|Sponsorship,400000.0,USA,2,1,532,15461,15993,0
Point of Sale|SaaS|Software|Technology,10550000.0,CAN,2,3,1629,13117,14746,0
Construction|Design|Hospitality|Tourism,265064.0,ESP,1,2,0,15867,15867,0
Brand Marketing|Mobile,4653959.0,USA,2,3,220,16455,16675,0
Mobile,27200000.0,USA,3,8,1699,13732,15431,1
Audio|Media|Publishing|Robotics|Software,2300000.0,ISR,2,1,1461,13879,15340,0
Advertising|MMO Games|VoIP,22600000.0,USA,4,10,1758,13045,14803,0
Health Care,6230000.0,FIN,1,3,0,13033,13033,0
Enterprise Software,5660000.0,USA,5,5,2846,11109,13955,1
Messaging,3000000.0,USA,3,7,1071,14063,15134,1
Manufacturing,2500000.0,USA,1,1,0,15460,15460,0
Technology,8000000.0,USA,1,1,0,12102,12102,1
Games|Social Games|Social Media|Virtual Goods,5000000.0,USA,1,2,0,14358,14358,1
Hardware + Software,19185226.0,CAN,2,1,2604,13255,15859,0
Beauty,470000.0,USA,1,2,0,16434,16434,0
Web Hosting,4000000.0,USA,1,3,0,13787,13787,1
E-Commerce|Furniture|Home Decor,2082580.0,USA,2,2,294,16344,16638,0
Business Analytics|Consulting|Enterprise Application,100000.0,USA,1,1,0,16283,16283,0
Consumer Goods|Furniture|Hardware + Software,120000.0,USA,1,1,0,16267,16267,0
Software,16000000.0,USA,3,3,1283,13879,15162,0
Brand Marketing|Mobile|Reputation|Search|SEO,4705910.0,USA,5,6,813,14929,15742,1
Curated Web|Finance,1510000.0,USA,5,11,629,15156,15785,1
Manufacturing,4100000.0,CAN,1,2,0,15357,15357,0
Software,3500000.0,USA,1,2,0,12843,12843,0
Financial Services|FinTech|Software,1955915.0,GBR,2,3,854,15749,16603,0
Advertising,13075000.0,USA,4,12,2240,13199,15439,1
Ad Targeting|Advertising|Internet Marketing,27000000.0,IND,3,9,1293,14940,16233,0
Mobile|Mobile Devices|Network Security,7000000.0,CHN,1,2,0,16427,16427,0
Software|Virtualization,11655000.0,USA,2,5,468,13909,14377,1
Analytics|Deep Information Technology|Legal|Search|Semantic Web,5160800.0,ESP,1,1,0,15360,15360,0
Enterprise Software|Video Conferencing,1500000.0,USA,1,2,0,15400,15400,0
Audio|Developer APIs|Mobile|Telecommunications,26500000.0,USA,3,6,1020,13483,14503,1
Apps|Mobile|Software,42800000.0,USA,1,2,0,16541,16541,0
Biotechnology,55000000.0,USA,1,7,0,13315,13315,0
Biotechnology,13570000.0,USA,2,2,3123,13151,16274,0
Enterprise Software,4000000.0,CAN,1,2,0,14712,14712,0
Enterprise Software|Video,31500000.0,USA,5,12,1653,13208,14861,0
Software,3500000.0,USA,1,1,0,13439,13439,0
Advertising|Big Data|Cloud Computing|Facebook Applications|Hospitality|Hotels|Internet of Things|Loyalty Programs|Mobile|Promotional|Restaurants|Retail|Social Media|Transportation,5462000.0,USA,3,1,1063,15398,16461,0
Enterprise Software,60000000.0,USA,3,7,1148,15307,16455,0
Software,368500000.0,USA,2,2,21,13703,13724,1
Health Care|Hospitals|iPhone|Mobile,54700000.0,USA,4,4,2496,14184,16680,0
Mobile,3000000.0,USA,2,5,243,15870,16113,0
Collaboration|File Sharing|Group SMS|Mobile|Social Network Media|Video Conferencing,1500000.0,USA,2,2,235,15695,15930,0
Digital Entertainment|Digital Rights Management|Entertainment Industry|Video,19268235.0,USA,3,11,2308,13818,16126,0
Software,331465.0,SWE,1,1,0,14042,14042,0
Education|Language Learning,200000.0,POL,1,1,0,15288,15288,0
Call Center Automation|Cloud Computing|Contact Centers|Customer Service|Customer Support Tools|Mobile Commerce|Mobile Software Tools|Sales and Marketing|Sales Automation|Software|Telephony,75000000.0,FRA,2,2,351,16071,16422,0
Internet|Service Providers|Telecommunications,44500000.0,USA,2,10,982,11262,12244,1
Audio|Automotive|Mobile|Wearables,1275575.0,GBR,1,2,0,16241,16241,1
Advertising,40000.0,USA,1,1,0,15712,15712,0
Communications Hardware|Enterprise Software|VoIP,46617107.0,USA,17,20,3351,11864,15215,1
Audio|Biometrics|New Technologies|Sensors|Speech Recognition|Wireless,12700000.0,ISR,4,11,1626,14816,16442,0
Software,6400000.0,USA,1,2,0,12800,12800,1
Health Care Information Technology|Mobile|Software|Telecommunications,20729000.0,USA,7,11,4214,11808,16022,1
Enterprise Software,5420000.0,USA,5,6,1876,14411,16287,0
iPad|Photography|Video,944814.0,ISR,2,4,713,15156,15869,0
Web Hosting,7927687.0,GBR,1,1,0,15436,15436,0
Games,16570000.0,SWE,3,3,440,14565,15005,0
Education|Software|Training,803909.0,FRA,2,1,1127,14365,15492,0
Curated Web,21000000.0,CAN,2,8,323,16287,16610,1
Big Data|Big Data Analytics|Data Mining|Enterprise Software|Natural Language Processing|Speech Recognition,5700000.0,USA,2,2,1049,14867,15916,0
Music|Music Services,20203.0,DEU,1,1,0,15732,15732,0
Audio|Entertainment|iOS|Media,190558.575293636,ESP,3,4,92,16495,16587,0
Messaging,22300000.0,DEU,2,10,285,13062,13347,1
Advertising|Audio|Audiobooks|Digital Media|E-Commerce|Freelancers|Marketplaces|Media|Mobile|Video|Video Streaming,3295433.0,CAN,4,1,3474,13081,16555,0
Enterprise Software,2430000.0,DEU,1,2,0,13228,13228,0
E-Commerce,226110.0,BEL,1,1,0,14579,14579,0
Telecommunications,4400000.0,USA,1,1,0,11670,11670,0
Web Hosting,1250000.0,USA,1,1,0,13215,13215,0
Security|VoIP,9570000.0,CAN,2,2,93,13914,14007,0
Analytics|Big Data|Customer Service|Direct Sales|SaaS,2345000.0,USA,4,2,1184,15495,16679,0
Auto|Cars|Location Based Services|Online Rental|Public Transportation|Real Estate,19462066.0,FRA,3,9,933,15594,16527,0
Broadcasting|Software|Video Streaming,767000.0,USA,1,3,0,15083,15083,0
Software,7500000.0,GBR,2,3,1900,11139,13039,1
App Marketing|Mobile|SEO,1750000.0,JPN,1,1,0,15937,15937,0
Software,1100000.0,USA,1,3,0,13626,13626,0
Games,11500000.0,ISR,2,4,196,13580,13776,0
Consumer Internet|Software,500000.0,CAN,2,1,301,16303,16604,0
Finance|FinTech,14560000.0,USA,2,4,22,15965,15987,0
Advertising,12000000.0,USA,2,4,333,13623,13956,0
Analytics|Enterprises|Enterprise Software|Social Media,16900000.0,USA,3,6,906,15450,16356,1
Advertising Platforms|Electric Vehicles|Internet of Things|Real Estate,15810000.0,USA,8,13,1826,14770,16596,0
Databases|Data Security|Security,39225000.0,USA,4,15,3739,12374,16113,1
Clean Technology,40000.0,USA,1,1,0,15562,15562,0
Computers|Networking|Software|Storage|Virtualization,45200000.0,USA,4,15,1511,11429,12940,1
Semiconductors,21500000.0,USA,2,2,352,14089,14441,1
Ad Targeting|Advertising|Analytics|Big Data|Machine Learning|Mobile|Predictive Analytics|Real Time|Sales and Marketing,323834120.0,USA,6,5,2557,11323,13880,1
Analytics|Big Data|Databases,23410864.0,USA,4,9,1779,14859,16638,0
Finance|FinTech,20196482.7682734,NLD,5,13,3489,13149,16638,0
Electronics|Hardware|Printing,55000.0,CAN,2,3,208,16287,16495,0
Electrical Distribution|Energy|Manufacturing,9178624.0,USA,5,8,1204,15530,16734,0
Software,29243184.4131357,MAF,2,11,981,12800,13781,1
E-Commerce|Mass Customization,3000000.0,SWE,1,2,0,16324,16324,0
Search,2945400.0,ITA,1,1,0,13884,13884,0
Communities|High Schools|Nonprofits,4090277.0,USA,3,8,1169,15518,16687,0
Software,31634000.0,FRA,2,5,2674,13514,16188,0
Application Platforms|E-Commerce|E-Commerce Platforms|Mobile Commerce|SaaS|Software,90000000.0,USA,2,2,381,16083,16464,0
Augmented Reality|E-Commerce|Retail|Software,550994.0,IRL,3,3,787,15187,15974,0
Mobile|Telecommunications,460000000.0,USA,3,11,3913,12382,16295,1
Audio|Messaging,2192000.0,USA,2,3,737,14292,15029,0
Hotels|Travel|Vacation Rentals,150000.0,ARG,3,4,366,15764,16130,0
Software,35000000.0,USA,3,11,976,12395,13371,1
Software,300000.0,MEX,1,1,0,16252,16252,0
Internet|Media|Social Media,2600000.0,KOR,1,1,0,16578,16578,0
Apps|Mobile|Photo Sharing|Social + Mobile + Local,375000.0,USA,2,2,91,16170,16261,0
Internet,1000000.0,IND,1,1,0,16721,16721,0
Digital Media|EBooks,11250000.0,USA,3,11,1944,14659,16603,0
E-Commerce|Fashion|Lifestyle|Social Media,5500000.0,IND,2,4,493,16102,16595,0
Mobile,23119200.0,DNK,2,1,759,14026,14785,0
Hardware + Software,20686530.0,USA,7,6,1903,14359,16262,0
Cloud Security|Software,10000000.0,IRL,1,5,0,11570,11570,1
Analytics|Business Services|Consulting,431086.0,VEN,3,3,396,16191,16587,0
Enterprise Software,45000000.0,USA,4,15,3911,11971,15882,1
Analytics|Cloud Computing|Security|Software,8400000.0,USA,2,4,965,15224,16189,0
Child Care|Recruiting|Services,373385.0,COL,2,2,121,16405,16526,0
Software,22000000.0,USA,2,6,875,14144,15019,0
Hospitality,18000000.0,USA,1,2,0,15189,15189,0
Games|Social Network Media,49114248.0,ARG,6,8,2094,14033,16127,0
Customer Service|Polling|Surveys,692655.0,GBR,2,2,518,15887,16405,0
Advertising|Content|Contests|Enterprise Software|Facebook Applications|Internet|Photography|Social Media|Video|Web Tools,1260000.0,USA,1,1,0,13907,13907,0
Curated Web|Law Enforcement|Politics|Social Media,2250000.0,USA,2,18,519,14875,15394,1
Accounting|Finance|Legal|Marketplaces,7665000.0,GBR,4,5,970,15743,16713,0
Event Management|Facebook Applications|Gift Card|Social Media,808464.0,IRL,6,6,942,15584,16526,0
Facebook Applications|Local|Mobile|Payments|Peer-to-Peer|Social Media,1500000.0,CAN,1,1,0,16399,16399,0
Entrepreneur|Telecommunications|VoIP,67148.0,ITA,1,1,0,16495,16495,0
Communities|Enterprise Software,19023247.0,USA,4,5,1212,13514,14726,1
Consumer Electronics|Wearables,1647446.0,CHN,1,1,0,16071,16071,0
Advertising Platforms|Digital Media|News|Sports|Technology,307632220.0,USA,8,18,2480,14179,16659,0
Messaging|Mobile|Mobile Devices,18400000.0,USA,3,5,1128,15476,16604,0
Productivity Software|SaaS,3500000.0,USA,2,5,279,16072,16351,0
Enterprise Software|SMS|Telecommunications,1522481.0,BEL,1,1,0,13787,13787,1
Mobile|Telecommunications|VoIP,1500000.0,USA,1,3,0,16104,16104,0
Mobile,1600000.0,USA,2,7,536,15959,16495,0
Content Delivery|Linux|Web Hosting,5500000.0,USA,1,1,0,15058,15058,1
3D Technology|Electronics|Printing,12050000.0,USA,3,6,633,16007,16640,0
Chat|VoIP|Web Hosting,9000000.0,DEU,1,2,0,14560,14560,1
Mobile,30000000.0,USA,1,10,0,15381,15381,0
Social Media,50000.0,MEX,1,1,0,15936,15936,0
Enterprise Software,33000000.0,USA,3,11,1905,12815,14720,1
Messaging,15000.0,USA,1,2,0,14245,14245,0
Curated Web|Messaging|Software|VoIP,5300000.0,USA,1,1,0,15722,15722,0
Games,3500000.0,USA,2,6,731,13634,14365,1
Information Services|Innovation Management|Journalism|Startups,40000.0,CHL,1,1,0,16491,16491,0
E-Commerce,1000000.0,IND,2,2,359,16029,16388,0
Analytics|Market Research|Mobile|Surveys|Video,3257312.0,GBR,9,3,1007,15709,16716,0
Audio|Software|Speech Recognition,7850000.0,USA,3,4,3951,12233,16184,0
Internet,100000.0,USA,1,1,0,16661,16661,0
Travel & Tourism,225000.0,RUS,2,1,548,15492,16040,0
EdTech|Education|Language Learning,18800000.0,USA,7,27,1230,14657,15887,0
Health Care,46415000.0,USA,4,7,2098,13468,15566,0
Travel,54894.0,SWE,1,2,0,16072,16072,0
Biotechnology,105000000.0,USA,2,5,425,16113,16538,1
Health Care Information Technology|Health Diagnostics|Medical Professionals,200000.0,USA,2,1,274,16467,16741,0
Hospitality|Information Technology|Technology,2525000.0,USA,3,10,770,15778,16548,0
Non-Tech,210000.0,USA,1,1,0,13384,13384,0
Design|EdTech|Education|Finance|FinTech|Health Care|Security|Software Compliance,12000000.0,USA,1,7,0,12724,12724,1
E-Commerce,15000000.0,IND,2,1,1077,15636,16713,0
E-Commerce,40000.0,USA,1,1,0,15167,15167,0
CRM|E-Commerce|VoIP,150000.0,ESP,1,1,0,16108,16108,0
Emerging Markets|Social Media|VoIP,140270.0,BRA,2,2,487,15796,16283,0
Sales and Marketing|Software,2841000.0,ESP,2,6,483,13243,13726,0
Software,19765861.0,USA,3,12,1854,12843,14697,1
Audio|B2B|Mobile|Photography|Publishing|Software|Television|Video,5100000.0,ESP,1,1,0,13287,13287,0
Consumers,50000.0,RUS,1,1,0,15772,15772,0
Digital Media|Social Media|Video|Video Streaming,1800000.0,USA,1,12,0,16519,16519,0
Mobile|Software|Telecommunications|Video,33632000.0,USA,5,3,1821,13361,15182,1
Education,7500000.0,IND,2,3,813,14033,14846,0
Logistics Company,22400000.0,IND,1,1,0,16539,16539,0
Automotive|Cars|E-Commerce,108000000.0,USA,3,8,34,16602,16636,0
Healthcare Services|Insurance|Services,5000000.0,USA,1,1,0,13816,13816,0
Emerging Markets|Mobile Advertising|Mobile Commerce|South East Asia,18000000.0,IND,3,5,1321,15175,16496,0
Telecommunications,18000000.0,USA,1,2,0,11408,11408,0
Finance,10000000.0,USA,1,1,0,13675,13675,0
Enterprise Software|Networking|SEO,20000000.0,USA,1,1,0,14845,14845,1
Semiconductors,8800000.0,USA,2,2,434,13768,14202,0
Biotechnology,25000000.0,USA,1,5,0,16077,16077,0
Cyber Security|SaaS,600000.0,USA,2,2,195,16283,16478,0
Mobile,21000000.0,DEU,1,2,0,13939,13939,0
Automotive,6061005.0,GBR,1,1,0,15974,15974,0
Curated Web,900000.0,USA,2,2,211,15252,15463,0
Apps|Mobile|Mobile Commerce|Mobile Software Tools|Retail Technology|Software,409300.0,BRA,2,2,318,16283,16601,0
Biometrics|Cyber Security|Fraud Detection|Identity Management|Internet of Things|Mobile Devices|Mobile Payments|Mobile Security|Online Identity|Security,1035000.0,ARG,3,2,1978,13845,15823,0
Digital Media|Games|Television|Video on Demand,237179999.0,USA,4,8,1847,13634,15481,0
Consumers|Internet|Mobile|Social Television|Sports,250000.0,GBR,2,1,767,15126,15893,0
Mobile,5500000.0,USA,1,1,0,14657,14657,0
Advertising|Media|Mobile|Video,48100000.0,USA,5,8,1658,14001,15659,0
Games|Television,36000000.0,USA,3,12,1003,12935,13938,1
Manufacturing,5020000.0,USA,1,2,0,13361,13361,1
Travel,35982584.0,ESP,1,3,0,12557,12557,0
Media|Social Media,200000.0,USA,1,1,0,16024,16024,0
Software,90000.0,ZAF,1,2,0,16567,16567,0
Fantasy Sports,13300000.0,USA,2,18,1160,15374,16534,0
Advertising|Brand Marketing|Content|Digital Media|Email Newsletters|Social Media,40000.0,ARG,1,1,0,15373,15373,0
Cars|Ride Sharing|Transportation,11062158.0,FRA,2,6,722,15978,16700,0
Advertising Exchanges|Apps|Mobile|Mobile Advertising|Mobile Software Tools|Online Video Advertising|Video,25500000.0,USA,4,32,859,15248,16107,0
Search,10000000.0,USA,2,21,533,15756,16289,0
Analytics|Digital Media|Financial Services|Personal Finance,1000000.0,CAN,1,4,0,16554,16554,0
Career Management|Recruiting|Software,22200000.0,USA,2,5,947,12368,13315,1
Semiconductors,9000000.0,USA,2,2,321,16211,16532,0
Software,34000000.0,USA,3,10,518,13330,13848,1
Security|Services|Software|Web Development,350000.0,USA,3,2,905,13330,14235,0
Mobile,28800000.0,USA,4,1,648,15789,16437,1
Health Diagnostics|Software,50000.0,USA,1,1,0,16239,16239,0
Software,40800000.0,USA,4,15,1889,13404,15293,1
Broadcasting|Collaboration|Crowdsourcing|Entertainment|Film|Mobile|Music|Photography|Social Media|Video,2700000.0,USA,1,1,0,15540,15540,0
Biotechnology|Life Sciences,12300000.0,IND,3,8,1380,14914,16294,0
Fashion,2300000.0,IND,3,2,506,16167,16673,0
Curated Web,3000000.0,USA,1,5,0,15117,15117,0
Web Hosting,1515078.0,GBR,1,1,0,14798,14798,1
Health Care,66377963.0,USA,6,8,2627,13745,16372,0
Content Discovery|Internet TV|Mobile|Social Media|Video on Demand,825000.0,USA,1,2,0,16351,16351,0
Blogging Platforms|Crowdsourcing|Gamification|Social News,100000.0,CAN,1,1,0,16381,16381,0
Web Hosting,25000000.0,USA,1,1,0,13231,13231,0
Curated Web|Video,3000000.0,GBR,1,3,0,14853,14853,0
Internet|Taxis|Transportation,517241.0,BRA,1,1,0,16049,16049,0
Consumers|Hardware + Software,2470000.0,SGP,2,2,131,15841,15972,0
Hardware + Software,1200000.0,USA,1,1,0,13129,13129,1
Product Design|Sales and Marketing|Service Providers,30000000.0,USA,1,1,0,13822,13822,0
Web Hosting,10000000.0,USA,2,3,388,13080,13468,0
Software,78000000.0,CHN,4,4,434,15971,16405,0
Hardware + Software|Telecommunications,1010000.0,GBR,1,2,0,13732,13732,0
Clean Technology,11300000.0,USA,1,1,0,16140,16140,0
Apps|Crowdsourcing|Pets|Technology,2450000.0,USA,1,8,0,16562,16562,0
E-Commerce,16876.0,USA,1,1,0,16493,16493,0
Finance|Financial Services|Small and Medium Businesses,2000000.0,CAN,1,3,0,16413,16413,0
Internet,1100000.0,USA,1,5,0,16190,16190,0
Education,855000.0,USA,4,1,1325,15244,16569,0
Cloud Data Services|Data Visualization|Enterprise Software,2000000.0,USA,2,1,174,16130,16304,0
Beauty|Curated Web|Fitness|Health and Wellness|Spas,110755159.097956,GBR,5,13,2679,13923,16602,1
Finance|FinTech,13000000.0,CHN,3,2,853,15126,15979,0
Design|Enterprise Software,1900000.0,USA,1,9,0,16665,16665,0
Music|Social Media|Utilities,75000.0,ISR,1,1,0,16679,16679,0
Software,7650000.0,USA,1,1,0,12114,12114,0
Crowdsourcing|Mobile|Social Media,3000000.0,USA,2,1,829,15479,16308,0
Augmented Reality|Wearables,5300000.0,ISR,2,1,490,16253,16743,0
Clean Technology,3160000.0,USA,1,4,0,14040,14040,0
Apps|Big Data|Consumer Behavior|Software,1000000.0,NLD,1,4,0,14032,14032,0
Education|K-12 Education,250000.0,IND,1,1,0,16161,16161,0
Mobile,8600000.0,CHN,2,2,335,14944,15279,0
Mobile|Small and Medium Businesses|Software|Spas,250000.0,USA,1,2,0,16019,16019,0
Advertising|Analytics|Big Data|Location Based Services|Mobile|Retail|Wireless,4159800.0,FIN,2,5,209,15812,16021,0
E-Commerce|Fashion|Local|Search|Shopping,650000.0,USA,2,2,252,15553,15805,0
Beauty,33300000.0,USA,4,25,691,16015,16706,0
Customer Support Tools|Enterprise Software|Project Management|Sales and Marketing|Training|User Experience Design,42500000.0,USA,4,12,1154,15442,16596,0
Location Based Services|Price Comparison|Real Estate|Rental Housing,2000000.0,USA,1,4,0,15352,15352,1
Hotels|Marketplaces|Networking|Online Travel|Travel|Travel & Tourism,1300000.0,USA,1,20,0,16560,16560,0
Cloud Computing|Credit|Finance,1100000.0,USA,1,8,0,15582,15582,1
Coupons|Hospitality|Loyalty Programs|Virtual Currency,19299.0,GBR,1,1,0,15950,15950,0
Consumer Goods|Food Processing|Specialty Foods,233644.0,BRA,1,1,0,13494,13494,0
Consumer Electronics|Internet of Things,4000025.0,USA,5,2,396,16282,16678,0
iPhone|Location Based Services|Mobile|Social Media,1200000.0,USA,1,2,0,15405,15405,0
Accounting|Hardware + Software|Security,8944808.0,FRA,5,8,2432,13801,16233,0
Sports,187967.0,GBR,1,1,0,16071,16071,0
Brand Marketing|Design|E-Commerce|Graphics,200000.0,USA,1,1,0,16329,16329,0
Curated Web|Social Buying,300000.0,ESP,1,1,0,15340,15340,0
Application Platforms|Developer APIs|Development Platforms|Identity|Mobile|NFC|PaaS|QR Codes,82112.0,LVA,1,1,0,15998,15998,0
Financial Services|FinTech|Risk Management,16249.0,FRA,1,1,0,16635,16635,0
Apps|Direct Marketing|Exercise|Health and Wellness|Maps|Mobile,50000.0,USA,1,1,0,16199,16199,0
Social Media|Social Network Media,4111500.0,GBR,1,1,0,13757,13757,0
Networking,70000000.0,CHN,1,2,0,16161,16161,0
Sports,110000.0,USA,1,1,0,15440,15440,0
Games,231340000.0,KEN,4,5,1839,14510,16349,0
Blogging Platforms|Curated Web|Finance|FinTech|Local|Reviews and Recommendations|Social Travel,1200000.0,USA,2,9,49,15400,15449,1
Mobile,26000000.0,USA,5,6,1136,15340,16476,0
Reviews and Recommendations|Travel,1400000.0,USA,2,6,549,14457,15006,1
Advertising|Comparison Shopping|Internet Marketing|Local Coupons|Online Shopping|Price Comparison|Shopping|Social Buying,50500000.0,USA,4,15,580,15608,16188,0
Online Travel|Travel,275000.0,ITA,1,3,0,16040,16040,0
Curated Web|Transportation|Travel,8050000.0,USA,2,17,461,15918,16379,0
Big Data|Open Source|Software,91466131.0,USA,4,5,966,15492,16458,1
Android|Apps|App Stores|Mobile,128000000.0,CHN,2,7,1107,14975,16082,0
Travel,3500000.0,USA,1,2,0,12899,12899,0
Curated Web|E-Commerce|Retail|Social Buying,14000000.0,USA,3,11,647,15497,16144,0
Social Media,1639344.0,CHN,1,1,0,16040,16040,0
Education,40000000.0,CHN,1,2,0,15614,15614,0
Telecommunications,16633126.0,CHN,4,6,823,13665,14488,0
Games,11120000.0,CHN,2,5,548,13239,13787,0
Application Platforms|Customer Service|Services|Travel,40000.0,BRA,2,1,341,15911,16252,0
Brand Marketing|Internet|Internet Marketing|Small and Medium Businesses|Social Media Marketing|Social Network Media,2750000.0,USA,2,4,833,15553,16386,0
Analytics|Curated Web|Events|Local|Mobile,811670.0,USA,3,7,1531,15095,16626,0
Online Dating,450000.0,RUS,1,1,0,15553,15553,0
Enterprise Software,23000000.0,USA,6,6,1239,13970,15209,1
Analytics,13622803.0,USA,6,9,5565,10592,16157,1
E-Commerce|Fashion|Online Shopping|Product Search|Search,1356320.0,CAN,3,15,620,15482,16102,1
E-Commerce,5500000.0,USA,1,8,0,15419,15419,0
E-Commerce,600000.0,DNK,1,1,0,15779,15779,0
Curated Web|E-Commerce|Fashion|Finance|Retail,1018000.0,USA,3,6,405,15156,15561,0
EdTech|Education,21000000.0,CHN,3,7,2366,13910,16276,0
Cloud Computing|Document Management|Enterprise Software|File Sharing|Productivity Software|SaaS|Startups,1200000.0,USA,2,1,456,14975,15431,0
Mobile Commerce|Online Video Advertising|Photography|Social Television,650000.0,USA,1,1,0,15945,15945,0
Advertising,8000000.0,CHN,2,2,217,13175,13392,0
E-Commerce|Fashion|Retail,100000.0,USA,1,2,0,15873,15873,0
SaaS,248900.0,GBR,1,1,0,16197,16197,0
E-Commerce|Fashion|Retail,115500000.0,USA,6,32,1646,14909,16555,0
Games|Online Gaming|Social Games,496044.504378052,IRL,1,1,0,16733,16733,0
E-Commerce,70000.0,DNK,1,1,0,15584,15584,0
Search,125000000.0,BRA,1,3,0,15350,15350,0
Customer Service|Retail|Web Hosting,19252.0,SRB,1,1,0,16159,16159,0
Auctions|DOD/Military|E-Commerce|Marketplaces,3600.0,GBR,1,1,0,15034,15034,0
Analytics,400000.0,GBR,1,2,0,15765,15765,0
Manufacturing,1894064.0,GBR,1,3,0,16034,16034,0
Software,1190000.0,GBR,1,1,0,14053,14053,0
Advertising|Event Management|Social Media,120000.0,USA,1,1,0,15492,15492,0
Biotechnology,2682631.0,USA,3,1,888,15364,16252,0
Clean Technology,1989571.0,USA,3,1,1145,14039,15184,0
Education,7800000.0,USA,1,1,0,15938,15938,0
Service Industries,16820000.0,USA,4,28,523,15707,16230,0
Delivery|Mobile|Retail,2500000.0,IND,2,2,1216,15350,16566,0
Consulting,7500000.0,USA,1,2,0,14086,14086,0
Games,4000000.0,DNK,2,2,2663,13704,16367,0
Consulting|CRM|Services,3000000.0,USA,1,1,0,11498,11498,1
Enterprise Software,35750000.0,USA,4,13,1642,14092,15734,1
Consumer Electronics|Gps|Kids,478000.0,NLD,3,1,199,15992,16191,0
Brand Marketing|Consumer Goods|Online Shopping,10000000.0,GBR,1,2,0,16323,16323,0
Telecommunications,26600000.0,USA,1,5,0,11670,11670,0
Curated Web|Social Media|Social Television|Television,130000.0,USA,5,5,399,14851,15250,0
News,4250000.0,USA,3,19,725,15655,16380,0
Advertising|Advertising Platforms|Mobile Advertising|SaaS|Social Media Marketing|Social Television|Television,12272810.0,USA,3,4,871,15881,16752,0
Entertainment|Music|Television|Theatre,310066.0,GBR,1,1,0,15949,15949,0
Clean Technology,29000000.0,USA,5,6,2835,13502,16337,0
Clean Technology,1020000.0,GBR,1,4,0,12935,12935,0
Energy|Oil,8358950.0,USA,1,3,0,16602,16602,0
Mobile|Sensors|Visualization,1325610.0,DNK,2,3,396,15999,16395,0
Consumer Goods,325474.0,GBR,1,1,0,16283,16283,0
Software,1122194.0,KOR,1,1,0,15156,15156,0
Databases|Mobile|Services|Telecommunications,55000000.0,USA,2,4,1124,10957,12081,0
Health Care,33000000.0,USA,2,7,176,13606,13782,0
Data Centers,7000000.0,USA,2,3,319,16040,16359,0
Health Care,45290236.0,USA,4,1,2157,14378,16535,0
Software,13350000.0,USA,4,15,1422,15110,16532,0
Specialty Chemicals|Swimming|Water Purification,232239.0,GBR,1,1,0,15825,15825,0
Enterprise Software,15304039.0,GBR,1,1,0,16078,16078,0
Clean Technology|Internet of Things|Renewable Energies|Solar,2679720.0,NLD,4,1,641,16020,16661,0
Analytics|Media|Water,487445.0,CAN,2,1,956,15757,16713,0
Medical,4700000.0,USA,2,12,832,15911,16743,0
Clean Technology,6393044.0,GBR,1,2,0,14130,14130,0
Software,2410000.0,USA,1,1,0,14769,14769,0
Building Owners|Energy Efficiency|Renewable Energies,48484.0,AUS,2,4,209,16372,16581,0
Clean Energy|Software|Technology,878619.0,IRL,1,2,0,15979,15979,0
Curated Web|Digital Media|Entertainment|Mobile|Social Media,66800000.0,CAN,5,18,1548,14620,16168,0
Advice|Babies|Communities|Content|Digital Media|E-Commerce|Fashion|Kids|Parenting|Toys,1631712.0,GBR,3,4,340,15871,16211,0
Accounting|Apps|Billing|Cloud Computing|Freelancers|Human Resources|Internet|Mobile|SaaS|Small and Medium Businesses|Software|Web Development,34557478.0,CAN,5,15,1458,15109,16567,0
Cable|Internet|Web Hosting,1180000000.0,USA,2,5,918,15658,16576,0
Finance|Mobile Payments|Payments,32929912.0,GIB,4,2,2022,14705,16727,0
Biotechnology,84000000.0,USA,2,10,197,16468,16665,1
Technology,59500000.0,USA,3,17,877,11745,12622,1
Health Care|Medical|Women,100000.0,CAN,1,1,0,16213,16213,0
Hardware + Software,884652.0,USA,1,2,0,15629,15629,0
Apps,125000.0,ISR,1,2,0,16129,16129,0
Application Platforms|Cloud Computing|Enterprise Application|Enterprise Software|Open Source|PaaS|Web Development,15920000.0,USA,4,6,2031,12983,15014,1
Internet|Wireless,10000000.0,CAN,1,2,0,10948,10948,0
Semiconductors,22110000.0,CAN,3,11,3067,11211,14278,1
Technology,20000000.0,USA,1,6,0,11757,11757,0
Manufacturing,35000035.0,USA,2,1,1064,13270,14334,1
Software,350000.0,USA,1,1,0,14158,14158,0
Biotechnology,91143286.0,USA,10,10,2471,13664,16135,1
Curated Web,2000000.0,USA,1,11,0,14791,14791,1
Games|Gamification|Health and Wellness|Internet|Personal Health,14100000.0,USA,4,25,1380,15246,16626,0
Mobile,36132514.0,USA,4,10,1567,12760,14327,1
Education|High Schools|High School Students|Language Learning,602103.0,IRL,3,3,824,15737,16561,0
Travel,5000000.0,USA,1,1,0,16574,16574,0
E-Commerce|Furniture|Retail,358000000.0,USA,3,9,990,15146,16136,1
Advertising|Search,850000.0,FRA,3,2,622,15279,15901,0
Application Platforms|Internet of Things|Mobile,2172045.0,USA,5,7,503,16018,16521,0
Facebook Applications|Social Media|Social Media Marketing|Social Media Monitoring|Social Media Platforms|Social + Mobile + Local|Social Search|Twitter Applications,49232091.0,USA,6,8,1571,15132,16703,0
Application Performance Monitoring|Databases|Motors,2200000.0,USA,1,2,0,16701,16701,0
Photography|Social Media|Social Network Media|Travel,11000000.0,GBR,2,7,2022,13453,15475,0
Tourism|Travel|Travel & Tourism,270862.0,ESP,1,1,0,16233,16233,0
Electronics|Families|Marketplaces,714740.0,ESP,1,1,0,16594,16594,0
Aerospace,85000000.0,USA,1,1,0,16519,16519,0
Hardware + Software,35000000.0,USA,2,9,877,11757,12634,1
Education|Freelancers,8968000.0,USA,3,16,224,16331,16555,0
Marketing Automation,455452.90996455104,GBR,1,1,0,16707,16707,0
Mobile|Software,25000.0,USA,1,1,0,16267,16267,0
Beauty|Big Data|Hardware + Software|Internet of Things|Services,202000.0,KOR,4,4,70,16435,16505,0
Entertainment|News|Politics|Social Media,1750000.0,USA,1,6,0,15521,15521,1
Navigation|Transportation,67000000.0,USA,3,9,1326,13939,15265,1
Software,1136438.0,GBR,1,2,0,16167,16167,0
Sports,2000000.0,USA,1,1,0,14048,14048,0
Apps,30000.0,IND,1,1,0,16371,16371,0
FinTech,2938747.14466276,USA,3,2,442,16283,16725,0
Big Data Analytics|Business Intelligence|Data Visualization|Enterprise Software,5000000.0,FRA,2,2,1603,14427,16030,1
Video|Video on Demand,2000000.0,GBR,2,4,525,16111,16636,0
Forums|Graphics|Internet|Music|Peer-to-Peer|Software|Twitter Applications,3000000.0,USA,1,1,0,13757,13757,0
E-Commerce|Fashion,150000.0,ESP,1,3,0,15839,15839,0
Mobile|Photo Sharing|Social Media,8000000.0,USA,2,5,263,15883,16146,0
Film|Games|Social Games|Social Media|Video Games,5000000.0,GBR,2,3,94,15107,15201,0
Finance,6189808.0,USA,4,4,1073,15628,16701,0
Analytics,13800001.0,USA,5,8,1541,14669,16210,0
Crowdfunding|Finance|FinTech,5229072.0,USA,4,5,757,15925,16682,0
Finance|FinTech|Personal Finance|Stock Exchanges|Wealth Management,129500000.0,USA,5,42,2141,14229,16370,0
Finance|Wealth Management,1705529.0,USA,2,4,167,16415,16582,0
Finance|Impact Investing|Investment Management,25657346.106503896,CAN,2,7,206,16328,16534,0
Software,12805001.0,USA,3,3,1731,14361,16092,0
Education|Financial Services|Mobile Games,75000.0,AUS,3,3,405,15887,16292,0
Augmented Reality|Mobile|Technology,188771.0,ITA,2,1,196,16239,16435,0
Hospitality,16151032.0,GBR,1,2,0,15468,15468,0
Crowdsourcing|Fashion|Manufacturing|Mobile,135000.0,CZE,2,1,193,16122,16315,0
Software|Wearables,7874243.0,USA,1,9,0,16302,16302,0
Advertising|Health Care Information Technology|Internet|Social Media|Social Network Media,50000.0,USA,1,3,0,14092,14092,0
Video,75836.0,GBR,1,1,0,16442,16442,0
Commercial Real Estate|Marketplaces,2721000.0,GBR,4,10,577,15584,16161,0
Mobile,20200000.0,USA,3,10,821,14610,15431,1
Consumer Electronics|Wearables,25000.0,USA,1,2,0,15898,15898,0
E-Commerce|Fashion|Shopping,1500000.0,THA,2,8,418,16285,16703,0
Analytics|Clean Technology,15495815.0,USA,3,2,788,15922,16710,0
News,38000000.0,USA,2,6,1369,11109,12478,0
Curated Web|E-Commerce|Fashion|News|Search|Shopping,500000.0,USA,1,1,0,14836,14836,0
Crowdsourcing|Mobile,1010000.0,USA,2,8,444,15459,15903,1
Curated Web|Online Reservations|Travel,625000.0,RUS,2,2,248,16040,16288,0
Dental|Medical|Telecommunications|Veterinary,20500000.0,USA,2,15,510,16232,16742,0
Location Based Services|Mobile|Professional Networking,120000.0,USA,1,5,0,16191,16191,0
Apps|Operating Systems|Software,118000.0,GBR,1,1,0,16622,16622,0
Software,2550000.0,USA,2,14,137,16237,16374,0
Artificial Intelligence|Chat|Internet of Things|Machine Learning|Messaging|Mobile|Watch|Wearables,100000.0,USA,2,2,43,16405,16448,0
Application Performance Monitoring|Networking|Open Source,5000000.0,GBR,1,1,0,16407,16407,0
Service Providers|Software,18852.0,AUT,1,1,0,15586,15586,0
Retail|Software,2590800.0,FRA,1,3,0,15603,15603,0
Analytics|B2B|Big Data|Business Services|Consulting|Information Technology,280908.34522512,LTU,1,1,0,16679,16679,0
Analytics|Big Data|Big Data Analytics|Business Intelligence|Data Integration|Real Time,32000000.0,USA,3,8,1231,15461,16692,0
Enterprise Software,3000000.0,USA,1,2,0,14860,14860,0
Customer Service|Internet|Optimization|Web Development,51701.0,ESP,1,1,0,15949,15949,0
Analytics|Content Syndication|E-Commerce Platforms|Publishing|SaaS|Sales and Marketing|Software,20643295.0,USA,5,7,1284,13643,14927,1
Android|Apps|Internet|iPhone|Mobile|Web Development,19311.0,GBR,1,1,0,14858,14858,0
Curated Web|Finance|Home Automation|Internet of Things,509000.0,USA,1,4,0,16040,16040,0
Big Data,4541222.0,DEU,2,4,774,15716,16490,0
Hardware + Software,1910000.0,FRA,1,1,0,14861,14861,0
Internet,2000000.0,USA,1,1,0,11409,11409,1
Advertising,446000.0,GBR,1,1,0,14232,14232,0
Software,1500000.0,USA,3,6,375,15765,16140,0
Software,9500000.0,USA,1,2,0,13300,13300,0
Accounting|E-Commerce|SaaS,2500000.0,USA,1,1,0,16506,16506,0
Software,18500000.0,USA,2,9,406,12542,12948,1
Curated Web|Information Technology|Software,7300000.0,RUS,1,4,0,16286,16286,0
Collaboration|Communities|Enterprise Software|Networking,2000000.0,GBR,1,1,0,13600,13600,0
Software,10000000.0,USA,2,6,548,13710,14258,0
E-Commerce,6000000.0,USA,1,1,0,16301,16301,0
Software,5235714.0,USA,8,2,2679,14022,16701,0
Domains|Moneymaking|Virtual Worlds,3300000.0,CAN,1,1,0,13713,13713,0
Technology,6000000.0,USA,1,5,0,11373,11373,0
Advertising,825800.0,GBR,2,2,335,14232,14567,0
Apps|Enterprise Application|Mobile,757155.0,GBR,1,2,0,16550,16550,0
Publishing|Social Media,5000000.0,USA,2,2,505,13634,14139,0
Electronic Health Records|Software,1000000.0,USA,2,1,1289,14957,16246,0
Security,108912913.0,USA,2,3,2141,12821,14962,0
Analytics|Direct Marketing|Email Marketing|Loyalty Programs|Marketing Automation,307260.0,GBR,2,8,122,15949,16071,0
Security,18000000.0,USA,1,4,0,13416,13416,1
Internet|Internet Marketing|Services,10000000.0,IND,1,1,0,13131,13131,1
Curated Web,644000.0,AUS,1,1,0,14686,14686,0
Incubators|Internet,728375.0,GBR,3,3,426,15979,16405,0
Curated Web|Health and Wellness|Language Learning|Lifestyle,3200000.0,JOR,2,3,347,15981,16328,0
E-Commerce|Fashion|Mens Specific|Outdoors|Sports|Women,232501.0,GBR,1,4,0,15534,15534,0
Hardware + Software|Television,15174199.0,USA,3,1,1853,14918,16771,0
Commodities|Consumer Goods|Groceries|Service Industries,400000000.0,USA,2,5,568,10227,10795,0
Public Relations,1060618.0,USA,4,1,1829,13879,15708,0
Advertising|Internet Marketing|Local Advertising|Sales and Marketing|Software,37000000.0,USA,3,5,1624,13027,14651,0
Information Technology,165000.0,USA,1,1,0,13325,13325,0
Internet,4200000.0,ISR,2,5,981,15459,16440,0
Design|Web Design,13400000.0,ISR,3,4,550,16010,16560,0
Algorithms|Big Data|Technology,26927740.0,CHN,3,2,184,16314,16498,0
Mobile,6033020.73348125,GBR,1,2,0,13739,13739,1
Weddings,407200.0,IND,1,3,0,16694,16694,0
iPhone|Mobile|Weddings,1000000.0,USA,2,4,301,15757,16058,1
Consumer Internet|Marketplaces,3225000.0,USA,2,13,284,16051,16335,0
Consumer Internet|E-Commerce|Events|Fashion|Social Buying|Weddings,11500000.0,USA,3,13,1106,15187,16293,0
Curated Web|Events|Weddings,31065000.0,USA,4,3,2064,13545,15609,0
E-Commerce|Local|Public Transportation|Startups,800000.0,USA,1,15,0,16085,16085,1
Music,975000.0,USA,1,1,0,15693,15693,0
Sports,2200000.0,USA,1,3,0,15608,15608,0
Security,800000.0,CAN,1,1,0,14690,14690,0
Curated Web|Polling|Surveys,2450000.0,USA,3,16,862,15658,16520,0
SaaS|Software,6950000.0,FRA,2,3,1985,13521,15506,0
Software,100000.0,USA,2,2,417,15835,16252,0
Social Media|Video|Weddings,75000.0,USA,1,1,0,14714,14714,0
E-Commerce|Furniture|Online Shopping|Shopping,4545754.0,GBR,1,2,0,16041,16041,0
Android|Apps|iOS|iPhone|Photography|Photo Sharing|Weddings,14850000.0,USA,6,27,965,15519,16484,0
Babies|Parenting|Social Media,270000.0,USA,1,5,0,14123,14123,0
Blogging Platforms|Curated Web|E-Commerce Platforms|Web Development,35670000.0,USA,4,10,2668,13514,16182,0
Agriculture|Food Processing|Innovation Management,1229229.0,GBR,2,2,1052,15538,16590,0
Enterprise Software|Human Resources|Project Management|Task Management,290000.0,EST,2,8,990,15034,16024,0
E-Commerce,450000.0,ITA,1,1,0,15901,15901,0
Software,200000.0,USA,3,2,579,15796,16375,0
Education,40000.0,MEX,1,1,0,16069,16069,0
Apps|Finance|Peer-to-Peer|Tourism|Travel,60000.0,FRA,2,2,51,16232,16283,0
Finance,10455481.0,USA,2,1,671,14559,15230,0
Application Platforms|Apps|Cloud Computing|Developer APIs|Enterprise Software|Internet|Mobile|Video,13000000.0,USA,3,3,1591,15126,16717,0
Logistics|Mobile|Shipping,263702.833441627,GBR,2,4,199,16524,16723,0
Curated Web|E-Commerce|Finance|Parenting|Social Media,700000.0,USA,2,2,243,15797,16040,0
Nonprofits,4919.0,CAN,1,1,0,15482,15482,1
Entertainment|Games|Social Games|Virtual Worlds,15500000.0,GBR,2,3,306,12843,13149,0
Credit Cards|E-Commerce|Event Management|Events|P2P Money Transfer|Payments,1439220.0,FRA,2,1,1709,13618,15327,0
Mobile,17000000.0,USA,3,7,1702,13657,15359,0
E-Commerce|Fitness|Gamification,290977.46043825697,ESP,1,1,0,16495,16495,0
Analytics|Big Data|Enterprise Software|Logistics|Predictive Analytics,2995000.0,USA,2,7,499,16134,16633,0
Finance,530000.0,USA,3,11,580,15671,16251,0
Social Media,3500000.0,USA,2,9,145,13794,13939,1
Android|Enterprise Software|Security,660000.0,IND,2,5,243,16409,16652,0
E-Commerce|Hotels|Search|Travel,34500000.0,SGP,3,5,2001,13879,15880,0
E-Commerce,3250000.0,USA,2,5,360,16363,16723,0
Curated Web|Events|Location Based Services|Mobile|Nightlife|Social Network Media,40000.0,BRA,1,1,0,15198,15198,0
Curated Web,4900000.0,USA,2,2,864,14975,15839,0
Home Automation|Sensors|Tablets,25000.0,USA,1,1,0,15949,15949,0
Health and Wellness,40000.0,CHL,1,1,0,16056,16056,0
E-Commerce|Marketplaces|Mobile|Social Media|Startups|Travel,1265000.0,USA,3,9,199,15218,15417,1
Software,162778.0,CHN,2,1,0,15857,15857,0
Financial Services|P2P Money Transfer|Services,24000000.0,CHN,2,2,374,16314,16688,0
Pharmaceuticals,3010248.0,CHN,1,1,0,14518,14518,0
Social Media,163309.0,CHN,1,1,0,15979,15979,0
Mobile,819672.0,CHN,1,1,0,16040,16040,0
Social Network Media,107800000.0,CHN,3,4,475,16274,16749,0
Security,4000000.0,CHN,1,1,0,15857,15857,0
Analytics|Craft Beer|Information Technology|Internet of Things,7500000.0,ISR,3,7,1339,15248,16587,0
News,5000.0,CAN,1,1,0,15983,15983,0
Finance|Finance Technology|FinTech|Personal Finance,20000000.0,HKG,2,7,737,15706,16443,0
Health and Wellness|Health Diagnostics,100000.0,IND,1,1,0,16056,16056,0
Finance,620000.0,FRA,1,2,0,12906,12906,0
Social Buying|Social CRM|Social Media Advertising|Social Media Marketing|Social Media Monitoring|Social + Mobile + Local|Social Recruiting,20000.0,USA,1,1,0,15520,15520,0
Health and Wellness|Health Care|Hospitals,2000000.0,USA,2,6,330,16300,16630,0
Mobile|SaaS,400000.0,USA,1,1,0,16724,16724,0
Curated Web|Mobile,1000000.0,USA,1,8,0,15400,15400,0
E-Commerce,10050000.0,CAN,5,11,1826,13970,15796,0
Cloud Data Services|Hospitality|IT Management|Mobile|Mobile Commerce|Mobile Payments|Nightclubs|Point of Sale|Restaurants|Tablets,15000.0,USA,1,1,0,16165,16165,0
Oil & Gas|Software,61000000.0,USA,3,6,694,15985,16679,0
Biotechnology,10810000.0,USA,3,2,1043,14586,15629,1
Nutrition,250887.864275241,GBR,1,1,0,16130,16130,0
Health Care,15249999.0,USA,3,1,674,15504,16178,0
Hardware + Software,7499994.0,USA,2,1,378,14424,14802,0
Health Care|Hospitals|Medication Adherence|Real Time,26652027.0,USA,6,2,2324,14323,16647,0
Oil,1500000.0,USA,2,2,3790,12585,16375,0
Biotechnology,32025000.0,USA,10,2,1710,14783,16493,0
Curated Web,10000000.0,USA,2,12,154,16167,16321,0
Biotechnology,12500000.0,USA,2,2,1313,12502,13815,0
Health Diagnostics|Wearables,100000.0,USA,1,2,0,16357,16357,0
Health and Wellness|Medical|Retail,3400000.0,IND,1,2,0,16532,16532,0
Health and Wellness,15000000.0,USA,2,4,426,14894,15320,0
Health and Wellness,64000051.0,USA,4,5,826,15385,16211,0
Fitness|Health and Wellness|Training,1000000.0,USA,1,7,0,15672,15672,0
Social Media,1055547.0,CAN,1,1,0,13818,13818,0
Business Services|Energy|Oil|Professional Services,8000000.0,USA,1,2,0,13038,13038,0
Biotechnology,40600000.0,USA,4,12,2588,12795,15383,0
Health and Wellness,3000000.0,USA,1,2,0,13514,13514,1
Software,5000000.0,USA,2,1,40,16113,16153,0
Health and Wellness,129990798.0,USA,7,27,1562,15210,16772,0
Health and Wellness|Health Care|Health Care Information Technology,2334978.0,USA,3,5,690,15974,16664,0
Consulting|Education|Local|Translation,34000000.0,USA,2,2,1654,14935,16589,0
Incubators,250000.0,GBR,1,3,0,16742,16742,0
Clean Technology,689500000.0,IND,4,1,845,15876,16721,0
Finance|Investment Management|Services,14400000.0,USA,1,1,0,14068,14068,0
Apps,1000000.0,USA,1,5,0,16392,16392,0
Games,8608986.0,USA,6,6,919,15350,16269,0
Hardware + Software,5300000.0,USA,1,1,0,15861,15861,0
Design|Photography,410000.0,USA,2,1,542,15939,16481,0
Mobile,20768788.0,GBR,1,2,0,15593,15593,0
Messaging,8775600.0,FRA,1,1,0,13923,13923,0
Analytics,7124255.0,CHN,2,1,577,15887,16464,0
Mobile,4082454.0,USA,8,1,1558,14883,16441,0
Clean Technology,2554600.0,FRA,1,2,0,14207,14207,0
Credit Cards|Developer APIs|Payments|Software,74150000.0,USA,6,21,2330,14245,16575,0
Entertainment,234804067.74567002,JPN,1,7,0,16764,16764,0
E-Commerce|Entertainment|Marketplaces|Online Reservations,25000.0,USA,2,2,123,16007,16130,0
Social Media,12970000.0,USA,3,11,947,13149,14096,1
Career Management|Enterprise Software|Recruiting,5400000.0,USA,4,6,1112,15202,16314,0
Cloud Computing|Enterprise Software|SaaS|Software,3400000.0,NLD,2,8,616,15728,16344,0
Curated Web,20000.0,AUS,1,1,0,15400,15400,0
Finance,4700000.0,USA,2,3,120,13545,13665,0
Crowdfunding,569413.0,NLD,1,2,0,16484,16484,0
Curated Web,5750000.0,USA,2,2,167,14825,14992,0
Games,5000000.0,USA,1,2,0,13665,13665,0
Internet,8000000.0,USA,1,2,0,12324,12324,0
News,22500000.0,USA,1,1,0,15233,15233,0
Software,20000000.0,CHN,1,1,0,16117,16117,0
Software,1577460.0,USA,2,1,878,14813,15691,0
Education,510000.0,RUS,2,2,316,15868,16184,0
E-Commerce|Retail Technology,178825133.0,DEU,4,10,943,15499,16442,0
Enterprise Software|Software|Sustainability,4982871.0,DEU,2,5,1518,14901,16419,0
Travel,10025277.0,GBR,3,2,482,15887,16369,0
Events|Service Providers|Video,40000.0,CHL,1,1,0,15446,15446,0
Services|Technology,500000.0,USA,1,1,0,11692,11692,0
Career Management|E-Commerce|Human Resources,9000000.0,USA,1,3,0,10987,10987,1
Curated Web|Web Tools,39750000.0,USA,3,9,961,13057,14018,1
Graphics|Networking|Nightclubs|SaaS|Social Media|Startups,1052500.0,USA,3,1,1303,15340,16643,0
Curated Web|Finance|Services|Startups,25000000.0,NLD,1,2,0,16483,16483,0
Cloud Computing|Collaboration|Enterprise Software|Startups|Video|Video Editing,20304200.0,USA,3,2,897,15280,16177,0
Legal,3396962.0,USA,5,10,914,15765,16679,0
Technology,10000000.0,USA,1,1,0,16647,16647,0
Education|High Schools,117805.981402362,NOR,1,1,0,16742,16742,0
Collaboration|Coworking|Real Estate|Social Media|Technology,1002784331.0,USA,6,9,1242,15369,16611,0
Photo Sharing|Social Media,31556.0,DEU,2,1,336,16174,16510,0
Security|Software|Trusted Networks,38000000.0,USA,4,9,2102,11047,13149,1
Enterprise Software,8000000.0,CHN,1,1,0,15575,15575,0
Big Data|Business Services|Marketplaces|Market Research|SaaS,1100000.0,USA,1,9,0,16317,16317,0
Advertising|Coupons|Curated Web|Custom Retail|Marketplaces,299500000.0,USA,5,7,739,14549,15288,1
Web Hosting,17385483.0,USA,9,4,1855,12991,14846,0
Entertainment Industry|Events|Mobile|Software,500000.0,USA,1,2,0,16045,16045,0
Curated Web,1500000.0,USA,1,2,0,13770,13770,0
Maps|Mobile,5000000.0,GBR,4,4,727,16015,16742,0
Cosmetic Surgery|Dental|Health and Wellness|Search|Web Development,4219300.0,IRL,2,4,1328,14254,15582,0
Digital Media,1000000.0,USA,1,1,0,15874,15874,0
Apps|Mobile|Software,263219.263483007,IRL,5,4,726,15675,16401,0
Messaging|Mobile|Mobile Social,58250000.0,USA,3,2,1369,14518,15887,1
Messaging,1681000.0,NLD,2,1,1238,14764,16002,0
E-Commerce,600000.0,THA,1,1,0,15706,15706,0
B2B|Marketing Automation|Sales and Marketing|Software,2330000.0,CAN,2,4,969,14914,15883,0
Android|iPhone|Search,100000.0,USA,1,1,0,13623,13623,0
Mobile,500000.0,USA,1,2,0,16252,16252,0
Logistics|Sensors|Supply Chain Management|Technology,4240774.0,GBR,1,1,0,16281,16281,0
Aerospace,115000000.0,USA,2,5,658,16048,16706,0
Automotive|Travel,9725000.0,RUS,2,2,29,15336,15365,0
Automotive|Collaborative Consumption,15700000.0,USA,2,6,147,15245,15392,1
Software,40000.0,USA,1,1,0,15329,15329,0
Apps|Mobile|Online Scheduling|Software,9000000.0,USA,2,6,551,16078,16629,0
Crowdfunding|Crowdsourcing|E-Commerce|Non Profit|Nonprofits|Project Management|Small and Medium Businesses|Tech Field Support,1500000.0,USA,1,2,0,15006,15006,0
Collaboration|Enterprise Software|Knowledge Management|Restaurants,4000000.0,USA,1,4,0,16497,16497,0
Software,35000000.0,USA,2,2,71,12899,12970,0
E-Commerce,22358207.0,USA,5,5,2184,12417,14601,1
Facebook Applications|Maps|Search|Social Media|Travel,1750000.0,USA,2,1,761,13953,14714,1
Social Media,106000.0,USA,1,4,0,16096,16096,0
Search,40000.0,GBR,1,1,0,16030,16030,0
Information Technology,900000.0,ZAF,1,4,0,16679,16679,0
Content|News|Opinions|Social Media,300000.0,USA,1,1,0,13879,13879,0
Hardware + Software,5000000.0,USA,1,5,0,12814,12814,1
Events,68142.0,ITA,1,1,0,16010,16010,0
E-Commerce|Fashion|Shopping|Social Buying,2275000.0,FRA,2,4,255,15949,16204,0
Games|Television,150000.0,USA,1,1,0,13879,13879,0
E-Commerce,17880000.0,USA,1,2,0,13409,13409,0
Software,161671.0,GBR,1,1,0,15706,15706,0
Automotive|Electric Vehicles|Hardware|Hardware + Software|Internet of Things|Mobility,12850000.0,USA,3,15,434,15881,16315,0
Mobile|Online Dating|Private Social Networking,200000.0,USA,2,1,38,16251,16289,0
Art|DIY|E-Commerce|Startups,75000.0,USA,2,3,153,15492,15645,0
Internet|Internet TV|Shared Services|Social Media,60000000.0,USA,3,16,432,16191,16623,0
Enterprise Software|Storage,31000000.0,USA,3,10,527,15160,15687,1
Consumer Electronics|Hardware + Software,19330000.0,USA,1,1,0,14547,14547,0
Customer Support Tools|E-Commerce|E-Commerce Platforms|Online Shopping|Retail Technology|Sales and Marketing,8610857.99051481,ESP,3,5,753,15362,16115,0
File Sharing|Mobile|Networking|Wireless,3159200.0,ESP,2,2,426,13239,13665,1
Curated Web|Web Development,4000000.0,USA,2,2,282,14327,14609,1
File Sharing|Mobile|Networking|Social Media|Startups|Technology,61000000.0,USA,4,19,868,15341,16209,0
Messaging|Mobile|Mobile Payments|Security,394500.0,USA,4,5,365,14610,14975,0
3D Printing|3D Technology|Mobile Games,546253.0,GBR,4,3,690,15650,16340,0
Electronics|Hardware + Software|Internet of Things|Pets|Technology,21000000.0,USA,2,10,603,15861,16464,0
Charity|Governments|Politics|Polling,1200000.0,GBR,1,3,0,14700,14700,0
Finance Technology|FinTech|Mobile|SaaS,3450000.0,USA,3,10,549,16191,16740,0
Entertainment|Sports|Video Streaming,53000000.0,USA,4,6,1108,15340,16448,0
Data Visualization|Financial Services|FinTech|Machine Learning|Software,380000.0,USA,2,2,120,16436,16556,0
Enterprise Software,450000.0,IND,1,1,0,15561,15561,0
Curated Web|Shopping|Women,1300000.0,USA,1,1,0,14207,14207,0
Enterprise Software|Information Technology|Services,10000000.0,USA,1,1,0,12363,12363,0
Mobile|SaaS|Transportation,1000000.0,USA,1,1,0,16084,16084,0
Advertising|Security,13000000.0,USA,3,3,480,15765,16245,0
Services,43000000.0,USA,1,3,0,11386,11386,0
Web Hosting,15500000.0,USA,1,5,0,12999,12999,1
Consumer Internet|Security|Technology,26525002.0,USA,4,7,2092,13417,15509,0
Curated Web|Energy|Internet|Mobile|Television,14000000.0,USA,1,2,0,13587,13587,0
Health and Wellness|Health Care|Medical,12900000.0,USA,1,1,0,15442,15442,0
Security,49900000.0,USA,5,9,2415,13326,15741,0
Software,3396991.0,CAN,1,1,0,12727,12727,0
Business Services,7000000.0,USA,1,3,0,11548,11548,1
Messaging|Mobile|Network Security,60000.0,SGP,1,1,0,16136,16136,0
Developer APIs,716950.0,KOR,1,1,0,15912,15912,0
Curated Web|Fraud Detection|Identity Management|Mobile|Search|Travel,45000000.0,USA,1,2,0,12996,12996,0
Curated Web|Employment|Recruiting|Startups,1600000.0,USA,2,6,427,15187,15614,0
Social Media,382890.0,FIN,1,1,0,14299,14299,0
Hardware + Software,500000.0,USA,1,1,0,14778,14778,0
Clean Technology,4460015.0,GBR,1,3,0,14552,14552,0
Delivery|Hospitality,150768.0,USA,1,1,0,16112,16112,0
Comparison Shopping|E-Commerce,4600000.0,USA,2,9,736,15874,16610,0
Computer Vision,2000000.0,PHL,1,4,0,16657,16657,0
Software,1022276.0,PRT,1,2,0,16248,16248,0
Curated Web|Printing|Search|Web Development,50000.0,CHE,1,1,0,13149,13149,0
Fashion,9725000.0,USA,3,13,1168,15492,16660,0
Mobile,50000.0,SGP,1,1,0,13149,13149,0
Art|Curated Web|Design|Film|Games|Music|Social Network Media|Television|Video,64305.0,GBR,1,3,0,15715,15715,0
Developer APIs|Domains|Web Hosting,250000.0,USA,3,5,966,15552,16518,0
Curated Web|Internet|Reviews and Recommendations|Social Media,900000.0,ISR,1,8,0,16071,16071,0
Collaboration|Enterprise Software|Knowledge Management|Machine Learning|SaaS,4750000.0,USA,4,6,662,15986,16648,0
Semiconductors,5000000.0,ISR,1,3,0,12918,12918,0
Finance|SaaS|Wholesale,250000.0,USA,1,1,0,15461,15461,0
SaaS|Security|Services,10000000.0,USA,1,4,0,12535,12535,0
Music|Video,6846548.0,IRL,1,2,0,16212,16212,0
MicroBlogging|Social Media,5000.0,USA,1,2,0,15887,15887,0
Sports,21751000.0,USA,4,21,964,15736,16700,0
Technology,1500000.0,CAN,1,1,0,16741,16741,0
Crowdsourcing|Journalism|Mobile|News|Photography|Social Network Media,506038.0,ITA,2,2,120,16467,16587,0
Games,20460000.0,USA,4,2,784,14761,15545,0
Active Lifestyle|Information Services|Private Social Networking|Proximity Internet,100000.0,FRA,1,1,0,16130,16130,0
Business Services|Consulting|Hotels|Online Reservations|Social Media,224482.0,CHE,1,1,0,16071,16071,0
E-Commerce|Social Commerce,500000.0,JPN,3,4,744,15076,15820,0
Nanotechnology|Semiconductors|Solar,7000000.0,USA,1,1,0,14014,14014,0
E-Commerce,964950.0,ITA,1,2,0,16157,16157,0
Hardware,671310.816908228,ITA,1,3,0,16742,16742,0
Mobile|News|Video|Web Development,10800000.0,USA,3,6,1420,15156,16576,0
Big Data|Enterprise Software,23000000.0,USA,3,8,958,14868,15826,0
Curated Web|Web Tools,2000000.0,USA,1,1,0,14719,14719,1
Cloud Computing|Embedded Hardware and Software|Hardware + Software|Internet of Things|Mobile|Wireless,500000.0,GBR,2,2,559,15780,16339,0
Web Hosting,42500000.0,USA,4,10,1048,13139,14187,1
Games,20000.0,USA,1,1,0,15824,15824,0
Messaging,39000000.0,USA,2,13,114,16132,16246,0
Consumer Electronics|Robotics,100000.0,RUS,1,1,0,15461,15461,0
Technology,119110.0,GBR,1,1,0,16385,16385,0
Advertising|Digital Media|Education|Online Video Advertising|Photography|Video,460000.0,USA,1,3,0,16252,16252,0
Advertising|Advertising Platforms|Enterprise Software|Internet Radio Market|Software|Television,34500000.0,USA,5,15,5938,10786,16724,0
Mobile Advertising,3746400.0,SWE,1,2,0,15516,15516,0
Clean Technology,1955080.0,USA,3,1,1797,14745,16542,0
Consumer Electronics|Digital Rights Management|Games|Internet TV,66300000.0,USA,6,11,3391,11201,14592,1
Digital Media,70000.0,ESP,1,1,0,15706,15706,0
Apps|App Stores|Facebook Applications|Mobile|Services|Social Media|Social Media Marketing|Social Network Media|Web Tools,131700.0,DEU,1,1,0,13514,13514,0
Software,61000.0,FRA,1,1,0,13171,13171,0
Games|Mobile|Mobile Games,581635.0,ARG,4,6,579,15765,16344,0
Games,121695.913574476,BGR,3,3,761,15826,16587,0
Big Data|Marketplaces|Mobile,16390.0,ESP,1,1,0,16529,16529,0
Mobile,50000000.0,USA,2,2,2607,13970,16577,0
Service Providers|Software|Wireless,10390341.0,CHN,2,2,703,15706,16409,0
Clean Technology,100000.0,IND,2,2,905,14975,15880,0
Collaboration|Enterprise Software,2939581.0,USA,4,2,1558,14092,15650,1
Colleges|Location Based Services|University Students,3842495.0,USA,2,8,99,16391,16490,0
3D Printing|Fashion|Fitness|Health and Wellness|Wearables,3000000.0,CAN,1,5,0,16772,16772,0
Curated Web|Media|Search|Social Media,29800000.0,USA,5,23,3891,12418,16309,0
Big Data|Cloud Computing|Information Technology|Security|Social Media|Storage|Virtualization,500000.0,USA,1,1,0,13523,13523,0
Data Visualization|Digital Media,750000.0,ISR,1,1,0,15965,15965,0
Hospitality,10000000.0,USA,1,2,0,15587,15587,0
Curated Web|Finance|Stock Exchanges|Trading,8168043.0,AUT,3,10,886,15340,16226,0
E-Commerce,87635000.0,RUS,8,6,1858,14465,16323,0
Finance|FinTech|Stock Exchanges,17519999.0,USA,2,1,2114,13787,15901,0
Photography,40000.0,CHL,1,1,0,16052,16052,0
Big Data|Data Visualization|Interface Design|Internet|Search|Software,140000.0,USA,1,1,0,15593,15593,0
Education|Internet|Mobile|Productivity Software,600000.0,ISR,1,1,0,16289,16289,0
Advertising|Games|Graphics,30000000.0,USA,1,2,0,12723,12723,0
Mobile,2500000.0,USA,1,2,0,14972,14972,1
Web Hosting,50000000.0,USA,1,4,0,14125,14125,1
Mobile,10000000.0,USA,2,10,401,15887,16288,0
Finance|Financial Services|Services,14500000.0,USA,1,4,0,11619,11619,1
Fashion,2925000.0,USA,3,2,960,15775,16735,0
Advertising|Enterprise Software|Sales and Marketing|Social Media,14100000.0,USA,4,9,1095,14214,15309,1
Mobile,6805790.0,USA,3,9,998,15614,16612,0
Advertising|Android|App Discovery|Application Platforms|App Marketing|Digital Entertainment|Mobile,100500000.0,USA,5,18,2801,11017,13818,0
Biotechnology,27070000.0,DEU,2,2,4040,10651,14691,1
Semiconductors,15000000.0,USA,1,1,0,13523,13523,0
Events|Mobile|Ticketing,2100000.0,USA,3,17,829,15095,15924,1
Biotechnology,1300000.0,USA,1,2,0,13447,13447,0
Semiconductors,55000000.0,ISR,2,11,1190,14805,15995,1
Biotechnology,40000000.0,SWE,1,4,0,16176,16176,0
Insurance|Insurance Companies|Services,600000000.0,USA,1,2,0,12774,12774,0
Software,15000000.0,USA,1,3,0,12087,12087,1
Mobile|Wireless,1008260.0,ITA,2,9,445,15975,16420,0
Cloud Management|Mobile|SaaS|Telecommunications|Wireless,100000.0,RUS,1,1,0,16535,16535,0
Software,25089334.0,USA,5,7,2139,12579,14718,1
Hotels|Internet|Online Rental|Social Media|Travel|Vacation Rentals,90000000.0,DEU,1,2,0,15139,15139,0
Casual Games|MMO Games|Mobile Games|Social Games,530000.0,ESP,2,1,65,16091,16156,0
Cable|Security,1096318.0,FRA,1,1,0,16211,16211,0
Games,40000.0,CHL,1,1,0,15562,15562,0
Information Technology,25000.0,COL,1,1,0,16130,16130,0
Hardware + Software,1560000.0,DEU,1,1,0,14004,14004,0
Software,6900000.0,GBR,1,2,0,14571,14571,0
Enterprise Software,2000000.0,CHN,1,2,0,14929,14929,0
Clean Technology,28802000.0,IRL,1,1,0,15072,15072,0
Energy|Energy Management|Utilities,40000.0,CHL,1,1,0,16222,16222,0
Babies|E-Commerce|Shopping,92275758.0,DEU,6,17,1586,14868,16454,1
Clean Technology,13000000.0,USA,1,2,0,13906,13906,0
Health Care|Medical|Pharmaceuticals,5965597.0,USA,3,3,473,16188,16661,0
Delivery|E-Commerce|Services,86792.0,ESP,2,2,123,16191,16314,0
Clean Energy|Clean Technology|Renewable Energies|Wind,14000000.0,AUS,2,3,762,13695,14457,0
Agriculture|Clean Technology|Consumer Goods|EdTech|Education|Green|Home & Garden|Organic|Sustainability,80000.0,USA,2,3,612,15095,15707,0
Analytics,1025000.0,USA,1,3,0,14610,14610,0
Analytics|Direct Marketing|E-Commerce|Email Marketing|Information Technology|Marketing Automation|Personalization|Retail|Software,9295000.0,USA,6,7,1238,15091,16329,0
Clean Technology,2000000.0,USA,2,1,1879,14373,16252,1
Big Data Analytics,15800000.0,ISR,2,3,536,16016,16552,0
E-Commerce,262424600.0,CHN,7,6,1581,15065,16646,0
CRM|Mobile Devices|Software|Wine And Spirits,34071.0,FRA,1,1,0,16010,16010,0
Hospitality|iPhone|Wine And Spirits,796760.0,GBR,1,1,0,15279,15279,0
Software|Wine And Spirits,25500100.0,USA,3,5,1734,13606,15340,0
Productivity|Wine And Spirits,16773.0,PRT,1,1,0,16703,16703,0
E-Commerce,28564825.0,CHN,2,2,427,15218,15645,0
E-Commerce|Flash Sales|Wine And Spirits,453555.0,ITA,2,1,352,16056,16408,0
Wine And Spirits,5000000.0,USA,1,1,0,13802,13802,0
Customer Service|Loyalty Programs|Online Shopping,16781.0,FRA,1,1,0,16496,16496,0
Mobile,19000000.0,USA,2,7,930,13378,14308,0
Wine And Spirits,632329.0,ITA,1,3,0,16354,16354,0
Gay & Lesbian,25000.0,USA,2,2,312,15865,16177,0
Investment Management|Startups|Technology,41250.0,HKG,1,1,0,16252,16252,0
Education|Games|Virtualization,500000.0,IND,1,1,0,15279,15279,0
Collaboration|Curated Web|Green|Networking|Peer-to-Peer|Transportation,2725000.0,USA,3,34,1470,15068,16538,0
Search,6200000.0,USA,1,2,0,12784,12784,1
Games|Mobile|New Technologies|Wearables,100000.0,RUS,2,2,184,15826,16010,0
Games,6049999.0,CHN,5,7,2922,13330,16252,0
Games,1400000.0,ESP,1,3,0,16597,16597,0
Games|Incentives|Online Gaming,100000.0,USA,1,1,0,15775,15775,0
Health Care,5142788.0,ITA,5,2,1679,15034,16713,0
Games,25000.0,USA,1,1,0,15340,15340,0
Consulting,4205355.0,GBR,1,2,0,16204,16204,0
Clean Technology|Hospitality|Optimization|Waste Management,236370.0,GBR,2,1,479,15954,16433,0
Databases|Mobile|Networking,84000000.0,USA,2,8,759,11400,12159,1
Software,12000000.0,USA,1,1,0,14866,14866,0
Games,1880000.0,USA,1,1,0,13239,13239,0
Biotechnology,375000.0,USA,1,1,0,15439,15439,0
Web Hosting,50461490.0,USA,7,4,3227,10957,14184,1
Local Businesses,28500000.0,USA,1,1,0,16036,16036,0
Bitcoin|Messaging|Music|Video|VoIP,2500000.0,USA,1,1,0,16265,16265,0
Finance|Financial Services|Mobile|Mobile Commerce|Mobile Payments|Web Development,999997.0,USA,4,7,1115,14853,15968,1
Collaboration|Media|Project Management|SaaS|Software|Video,1381812.0,NZL,3,4,535,15949,16484,0
Hardware + Software,59000000.0,USA,3,13,903,12772,13675,0
Celebrity|Content|Image Recognition|Mobile|Subscription Businesses|Video,230627.0,GBR,1,1,0,15915,15915,0
Curated Web,3000000.0,SWE,1,1,0,14183,14183,0
Hardware + Software,1000000.0,USA,1,1,0,13572,13572,0
Messaging,2250000.0,USA,1,12,0,15706,15706,0
Clean Technology,8680000.0,FRA,2,8,652,13166,13818,0
Health and Wellness,2500000.0,USA,1,1,0,13733,13733,0
Audio|Music|Wireless,6000000.0,NLD,1,1,0,13726,13726,1
Mobile,1190000.0,GBR,1,1,0,13397,13397,0
Hardware + Software,605000.0,USA,2,1,196,14553,14749,0
Internet of Things|Software,4500000.0,USA,1,4,0,15757,15757,0
Hardware + Software,754000.0,NOR,1,1,0,13888,13888,0
Hardware + Software,63000001.0,USA,6,4,1393,14964,16357,0
Internet|Networking|Wireless,8500000.0,USA,1,4,0,12594,12594,0
Curated Web,150000.0,USA,2,4,213,15340,15553,0
Software,4260000.0,NOR,2,3,1597,14683,16280,0
Solar,125535.0,MEX,1,1,0,16375,16375,0
Cyber Security|Enterprises|Security,9300000.0,ISR,1,3,0,16637,16637,0
Human Resources|Mobile|Recruiting,2000000.0,CAN,3,3,246,16343,16589,0
Social Media|Social Network Media,5000000.0,USA,1,1,0,13726,13726,0
Semiconductors,55833663.0,ISR,5,12,2023,13172,15195,0
Mobile,1530000.0,CHN,1,1,0,13356,13356,0
Big Data|Enterprise Software|Machine Learning|Software,2614554.0,USA,3,3,501,15645,16146,0
Hardware + Software,4653011.0,ITA,2,8,578,16017,16595,0
Information Technology|Networking|Social Media|Social Network Media,8900000.0,USA,5,8,1484,14936,16420,0
Q&A,1250000.0,USA,1,3,0,16678,16678,0
Events|Meeting Software,1929900.0,FRA,1,1,0,16105,16105,0
Agriculture|Mobile,40000.0,PRT,1,1,0,16055,16055,0
Health and Wellness,3710544.0,USA,2,1,675,16059,16734,0
Clean Technology,32272314.0,USA,5,2,1235,15478,16713,0
Big Data Analytics|Employer Benefits Programs|Health and Wellness|Health Care|Human Resources|Medical,19453775.0,USA,6,10,1182,15155,16337,0
Curated Web|E-Commerce|Marketplaces|Mobile,578700000.0,USA,5,35,1686,14903,16589,0
Crowdfunding|Crowdsourcing|Events|Internet|Technology,1958750.0,USA,4,1,1422,14909,16331,0
Comparison Shopping|Printing|Software,16000000.0,CAN,2,1,2804,13149,15953,0
Curated Web|Ediscovery|Registrars|Social Media,150000.0,IND,1,1,0,15996,15996,0
Crowdfunding,652688.0,IND,1,2,0,16364,16364,0
E-Commerce,4000000.0,USA,1,2,0,16085,16085,0
Communities|Curated Web|Location Based Services|Networking|Online Dating,1300000.0,GBR,2,1,335,15126,15461,0
E-Commerce,470000.0,KOR,1,1,0,15490,15490,0
Online Shopping|Retail,5300000.0,AUS,1,2,0,11372,11372,0
E-Commerce|Shopping|Social Media,1395100.0,USA,3,3,849,13149,13998,1
Apps|E-Commerce|Payments|Retail|Software,200000.0,UKR,1,1,0,16460,16460,0
Semiconductors,70799998.0,USA,11,18,3844,12418,16262,0
Education,160000.0,USA,1,1,0,15126,15126,0
Games,10000000.0,CHN,2,2,944,14335,15279,0
Software,3000000.0,USA,2,9,287,16071,16358,1
Computers|Developer APIs|Technology,302883.0,KOR,2,1,1071,14610,15681,0
Advertising|Analytics|Big Data|Content|E-Commerce|Internet Marketing|Personalization|Sales and Marketing|Search|Web Tools,100000.0,RUS,1,2,0,15901,15901,0
Health and Wellness,20000000.0,USA,1,3,0,15694,15694,0
Hardware + Software,33831613.0,FRA,2,6,1049,14854,15903,0
Curated Web|Marketplaces|Travel,500000.0,NLD,1,1,0,15964,15964,0
Apps|Marketplaces|Wine And Spirits,139663.0,AUS,1,1,0,16283,16283,0
E-Commerce,40000.0,CHL,1,1,0,15435,15435,0
Clean Technology,31000000.0,USA,3,5,2149,13851,16000,0
Software,1600000.0,USA,1,1,0,16646,16646,0
Cloud Computing|Software|Storage|Web Hosting,206447.0,USA,2,2,1635,13149,14784,1
E-Commerce|Fashion|Life Sciences|Parenting,2500000.0,USA,1,5,0,15435,15435,1
Content|Curated Web|Productivity Software|Software,1000000.0,USA,1,1,0,16164,16164,0
Analytics|Big Data|Big Data Analytics|Search|SNS|Startups|Technology,1000000.0,KOR,1,2,0,15957,15957,0
Retail Technology,204258.0,CHL,2,2,85,16290,16375,0
Mobile,50569858.0,CHN,4,1,859,15553,16412,0
Curated Web|Design|Internet|Software|Web Design|Web Tools,58500000.0,ISR,4,12,1213,13848,15061,1
Entrepreneur|Games|Mobile Games|Startups,150000.0,LBN,1,1,0,15400,15400,0
Social Media,2068314.0,FRA,1,1,0,16324,16324,0
Big Data|Business Analytics|Business Intelligence,1045607.0,PRT,1,2,0,16202,16202,0
E-Commerce|Reviews and Recommendations|Search|Shopping,4988000.0,USA,2,3,365,13514,13879,1
Brand Marketing|Celebrity|Promotional,500000.0,FRA,1,1,0,15126,15126,1
Enterprise Software,2580000.0,USA,3,5,1540,14245,15785,0
Analytics|Business Intelligence,8435583.0,USA,2,9,186,16036,16222,0
EdTech|Education,4000000.0,USA,1,2,0,15729,15729,0
E-Commerce|SaaS,198079.0,FRA,1,1,0,15706,15706,0
Blogging Platforms|Browser Extensions|Internet|Marketplaces|Software,41303.0,ITA,1,1,0,16071,16071,0
Messaging,25000.0,USA,1,1,0,15348,15348,0
Consulting,2000000.0,JPN,1,4,0,16471,16471,0
Consumer Behavior|Mobile Analytics|SaaS,9600000.0,USA,2,3,392,16258,16650,0
Collaboration|Corporate Training|Education|Internet|Marketplaces|Social Media|Social Network Media|Training|Virtualization|Weddings,700000.0,SGP,1,8,0,14975,14975,0
Games,2500000.0,FRA,2,2,183,13848,14031,0
Hospitality,43000000.0,USA,1,1,0,16112,16112,0
Curated Web|Events|Social Media|Video,20000.0,USA,1,1,0,14842,14842,0
Telecommunications,6068467.0,CAN,2,1,2922,13451,16373,0
Curated Web,32059.0,BGR,1,1,0,15796,15796,0
Software,10000000.0,CHN,1,1,0,14975,14975,0
News|Video,14750000.0,USA,2,7,364,15838,16202,0
Application Platforms|Cloud Computing|Development Platforms|PaaS|Web Development|Web Hosting|Web Tools,105000.0,USA,2,4,380,16314,16694,0
Document Management|Publishing|Software,11701776.0,FRA,1,5,0,11710,11710,1
Manufacturing,755000.0,USA,1,1,0,15736,15736,0
Apps|Payments|Restaurants,500064.0,FIN,1,2,0,16392,16392,0
E-Commerce,310000000.0,CHN,3,5,805,15915,16720,0
Information Security|Software,10845000.0,USA,5,5,1575,15154,16729,0
Internet|Women,120000.0,USA,1,1,0,16267,16267,1
Entertainment|News|Social Media,1750000.0,USA,1,13,0,16283,16283,0
Forums,7000000.0,USA,1,1,0,11047,11047,0
Mobile Payments,322917.0,KOR,1,3,0,15666,15666,0
Games,1750000.0,USA,2,1,210,15503,15713,0
E-Commerce|Gift Card|Marketplaces|Mobile|Payments|Shopping,1666000.0,USA,3,10,211,16071,16282,0
Software,2030000.0,GBR,1,1,0,13239,13239,0
Analytics|Customer Service|Internet|Web Tools,20658.0,NLD,1,1,0,16161,16161,0
Games,7000000.0,USA,1,3,0,14370,14370,1
Curated Web|Networking|Social Media|Video,600000.0,USA,2,6,216,16192,16408,0
Curated Web,550000.0,GBR,2,1,92,16344,16436,0
E-Commerce|Fashion|Mobile|Photography|Publishing|Travel,158000.0,USA,2,3,203,16314,16517,0
Curated Web,360000.0,JPN,1,2,0,15247,15247,0
Computers|Software|Technology,10000000.0,CHN,2,2,638,14488,15126,0
Games,64873.0,BGR,2,2,68,15789,15857,0
Credit|Curated Web|Finance|Financial Services|FinTech|Risk Management,145393366.0,GBR,5,9,1356,13665,15021,0
Consumers|Local|Location Based Services|Search,500000.0,THA,2,2,352,15854,16206,0
Marketplaces|Temporary Staffing,2200000.0,USA,2,5,516,16054,16570,0
Hardware + Software|Wearables,4741000.0,USA,4,1,566,15986,16552,0
B2B|Curated Web|Gamification|Human Resources|SaaS,700000.0,AUS,2,5,199,15162,15361,1
Medical Devices,10609141.0,FIN,1,3,0,16539,16539,0
Clean Technology,1218184.0,CAN,1,1,0,13970,13970,0
Clean Technology,15000000.0,USA,2,3,454,14033,14487,0
Career Management|Developer APIs|Personal Data|Personalization|Software,9488521.0,USA,8,7,1541,15126,16667,0
Pets,400000.0,USA,1,1,0,15949,15949,0
Consumer Electronics|Facebook Applications|Game|Games|iPad|iPhone|Mobile|Mobile Games|Social Games,32200000.0,DEU,3,7,699,14426,15125,0
E-Commerce|Fashion|Handmade,2800000.0,GBR,1,6,0,15911,15911,0
Curated Web|Women,17400000.0,USA,3,7,438,13604,14042,1
E-Commerce|Retail|Shopping,74884.0,FRA,1,1,0,16160,16160,0
Curated Web|Digital Media|Publishing,189894.0,IRL,3,3,335,15614,15949,0
Curated Web|Social Buying,5000000.0,IND,1,1,0,16484,16484,0
Advertising|Internet Marketing|Marketplaces|Video,888668.0,GBR,2,3,1635,14344,15979,0
Education|Software,1000000.0,USA,1,1,0,16478,16478,0
Software,50057463.0,KOR,4,5,1232,15168,16400,0
Curated Web,275000.0,ARG,2,4,730,15553,16283,0
Social Media,9000000.0,CAN,2,4,477,14739,15216,0
Education|Search|Young Adults,51878.0,SVK,1,1,0,15949,15949,0
Travel,21000000.0,USA,2,3,170,16161,16331,0
Apps|B2B|Financial Services|Fitness|Technology,556049.0,LTU,2,2,361,16274,16635,0
Education,7700000.0,USA,4,2,961,14614,15575,0
Hardware + Software,5393366.0,USA,6,4,1368,14323,15691,0
Advertising,28426456.0,USA,8,6,2277,14272,16549,0
Advertising|Search|Semantic Search|SEO|Small and Medium Businesses,1400000.0,USA,1,1,0,15169,15169,0
Blogging Platforms|Content|English-Speaking|Messaging|Photo Editing,64000.0,GBR,2,4,316,14537,14853,0
Recruiting|Software|Technology,315000.0,USA,3,4,425,15038,15463,0
Collaboration|Curated Web|Productivity Software|Project Management,30000.0,PHL,1,1,0,15644,15644,0
Enterprise Software,35000000.0,USA,3,8,1238,15218,16456,0
Clean Technology|Computers|Medical Devices|Telecommunications,100000.0,GBR,1,1,0,16392,16392,0
Human Resources|Recruiting,40000.0,CHL,1,1,0,15777,15777,0
Career Management|Facebook Applications|Human Resources|Recruiting|Social Media|Social Recruiting,18000000.0,USA,2,3,581,15596,16177,0
Human Resources|Recruiting|Software,34450000.0,GBR,6,9,995,15713,16708,0
E-Commerce|Marketplaces|Outsourcing,75000.0,USA,2,2,975,15400,16375,0
Application Platforms|Employer Benefits Programs|Employment,5000000.0,GBR,1,5,0,16454,16454,0
Business Productivity|Collaboration|Human Resources|Project Management|Software,4250000.0,USA,1,4,0,16126,16126,0
Software,1380000.0,GBR,2,2,314,14245,14559,0
Career Management|Enterprises|Enterprise Software|Human Resources|Reviews and Recommendations|SaaS|Software,811531.0,IRL,2,3,547,15855,16402,0
Colleges|Enterprise Software|Finance|FinTech|Human Resources|SaaS|Technology|Web Development,175000000.0,USA,3,10,2487,12784,15271,1
Consulting|Freelancers|Outsourcing,170000.0,USA,2,2,254,15707,15961,0
Chat|Enterprises|Identity|Software|Video,5443678.0,USA,6,1,2302,13665,15967,0
Software,4500000.0,USA,2,2,1311,14831,16142,0
Software,17000000.0,USA,2,3,877,15307,16184,0
Enterprises|Enterprise Software|Project Management|SaaS,95000000.0,USA,4,11,2985,13667,16652,0
Mobile|Networking|Social Media,20000.0,USA,2,2,62,15887,15949,0
Staffing Firms,500000.0,IND,1,1,0,16714,16714,0
Finance Technology|Home Owners|Wealth Management,5000000.0,USA,1,1,0,14578,14578,0
Finance Technology|Financial Services|FinTech|Mobile Enterprise,30000.0,USA,1,1,0,16436,16436,0
Accounting|Billing|CRM|Freelancers|Small and Medium Businesses|Software,188000.0,USA,1,1,0,15431,15431,1
E-Commerce,3500000.0,RUS,1,1,0,15821,15821,0
Business Productivity|Internet,120000.0,USA,2,4,185,16130,16315,0
Mobile,17600000.0,USA,3,8,801,13198,13999,1
Health Care|Medical|Training,553000.0,USA,2,2,289,15949,16238,0
Internet,7900000.0,USA,2,15,168,16161,16329,0
Enterprise Software,100000.0,USA,2,2,888,14056,14944,0
Art|Artists Globally,10000.0,HUN,1,1,0,15775,15775,0
Software,68071635.0,GBR,4,7,4234,11963,16197,0
Collaboration|Lead Management|Productivity Software|Social Media|Teachers|Weddings,1019999.0,USA,2,2,515,14896,15411,0
Software,32000000.0,USA,4,3,2114,12499,14613,0
Enterprise Software|Mobile Devices|Mobile Security|Virtual Desktop|Virtualization,14625000.0,USA,5,13,1068,15564,16632,0
Health Care,2300000.0,USA,1,1,0,16262,16262,0
Enterprise Software,3500000.0,USA,2,2,572,14245,14817,0
Marketplaces,40000.0,USA,1,1,0,15666,15666,0
Enterprise Software|Meeting Software,12282836.0,USA,3,3,1018,13787,14805,1
Enterprise Software,150000.0,USA,1,1,0,14245,14245,0
CRM|Enterprise Software|File Sharing|Social Network Media|Web Development,267240.0,NLD,1,1,0,14975,14975,1
Art,200000.0,IND,1,2,0,16560,16560,0
Android|Entertainment|Facebook Applications|Finance|Games|iPhone|Mobile|Social Media|Software,12000.0,USA,1,1,0,14914,14914,0
Finance,25000000.0,USA,2,3,0,15986,15986,0
Bitcoin|Virtual Currency,28753.0,AUS,1,2,0,15870,15870,0
Clean Technology,5400000.0,USA,1,1,0,13495,13495,0
Facebook Applications|Games|Online Gaming|Sports|Video Games,21000000.0,USA,4,8,2000,13614,15614,0
E-Commerce,5087553.0,USA,2,3,791,13458,14249,0
Web Hosting,57400000.0,USA,4,16,1236,12426,13662,1
Crowdfunding|E-Commerce|Social Commerce|Social Fundraising,375054.41699571296,ESP,2,5,437,15837,16274,0
Cloud Computing|Enterprise Software|File Sharing|Software,1250000.0,GBR,1,1,0,15868,15868,1
Health Care,32606439.0,USA,2,3,259,14643,14902,0
Events|Local|Mobile|Real Time|Social Network Media|Software,800000.0,USA,2,15,277,14396,14673,0
Collaboration|Hotels|Mobile|News|Real Time|Social Media|Travel,10800000.0,USA,3,7,1504,13836,15340,1
Analytics,60000000.0,USA,2,2,573,15225,15798,0
Travel,89591.0,HUN,2,3,328,15347,15675,0
P2P Money Transfer,147655000.0,GBR,7,4,1873,14610,16483,0
E-Commerce|Furniture,70112426.0,GBR,4,9,2071,14426,16497,0
Aerospace|Enterprises|Travel,250000.0,USA,2,4,78,15993,16071,0
Curated Web,1200000.0,USA,1,3,0,13757,13757,0
Enterprise Software|Virtualization,1000000.0,USA,2,1,397,16142,16539,0
Games,10043477.0,USA,2,4,773,13604,14377,0
Business Services,4000000.0,IND,1,1,0,12094,12094,0
College Campuses|Corporate Training|EdTech|Education|Semantic Web|Software|Training,500000.0,ARG,1,5,0,15886,15886,0
Curated Web,2000000.0,USA,2,2,373,14586,14959,0
Finance|Investment Management,493683.0,GBR,1,1,0,16102,16102,0
Design,7289227.0,USA,6,1,1612,14957,16569,0
Finance|Financial Services,8000000.0,USA,1,3,0,16730,16730,0
Big Data|Content Delivery|Digital Media|Publishing|Social Media,500000.0,GBR,2,3,31,16314,16345,0
Health Care,2496831.0,USA,3,1,1487,14281,15768,0
Advertising|Content|Media,23500000.0,USA,2,8,1440,14975,16415,0
Hardware + Software,6600000.0,USA,1,1,0,16630,16630,0
Web Hosting,34452226.0,USA,3,5,1091,13118,14209,1
Software|Translation,1100000.0,JPN,1,2,0,16680,16680,0
Delivery,500000.0,IND,1,1,0,16630,16630,0
Hardware + Software,7503717.0,GBR,1,1,0,15411,15411,0
Games,1500000.0,CHN,1,1,0,12509,12509,0
Fashion,32165.0,GBR,1,2,0,16055,16055,0
Curated Web,7700000.0,USA,4,2,456,14518,14974,0
Real Estate,2391634.0,CHN,2,1,853,15065,15918,0
Apps|Chat|Databases|Gps|Local|Location Based Services|Messaging|Proximity Internet|Social Media|Social Network Media|Social Search,851195.0,GBR,4,3,882,15189,16071,0
Games,2000000.0,CHN,1,1,0,16623,16623,0
Blogging Platforms|Software|Web CMS|Web Hosting,39200000.0,USA,3,10,1226,15293,16519,0
Content|Media|Services,16200000.0,USA,2,12,142,16539,16681,0
Advertising|Advertising Platforms|Services,1000000.0,USA,1,3,0,16692,16692,0
Apps|App Stores|Curated Web|Facebook Applications|Gift Card|Mobile|Social Media,28371641.0,SWE,5,14,1449,15292,16741,0
Messaging,19579019.0,GBR,1,1,0,15201,15201,0
Hospitality|Restaurants,284789.0,GBR,3,3,260,16071,16331,0
Manufacturing,10285524.0,USA,7,2,2028,14643,16671,0
Collaboration|Enterprise Software|Project Management,26000000.0,USA,3,5,1057,15504,16561,0
Enterprise Software,264094.0,IRL,1,1,0,15706,15706,0
News,2000000.0,USA,1,3,0,16751,16751,0
Education|Publishing,22818.0,GBR,2,2,387,15887,16274,0
Printing|Translation,525000.0,CHN,1,5,0,16224,16224,0
Curated Web,80000.0,USA,1,1,0,15723,15723,0
Education|iPad|iPhone,960000.0,DNK,3,3,662,15988,16650,0
Business Services|Content|Digital Media|Social Media,1000000.0,USA,1,3,0,16467,16467,0
Computer Vision|Image Recognition|Software,454545.0,CAN,1,1,0,16191,16191,0
Open Source|Services|Software,40540723.0,USA,4,10,3349,13308,16657,0
Leisure|Services|Travel,3000000.0,IND,1,2,0,16623,16623,0
Health Care,11000000.0,CHN,1,4,0,15154,15154,0
Software,33887.0,CZE,1,1,0,16467,16467,0
Search,3500000.0,CHN,1,2,0,15065,15065,0
Software,475000.0,DEU,2,1,357,16304,16661,0
Brokers|Security|Services|Trading,40000000.0,USA,1,1,0,16044,16044,0
Advertising,10000000.0,GBR,1,4,0,13514,13514,1
E-Commerce,17500000.0,USA,2,3,48,16071,16119,0
Enterprise Software|Internet|Media|Video|Video Streaming,6539907.0,USA,3,2,1918,14245,16163,0
Certification Test|Cyber Security|Infrastructure,5186985.0,CAN,2,3,623,15460,16083,1
Apps|Messaging|Social Media,1000000.0,USA,1,6,0,16231,16231,0
Biotechnology,93470000.0,CHN,5,6,1246,12815,14061,1
Clean Technology,70000000.0,CHN,1,4,0,14053,14053,0
Consulting|Human Resources|Recruiting,1850000.0,EGY,3,5,1729,14944,16673,0
EdTech|Education,162954.0,CHN,1,1,0,16130,16130,0
Enterprise Software|Portals|Social Games,10000.0,UKR,3,2,1421,15288,16709,0
Apps|Gamification|iPhone|Online Dating|Social Media,450000.0,USA,3,1,255,16103,16358,0
Film|Film Production|Media|Software|Television|TV Production,5438947.0,USA,3,6,1131,15575,16706,0
E-Commerce|Restaurants|Retail,7800000.0,CAN,1,2,0,16720,16720,0
Web Hosting,3000000.0,CHN,2,3,122,15187,15309,0
Analytics|Financial Services|Governments|Law Enforcement,58875383.0,NZL,2,2,436,16160,16596,1
Broadcasting|Embedded Hardware and Software|Internet TV|Software|Telecommunications,15608659.0,FRA,1,3,0,13953,13953,0
E-Commerce,5000000.0,JOR,2,4,501,15869,16370,0
Software,5100000.0,CAN,1,2,0,12101,12101,0
Consulting,190000.0,ESP,1,1,0,13406,13406,1
Advertising|Software,10046250.0,DEU,2,1,509,15534,16043,0
Curated Web|Education|Marketplaces|Music Education|Service Providers|Tutoring,21500000.0,USA,1,1,0,16056,16056,0
User Experience Design,75000.0,USA,2,3,380,16222,16602,0
Software,750000.0,BWA,1,2,0,16223,16223,0
Enterprise Software,45000000.0,USA,4,8,1768,14031,15799,0
E-Commerce|Sporting Goods,5000000.0,USA,1,1,0,13612,13612,0
B2B,11300000.0,USA,2,10,229,16211,16440,0
Software,6670000.0,DEU,2,3,1671,13181,14852,0
Health Care|Medical|Medical Devices,2315880.0,IRL,1,1,0,16086,16086,0
Information Technology|Services|Storage,2000000.0,GBR,1,1,0,15795,15795,0
Health Care|Medical Devices|Pharmaceuticals,725000.0,USA,1,2,0,13042,13042,0
Enterprise Software,12200000.0,USA,3,3,3232,12894,16126,0
Health Care,100000.0,NLD,1,1,0,16706,16706,0
Health Care,4570000.0,USA,2,1,288,15111,15399,0
Mobile,4500000.0,ITA,1,1,0,14928,14928,0
Games,20395.0,EST,1,1,0,15737,15737,0
Technology,5000000.0,ISR,1,1,0,16657,16657,0
Enterprise Software,349000.0,GBR,1,3,0,13249,13249,0
Analytics|Incentives,85870000.0,USA,7,27,3174,13231,16405,1
Advertising|Apps|Local|Mobile|Search|Technology|Wireless,74000000.0,USA,4,12,2225,14092,16317,0
Software,13000000.0,USA,1,3,0,12209,12209,0
Android|Mobile|Software,219619.0,CHN,1,1,0,14610,14610,0
Biotechnology|Health Diagnostics,47298141.0,CAN,4,14,1613,15012,16625,0
Aerospace|Innovation Engineering|Manufacturing,20000000.0,CHN,1,1,0,16314,16314,0
Networking,21000000.0,USA,1,4,0,11589,11589,0
Android|iOS|Mobile Software Tools|Software|Testing|Windows Phone 7,82000000.0,USA,3,12,758,15545,16303,0
Finance,65548214.0,USA,7,13,3627,12599,16226,0
Education,1800000.0,IND,1,1,0,16373,16373,0
Software,200000000.0,USA,1,1,0,15960,15960,1
Education,12800000.0,USA,3,6,834,15795,16629,0
Enterprise Software|Internet|Virtualization,21700000.0,USA,2,4,2235,13780,16015,0
Semiconductors,808000.0,GBR,1,1,0,13692,13692,0
Hospitality,3500000.0,USA,3,1,1286,14884,16170,0
Biotechnology,132783861.0,USA,3,15,1955,12592,14547,0
Manufacturing|Semiconductor Manufacturing Equipment|Semiconductors,15200000.0,USA,1,4,0,12558,12558,0
Pharmaceuticals,55800000.0,USA,2,21,1085,12398,13483,1
Bitcoin|Curated Web|Information Security|Personal Finance,40000000.0,USA,2,14,117,16142,16259,0
Audio|Consumer Behavior|Mobile Advertising,8750000.0,USA,3,1,386,16183,16569,0
Search,22655660.0,USA,5,13,2370,11963,14333,0
Software,2230000.0,USA,1,2,0,13149,13149,0
Software,7588252.0,FRA,2,7,881,12606,13487,1
Apps|Browser Extensions|Events|Mobile|Music|Nightlife,625000.0,ESP,1,1,0,16617,16617,0
Security,37689119.0,USA,7,5,2782,13353,16135,1
Semiconductors,50983427.0,USA,6,7,2697,12444,15141,0
Medical|Medical Devices|Pharmaceuticals,88000000.0,USA,2,1,0,12144,12144,1
Clean Technology,11140000.0,USA,1,1,0,14061,14061,0
Analytics|Bio-Pharm|Biotechnology|Pharmaceuticals,10005118.4168566,USA,4,8,2448,12928,15376,0
Biotechnology|Diagnostics|Life Sciences,120000.0,USA,1,1,0,16358,16358,0
Biotechnology,31000000.0,USA,1,2,0,13798,13798,1
Cloud Computing|Consumers|Enterprise Software|PaaS|SaaS|Software|Web Development|WebOS,13340000.0,SWE,2,1,1476,13585,15061,0
Mobile|Networking|Software,806018.0,CHN,2,1,301,16161,16462,0
Messaging|VoIP,32000000.0,GBR,3,8,2255,13627,15882,0
Manufacturing,19200000.0,USA,4,9,2546,13671,16217,0
Clinical Trials|Medical|Therapeutics,29123719.0,USA,6,1,1094,15278,16372,0
Biotechnology|Diagnostics|Fitness|Health and Wellness|Health Care|Health Diagnostics,146397292.0,USA,9,30,2842,12753,15595,1
Biotechnology,262500.0,USA,2,1,402,15391,15793,0
Developer Tools|Enterprise Software|Software,21500000.0,USA,2,1,738,15492,16230,0
Android|App Marketing|Mobile,500000.0,CHE,1,1,0,15201,15201,0
Semiconductors,75000000.0,USA,5,20,2494,11611,14105,1
Networking|Semiconductors|Services,12500000.0,USA,1,3,0,12251,12251,0
Enterprise Software,6000000.0,USA,1,4,0,13040,13040,0
Medical Devices,34000000.0,CHE,1,3,0,16406,16406,0
Semiconductors,6000000.0,CHE,1,4,0,11621,11621,0
Entrepreneur|Finance,400000.0,GBR,1,1,0,15510,15510,0
Biotechnology|Health Care,36097653.0,USA,4,3,2076,13811,15887,1
Games,7081383.03670139,AUT,2,2,523,14055,14578,0
Enterprise Search|Enterprise Software|Productivity Software|SaaS|Search|Semantic Search,28000.0,USA,1,1,0,16120,16120,0
Analytics|Enterprises|Logistics|SaaS|Shipping,8514280.0,NOR,3,8,665,15806,16471,0
Biotechnology,10000000.0,GBR,1,1,0,16101,16101,0
Biotechnology,36300000.0,USA,2,8,432,16030,16462,0
Bio-Pharm|Biotechnology,22000000.0,USA,1,1,0,12243,12243,1
Biotechnology,32500000.0,NOR,5,7,2499,12222,14721,0
B2B|Information Services|Software,27509998.0,USA,2,1,535,14963,15498,0
Curated Web|Social Media,3000000.0,USA,1,1,0,14579,14579,0
Biotechnology,100900000.0,USA,4,5,3826,11839,15665,1
Software,38000000.0,USA,3,11,656,12796,13452,0
Biotechnology,19051289.0,GBR,2,5,2632,12305,14937,0
Health and Wellness,49085376.0,GBR,4,4,503,15944,16447,0
Health Care Information Technology|Medical|Services,2286492.41900736,GBR,1,1,0,16682,16682,0
Biotechnology,21700000.0,USA,5,2,1479,14963,16442,0
Accounting|Banking|Billing|Business Services|Collaboration|CRM|Finance|Personal Finance|SaaS|Software,374995300.0,NZL,8,16,4796,11694,16490,1
Hardware + Software,5000000.0,USA,1,2,0,13189,13189,0
Analytics|Cloud Computing|Databases|Virtualization,46800000.0,USA,6,15,2769,12859,15628,0
Health and Wellness|Internet of Things|Smart Building|Technology,719427.0,BEL,2,1,961,15727,16688,0
Service Providers,20000000.0,USA,1,3,0,11246,11246,0
Clean Technology,12500000.0,USA,5,8,1107,15503,16610,0
Computers|Entertainment|Games|Networking,12000000.0,USA,4,6,2953,12528,15481,1
Mobile|Telecommunications,1633333.0,USA,2,1,2045,14594,16639,1
Automotive|Services,40000.0,USA,1,1,0,16246,16246,0
Analytics,3750000.0,USA,1,1,0,14797,14797,1
Biotechnology,21160182.0,USA,3,1,188,16085,16273,0
Apps|Mobile|Retail|Shopping,1009404.20803575,PRT,2,3,348,16119,16467,0
Communities|Cooking|Recipes|Shared Services,30000000.0,CHN,1,4,0,16632,16632,0
Mobile|Web Development,1221900.0,IRL,1,2,0,12645,12645,1
Software,5054368.0,CHN,2,5,181,15645,15826,0
Algorithms|Curated Web|Music|Music Services,20292825.0,CHN,3,3,1675,14031,15706,0
Biotechnology,1208468.0,CHN,1,1,0,12570,12570,0
Semiconductors,10000000.0,CHN,1,3,0,13787,13787,0
Automotive,12578616.0,CHN,1,1,0,15279,15279,0
Mobile,10000000.0,CHN,2,2,549,14669,15218,0
Health and Wellness|Manufacturing,40000000.0,CHN,2,2,31,14669,14700,0
Bridging Online and Offline|Location Based Services|Marketplaces|Mobile Shopping,17500000.0,CHN,2,2,342,16253,16595,0
Consumer Electronics|Mobile,1447000000.0,CHN,6,14,1608,14944,16552,0
Mobile,162954.0,CHN,1,1,0,16130,16130,0
Photography,815037.0,CHN,2,2,142,16019,16161,0
Real Estate,86600853.0,CHN,4,7,949,15675,16624,0
Enterprise Software|SaaS|Software,2000000.0,USA,1,4,0,13402,13402,1
Technology|Web Hosting,476000.0,ESP,1,1,0,12969,12969,0
Biotechnology,41000000.0,CHE,2,4,1536,13032,14568,0
FinTech,16394816.0,USA,3,3,669,14561,15230,0
Games|Language Learning|Networking|Photography|Private Social Networking|Real Time|Search,1000000.0,CHE,1,1,0,14635,14635,0
Business Services|Local Commerce|Loyalty Programs|Mobile|Mobile Commerce|Mobile Payments|Point of Sale|Promotional|SaaS|Sales and Marketing|Small and Medium Businesses,150000.0,USA,1,1,0,15659,15659,0
Semiconductors,960000.0,USA,1,1,0,13844,13844,0
Mobile,11500000.0,CHN,1,3,0,16212,16212,0
Internet|Web Development|Web Tools,176000.0,USA,1,1,0,16495,16495,0
Business Services|Contact Management|Networking|Social Media,6844560.0,DEU,2,2,549,12539,13088,1
Apps|Mobile|Mobile Health,32000000.0,CHN,1,2,0,16632,16632,0
Education|Training|Tutoring,32400000.0,CHN,2,3,601,15706,16307,0
Media,20000000.0,HKG,1,3,0,12368,12368,0
Travel,23000000.0,CHN,1,1,0,15236,15236,0
Medical Devices,100000000.0,CHN,1,1,0,16342,16342,0
Mobile|Network Security|Security|Software,1130130.0,IRL,1,2,0,15484,15484,0
Software,1647446.0,CHN,1,1,0,16102,16102,0
Web Hosting,50000000.0,USA,2,2,659,13845,14504,0
E-Commerce,10000000.0,CHN,1,1,0,15614,15614,0
Drones|Mobile,1500000.0,CAN,1,1,0,16127,16127,0
Cloud Management|Mobile,112724312.0,USA,7,17,3329,13178,16507,0
Early-Stage Technology|Enterprise Hardware|Flash Storage,173000.0,USA,3,3,505,16135,16640,0
E-Commerce|Fashion,150000000.0,CHN,3,5,1539,15034,16573,0
Real Estate|Retail|Small and Medium Businesses,20000.0,IND,1,4,0,15961,15961,0
Embedded Hardware and Software,89948.0,DEU,1,1,0,16010,16010,0
Software,11035000.0,USA,3,5,1182,13088,14270,0
Public Relations,1480000.0,FRA,1,2,0,13879,13879,1
Clean Technology,21900000.0,USA,4,2,1687,14988,16675,0
Hardware + Software,27388500.0,BEL,1,1,0,15187,15187,0
Software,6788572.0,USA,5,3,2601,13888,16489,0
Health Care,46922681.0,USA,5,10,1296,14746,16042,0
Electronics|Health Diagnostics,3000000.0,CAN,1,1,0,16218,16218,0
Classifieds|Marketplaces|Real Estate,950000.0,BRA,1,3,0,16266,16266,0
Business Services|Enterprise Software,7500000.0,USA,2,1,0,13746,13746,0
Semiconductors,57390000.0,GBR,4,12,2862,13410,16272,0
Software,9000000.0,USA,3,3,1887,11474,13361,1
E-Commerce,23572551.0,USA,1,2,0,15492,15492,0
Biotechnology,11000000.0,GBR,1,1,0,15873,15873,0
Software,41752000.0,USA,8,29,2097,13300,15397,1
Big Data Analytics,5363323.0,USA,2,1,1137,15522,16659,0
Construction|Enterprise Software|Logistics|Manufacturing|Wearables,3400000.0,USA,2,6,142,16412,16554,0
Electronics|Medical Devices|Technology,100496138.0,USA,6,15,3845,10957,14802,1
Clean Technology,50000000.0,USA,1,1,0,14995,14995,0
Public Transportation,153450218.0,USA,2,2,812,13782,14594,0
B2B|SaaS|Software,1800000.0,USA,1,10,0,16071,16071,0
Manufacturing|Mechanical Solutions|Technology,8800000.0,USA,1,1,0,16744,16744,0
Heavy Industry|Industrial Automation|Internet of Things|SaaS,70000.0,USA,1,1,0,16010,16010,0
E-Commerce|Finance|Financial Services|P2P Money Transfer,93029000.0,USA,4,21,1982,13318,15300,1
Consulting,8000000.0,USA,1,3,0,13682,13682,0
Curated Web|Email|Photo Sharing|Search|Social Network Media,6500000.0,USA,2,14,488,13483,13971,1
Information Services,6000000.0,USA,2,6,224,16456,16680,0
Enterprise Software|Gps|Mobile,23500000.0,USA,4,5,3025,11443,14468,1
Advertising|Content|Digital Media|Software,71524785.0,USA,12,10,3491,12734,16225,0
Data Security,9000000.0,USA,1,1,0,12606,12606,1
Peer-to-Peer|Real Estate|Rental Housing,1402469.0,FRA,1,2,0,16504,16504,0
Cloud Infrastructure|Enterprise Software|Mobile,8000000.0,USA,1,1,0,15897,15897,0
Finance,58000000.0,BRA,1,1,0,14939,14939,0
Games,2000000.0,CHN,1,2,0,14062,14062,1
Financial Services,43000000.0,USA,1,6,0,11122,11122,1
Software,620441.0,USA,1,1,0,14880,14880,1
Business Productivity|SaaS|Software,9516719.0,BEL,3,4,1652,15068,16720,0
Information Technology,1250000.0,CAN,1,1,0,16563,16563,0
Computers|Security|Software,20000.0,USA,1,1,0,16251,16251,0
Big Data|Big Data Analytics|Business Intelligence|Cloud Computing|Data Integration|Enterprise Software|SaaS|Software,3000000.0,ISR,2,2,857,15506,16363,0
Technology,57000000.0,USA,3,12,2278,11323,13601,0
Business Services|Sales Automation|Technology,15500000.0,USA,1,3,0,11332,11332,0
E-Commerce|Information Services|Information Technology|Logistics,1117558.0,IRL,3,2,486,15949,16435,0
Clean Technology,40000.0,USA,2,5,28,15744,15772,0
Biotechnology,11000000.0,USA,2,1,51,13529,13580,1
Semiconductors|Technology,383850.0,ESP,1,1,0,14300,14300,0
Semiconductors,4000000.0,KOR,1,3,0,14211,14211,0
Fleet Management|Software|Tracking|Transportation,33010002.0,USA,2,2,233,14363,14596,1
Semiconductors,550000.0,IND,2,1,24,16053,16077,0
Finance|Financial Services|Risk Management,3250000.0,USA,1,1,0,11660,11660,1
B2B|Marketplaces|Online Auctions|Textiles,450000.0,IND,1,1,0,16695,16695,0
Hardware + Software,18000000.0,USA,2,2,838,14160,14998,0
Hardware + Software,16300000.0,USA,2,6,2219,11746,13965,1
Medical Devices,40200000.0,USA,2,4,641,12204,12845,1
Hardware + Software,153764344.0,USA,6,5,4399,12283,16682,0
Enterprise Software,2000000.0,USA,1,1,0,12821,12821,0
Android|App Marketing|Location Based Services|Mobile,6586383.0,USA,3,4,1162,14215,15377,0
Analytics|CRM|Software,28400000.0,USA,2,6,4700,10957,15657,1
Cloud Management|Enterprise Software,15500000.0,USA,3,1,747,15240,15987,0
Apps|SaaS|Travel & Tourism,817449.0,PRT,1,1,0,16262,16262,0
Advertising,5479600.0,FIN,1,2,0,14027,14027,1
Clean Technology|Energy,52750000.0,USA,7,8,2520,13514,16034,0
Enterprise Software|Storage,25000000.0,USA,3,6,754,14559,15313,1
Finance|FinTech,1130000.0,USA,1,1,0,13642,13642,0
Diagnostics|Health Diagnostics|Medical|Pharmaceuticals,26000000.0,USA,2,5,188,16409,16597,0
Mobile|Navigation|Robotics,20000.0,RUS,1,1,0,15414,15414,0
Application Platforms|Media|Mobile|Video Streaming,2000000.0,USA,2,2,271,15994,16265,0
Mobile,5000000.0,CHN,1,1,0,16130,16130,0
Customer Service|Education,20000000.0,CHN,1,1,0,13939,13939,1
Education,40000000.0,CHN,1,1,0,14495,14495,0
Education,20000000.0,CHN,1,2,0,16454,16454,0
Chat|iPhone|Messaging|Mobile|Networking,12800000.0,USA,3,5,1001,13129,14130,1
Clean Technology,40000000.0,USA,3,8,414,13706,14120,0
Enterprise Software,3000000.0,USA,1,1,0,13091,13091,0
Local Search|Mobile Payments,1400000.0,USA,1,1,0,15949,15949,0
Journalism|News|Social Media|Social Network Media,1250000.0,USA,1,1,0,15133,15133,0
Education|Music,273453.0,USA,1,1,0,16252,16252,0
Information Services|Information Technology|Services|Technology,35000000.0,USA,2,4,175,10848,11023,1
Biotechnology,24500000.0,USA,1,4,0,13157,13157,0
Fashion|Online Shopping,1200000.0,JPN,1,3,0,16700,16700,0
Consulting|Finance|Startups|Venture Capital,10250000.0,USA,2,6,431,14319,14750,0
Health and Wellness,7519068.0,USA,2,1,389,15955,16344,0
Advertising|App Marketing|Audio|Content|Digital Media|Mobile|Video,150000.0,USA,1,1,0,15857,15857,0
Advertising|Analytics,4300000.0,ISR,2,3,306,13239,13545,1
Emerging Markets,15200000.0,USA,1,4,0,11485,11485,1
Email|Internet|Photography|Portals|Search|Technology,6800000.0,USA,2,4,243,9221,9464,1
Automotive|Discounts|Marketplaces,3925845.0,FRA,1,1,0,14944,14944,0
Classifieds|Local|Search|Social Media,641000.0,FRA,1,1,0,13306,13306,0
EdTech|Education,2450000.0,RUS,2,5,263,15849,16112,0
Productivity Software,500002.0,USA,3,1,1183,15374,16557,0
Apps|Mobile,6300000.0,ISR,2,4,247,16504,16751,0
Software,500000.0,USA,1,1,0,15035,15035,0
Curated Web|Education,700000.0,USA,2,5,266,14692,14958,0
Enterprises|Enterprise Software|Networking|Social Media|Twitter Applications|Web Development,142000000.0,USA,5,27,1136,14263,15399,1
E-Commerce|Hospitality|Hotels|Travel,4500000.0,PRT,2,3,996,15593,16589,0
Automotive|Energy|Transportation,2700000.0,USA,2,2,453,16219,16672,0
Productivity Software|Project Management,130855.0,BGR,3,3,307,16098,16405,0
Big Data Analytics|Cloud-Based Music|E-Commerce|Email|Information Technology|Mobile Search|Mobile Software Tools|Portals|Search|Software,5300000.0,RUS,1,3,0,11048,11048,1
Online Travel|Resorts|Travel & Tourism,611631.0,DNK,1,1,0,16472,16472,0
Automotive|Cars,75000000.0,CHN,3,3,232,16391,16623,0
Financial Services|FinTech,8000000.0,USA,1,1,0,15177,15177,0
Curated Web,17700000.0,CHN,1,3,0,13963,13963,0
Data Mining|E-Commerce|Internet Technology|Product Search,2700000.0,EGY,2,1,1003,15706,16709,0
Audio|Messaging|Mobile|Speech Recognition|Telecommunications|Telephony,12000000.0,USA,4,11,1357,13532,14889,0
Celebrity|Entertainment|Mobile|Music|News|Photo Sharing|Social Media|Sports|Video,2300000.0,USA,3,3,719,15492,16211,0
Enterprise Software|Social Business|Social Media|Social Network Media,3500000.0,USA,1,1,0,15262,15262,0
Mobile,1000000.0,USA,2,3,141,15294,15435,0
Cloud Computing|E-Commerce|Events|Sponsorship,284655.0,LUX,1,1,0,16483,16483,0
Apps|Guides|Navigation|Travel & Tourism,100000.0,ISR,1,1,0,16587,16587,0
Finance|Finance Technology|Financial Services|FinTech|Mobile Payments|Payments,113400000.0,USA,3,4,2056,14469,16525,0
Tracking|Transportation|Travel,26556563.0,USA,12,12,2950,13695,16645,0
Curated Web|Networking,200000.0,USA,1,1,0,14853,14853,0
Collaborative Consumption|Enterprise Software|Peer-to-Peer,1600000.0,USA,2,8,646,15916,16562,0
Curated Web,8134000.0,USA,4,18,877,13618,14495,1
Curated Web,5750000.0,USA,2,3,266,14669,14935,0
Software,25000.0,USA,1,1,0,16202,16202,1
Automotive,11502019.0,GBR,2,2,522,15568,16090,0
Advertising|Local|Local Search|Mobile|Search,4601314.0,USA,3,11,1285,14911,16196,0
Advertising|Curated Web|Video,7250000.0,USA,4,3,1369,14960,16329,1
Events|Mobile|Networking|Social Media,435000.0,USA,4,3,1116,14507,15623,0
Apps|Broadcasting|Mobile|Music,144814.0,FRA,1,1,0,15156,15156,0
Project Management|Software|Tracking,690000.0,NOR,3,4,771,14013,14784,0
Search|Semantic Search,1602720.0,FRA,1,1,0,15431,15431,0
Communities|Local|Social Media|Social Network Media,330000.0,USA,2,2,285,14822,15107,0
Travel,104500000.0,IND,6,10,3389,13159,16548,0
Biotechnology,38040000.0,USA,5,9,1732,13465,15197,0
Software,1569037.0,CHN,2,1,275,15034,15309,0
Hardware + Software,4143045.0,KOR,3,1,921,15750,16671,0
Advertising,103000000.0,IND,3,5,1140,13852,14992,0
Curated Web,1750000.0,USA,2,4,170,15356,15526,0
Digital Media|Digital Signage|Software,41500000.0,USA,5,12,2048,13226,15274,0
Analytics|Finance|Financial Services|Investment Management|Stock Exchanges|Visualization,14650000.0,USA,4,19,1886,14687,16573,0
Business Services|Internet|Online Scheduling,25000.0,RUS,1,1,0,15720,15720,0
Advertising|Internet Marketing|Real Time,5918360.0,GBR,2,3,2050,13914,15964,0
E-Commerce|Software,374967.0,KOR,1,1,0,16121,16121,0
Enterprises|Software,1163755.0,CHN,2,2,109,16010,16119,0
Education,610000.0,USA,6,6,1826,14426,16252,0
Transportation,25000.0,CHL,1,2,0,16422,16422,0
Fashion|Gift Card|Home & Garden|Jewelry|Mobile|Online Shopping|Shoes|Sports,40180000.0,IND,4,10,1210,14610,15820,0
Media|Social Media,2500000.0,ISR,2,1,337,13208,13545,1
Startups,377200.0,CAN,1,1,0,16332,16332,0
Babies|Baby Accessories|Parenting,100000000.0,CHN,1,1,0,15340,15340,0
Home Automation,25000.0,CHN,4,3,957,15722,16679,0
Software,6300000.0,CHN,2,3,512,13019,13531,0
Finance|FinTech,8350000.0,CHN,4,5,3910,12600,16510,0
Android|Apps|Crowdfunding|Crowdsourcing|iOS|Marketplaces|Mobile,345000.0,ESP,3,1,581,15671,16252,0
Health Care,5000000.0,CHN,1,1,0,15765,15765,0
Enterprises|Enterprise Software,4970000.0,CHN,2,3,396,14975,15371,0
Distribution|Entertainment|Film|Games|Video,3000000.0,USA,1,4,0,15834,15834,0
Apps|Databases|Information Technology|Services,11000000.0,RUS,1,2,0,16239,16239,0
Blogging Platforms|Social Media|Social Network Media,91900.0,AUS,1,1,0,15857,15857,0
Career Management|CRM|QR Codes|Recruiting|SaaS|Social Recruiting|Software,11000000.0,USA,2,2,347,16395,16742,0
Mobile,100000000.0,KOR,1,1,0,16384,16384,0
Games,13596.0,IND,1,1,0,15737,15737,0
Location Based Services|Search,2000.0,POL,1,2,0,10575,10575,0
Location Based Services|Mobile Social|Parenting|Social Media,150000.0,USA,1,1,0,15097,15097,0
E-Commerce,3216500.0,FRA,2,2,2371,13776,16147,0
Financial Services|Mobile Payments,39000000.0,USA,3,7,1559,14909,16468,0
Crowdsourcing|E-Commerce|Jewelry,850000.0,USA,1,10,0,15572,15572,1
Energy|Renewable Energies|Solar,4500000.0,USA,2,3,934,15599,16533,0
Customer Service|Reviews and Recommendations|Search,56000000.0,USA,5,5,2036,12600,14636,1
E-Commerce|Hospitality|Service Providers,44000000.0,TUR,2,2,227,15600,15827,1
Curated Web|Facebook Applications|iPhone|Location Based Services|Photo Sharing|Social Media|Twitter Applications,14450.0,ITA,1,1,0,15079,15079,0
Brand Marketing|Online Shopping|Product Design,88200000.0,IND,3,6,502,16192,16694,0
Apps|Social Media,34517.0,DEU,1,1,0,16153,16153,0
Software|Technology,981217.0,ESP,1,1,0,15902,15902,0
Collaborative Consumption|E-Commerce|Marketplaces,5500000.0,USA,2,7,239,15944,16183,0
Banking,200000000.0,IND,1,1,0,16427,16427,0
Q&A|Social Network Media,1000000.0,ISR,1,1,0,16556,16556,0
Mobile Commerce|Restaurants,317000.0,NLD,3,1,138,15992,16130,0
Analytics|Developer APIs|Enterprise Software,2300000.0,USA,2,12,646,15847,16493,0
E-Commerce,34000000.0,CHN,2,3,426,14669,15095,0
Local Based Services|Peer-to-Peer|Social Media|Trading,30000.0,USA,1,1,0,15126,15126,0
Curated Web,1000000.0,USA,1,4,0,14398,14398,0
Curated Web|Video,31361000.0,USA,7,3,4383,11139,15522,0
CRM|Email|Enterprise Software|Mobile|Productivity Software|Sales and Marketing,33000000.0,USA,5,20,1353,15244,16597,0
Analytics|Big Data|Internet|Internet of Things,1300000.0,USA,1,3,0,16757,16757,0
E-Commerce|Fashion,6000000.0,CHN,2,3,160,16266,16426,0
Advertising|Big Data Analytics|Consumer Behavior,1000000.0,USA,1,1,0,15857,15857,0
Search,12000000.0,CHN,1,2,0,14202,14202,0
Advertising|Cloud Data Services|Local|Mobile|SaaS|Sales and Marketing|Software,115750000.0,USA,6,20,2772,13453,16225,0
Application Platforms|Social Media|Sports,20000.0,USA,1,1,0,16671,16671,0
Big Data|Location Based Services|Retail,1190476.0,SGP,1,2,0,15420,15420,0
Entertainment,80000000.0,KOR,1,1,0,16303,16303,0
Public Relations,5000000.0,USA,1,2,0,12251,12251,0
Enterprise Software|Machine Learning|Predictive Analytics,2620000.0,USA,3,21,606,15979,16585,0
Apps|Events|Mobile,19000000.0,CHN,1,2,0,16700,16700,0
Finance,1246804.0,CHN,1,3,0,13239,13239,0
Enterprises|Enterprise Software,20000000.0,CHN,2,3,549,14669,15218,0
Android|Internet|Mobile|Social Network Media|Software,60000.0,CHN,1,1,0,15143,15143,0
Mobile,13000000.0,CHN,2,1,485,12784,13269,0
Content Discovery|Entertainment|Guides|Internet TV|Search|Television|Video,350000.0,USA,1,5,0,14560,14560,0
Optimization|Semantic Search|SEO|Software,6000000.0,USA,1,2,0,14034,14034,1
Advertising|Analytics|Optimization|Publishing|Real Time,28400000.0,USA,4,23,1282,14944,16226,0
Advertising|Web Tools,18500000.0,USA,3,9,952,14293,15245,1
Algorithms|Analytics|Software,11500000.0,GBR,2,4,540,16071,16611,0
Advertising,1700000.0,USA,2,12,510,15715,16225,0
Advertising|Mobile,22099999.0,USA,4,14,783,15582,16365,0
Communities|Curated Web|Employer Benefits Programs|Gift Card|Local|Mobile Shopping|Social Media|Trading,4000000.0,USA,2,7,386,15712,16098,0
Apps|Identity|Local|Social Media,73500000.0,USA,3,16,216,16182,16398,0
Automotive|Service Providers,12000000.0,CHN,1,1,0,16494,16494,0
Art|Artists Globally|Entertainment Industry,34644.0,COL,1,1,0,15224,15224,0
Financial Services|Investment Management|Risk Management,10000000.0,CHN,2,2,1,16289,16290,0
Algorithms|Curated Web|Restaurants|Reviews and Recommendations|Sales and Marketing|Shopping,7550000.0,USA,3,19,440,14706,15146,0
Advertising|Email Marketing|Internet Marketing|Semantic Search|SEO|Web Design,2000000.0,USA,1,1,0,13514,13514,0
Curated Web|E-Commerce|Online Shopping|Price Comparison,698963.0,NLD,2,1,702,15991,16693,0
Search,2000000.0,USA,1,1,0,15404,15404,0
Fashion|Media|Social Media,1991250.0,FRA,1,2,0,14365,14365,0
Digital Media|Information Technology|Services,15336992.0,FRA,2,2,1941,14153,16094,1
E-Commerce,110799000.0,JPN,3,1,1852,14610,16462,0
Design,40000.0,CHL,1,1,0,15839,15839,0
Apps|Communications Infrastructure|Messaging,1500000.0,USA,1,6,0,16266,16266,0
Fashion,25000.0,ARG,1,1,0,15340,15340,0
Application Platforms|Human Resources|Recruiting,175060.0,SWE,1,1,0,16643,16643,0
Curated Web|Mobile Devices,1350000.0,USA,1,10,0,15056,15056,1
E-Commerce,813646.0,ESP,2,5,406,15763,16169,0
Advertising|Email Marketing|Internet Marketing|Local Advertising|Local Search|Marketing Automation|Reviews and Recommendations|SEO|Small and Medium Businesses|Social Media Marketing,40000002.0,USA,5,12,2310,13453,15763,0
Finance,124309780.0,USA,4,7,2141,13328,15469,1
Advertising|All Markets|English-Speaking|Games,18000000.0,CHN,3,7,709,15340,16049,0
Travel,4000000.0,CHN,1,1,0,16020,16020,0
Exercise|Health and Wellness,13000000.0,USA,1,1,0,13756,13756,1
Fitness|Freemium|Health and Wellness|Marketplaces|Social Media,640000.0,THA,3,5,44,16244,16288,0
Hardware + Software,2800000.0,ISR,2,3,256,13279,13535,1
Mobile,1000000.0,USA,1,2,0,15428,15428,0
Semiconductors,2723900.0,ITA,2,3,2308,12943,15251,0
Education|Games|High Schools|Kids,30000.0,USA,1,2,0,15262,15262,0
Entertainment|Game|Social Media,3000000.0,IDN,1,2,0,16659,16659,0
Consumer Goods|Entertainment|Restaurants,115190.0,USA,1,2,0,16521,16521,0
3D|Curated Web|Games|Social Network Media|Software|Virtual Currency|Virtual Worlds,5000000.0,TUR,1,1,0,13879,13879,0
E-Commerce,30000000.0,CHN,3,7,2669,13422,16091,0
E-Commerce|Shopping,40000000.0,CHN,3,4,945,15126,16071,0
Enterprise Software|Human Resource Automation|SaaS,1500000.0,USA,1,4,0,15857,15857,0
Information Technology|Services,1496000.0,USA,1,1,0,15340,15340,0
Fashion,15000000.0,CHN,4,11,2702,13361,16063,0
Messaging,100000.0,USA,1,1,0,16059,16059,0
Banking|Internet|Wealth Management,3918297.0,FRA,1,1,0,16595,16595,0
Adventure Travel|Apps|Game,2000000.0,USA,1,2,0,16583,16583,0
E-Commerce,790000000.0,CHN,6,7,1998,14730,16728,0
Mobile|Social Media,185000.0,USA,5,3,275,14700,14975,0
Facebook Applications|Networking|Social Games|Social Media,12500000.0,USA,1,2,0,13908,13908,0
Fitness|Health and Wellness,3630000.0,FIN,2,5,318,16349,16667,0
Banking|Credit|Investment Management,20000000.0,CHN,2,2,534,15706,16240,0
Enterprise 2.0|Information Services|Social Bookmarking|Social Media,779850.0,FRA,1,1,0,14036,14036,0
Games,1077500.0,USA,3,4,261,15497,15758,0
Games,197597.0,DEU,1,1,0,14916,14916,0
Social Media,5450000.0,USA,2,2,639,13361,14000,0
Curated Web,241061.0,FRA,1,2,0,15166,15166,0
Travel,2000000.0,CHN,1,1,0,16010,16010,0
Fashion,5800000.0,USA,4,4,2070,10957,13027,1
Cloud Computing|File Sharing|Web Hosting,40000.0,CHL,1,1,0,16222,16222,0
Games,600000.0,USA,1,1,0,15706,15706,0
Curated Web,25000.0,ARG,1,1,0,15218,15218,0
Mobile,13000000.0,USA,3,3,1917,13517,15434,0
Mobile,932782.0,GBR,1,1,0,14867,14867,0
Public Relations,38880.0,CAN,1,1,0,14902,14902,1
Hardware + Software,100000000.0,RUS,1,1,0,16731,16731,0
E-Commerce|Reviews and Recommendations|Social Commerce,28000000.0,ISR,5,27,1527,15082,16609,0
Application Performance Monitoring|Content Delivery|Enterprise Software|Optimization,39445469.0,USA,4,8,1583,14852,16435,0
Software,42000000.0,USA,3,11,1483,14084,15567,0
Data Visualization,40648791.0,CAN,2,11,1280,11198,12478,0
Active Lifestyle|Apps|Consumers|Content|Health and Wellness|Mobile,550000.0,FIN,1,1,0,16443,16443,0
Advertising|Android|Apps|Artificial Intelligence|Big Data|Content|Ediscovery|iOS|Machine Learning|Mobile|Publishing,5000000.0,USA,3,4,842,15523,16365,0
Games,1150000.0,USA,2,7,389,14457,14846,0
Consumer Goods|Gambling|Games|Mobile Games|Social Media,5125000.0,USA,3,4,507,15887,16394,0
E-Books|Internet|Printing|Publishing|SaaS|Search|Software,150000.0,CHE,1,3,0,14202,14202,0
Curated Web,1415260.0,FRA,1,1,0,15972,15972,0
Media|News|Publishing,51126.0,BRA,1,1,0,15461,15461,0
Analytics|Business Intelligence|Gadget|Graphics|Music|Visualization|Web Development|Web Tools,3840000.0,DNK,3,2,1675,12204,13879,1
Automotive|Cars|Retail|Utility Land Vehicles,10000000.0,CHN,1,1,0,16258,16258,0
Micro-Enterprises|Recruiting|Small and Medium Businesses,447037.0,SWE,1,1,0,16107,16107,0
Marketplaces,1025000.0,RUS,2,2,215,15765,15980,0
B2B|E-Commerce|Marketplaces|Retail|Supply Chain Management,54589.0,ITA,1,1,0,16520,16520,0
Employer Benefits Programs|Human Resources|SaaS|Software,1500000.0,USA,1,2,0,16204,16204,0
Big Data Analytics|Business Intelligence|Consulting|Consumer Behavior|Curated Web|Enterprise Software|Machine Learning|Market Research|Optimization|Quantitative Marketing|SaaS|Usability,8764000.0,USA,5,9,1418,15095,16513,0
Collaboration|Enterprise Software|Networking,268000.0,ISR,1,1,0,13879,13879,0
Consumers|E-Commerce|Events|Facebook Applications|Gift Card|Psychology|Social Media,1200000.0,USA,1,1,0,15421,15421,0
Real Estate,150000.0,USA,1,2,0,15039,15039,0
Social Media,1000000.0,CHN,1,1,0,16010,16010,0
Broadcasting|Photography|Technology,1320000000.0,CHN,6,19,2980,13208,16188,1
Marketplaces|Music|Social Media,1100000.0,ISR,3,4,578,13757,14335,0
Identity|Social Media|Social Network Media,310000.0,TUR,1,1,0,15431,15431,0
Curated Web|News,1000000.0,FRA,1,1,0,15034,15034,0
Communications Infrastructure|Email|Enterprise Software|Messaging|Telecommunications,19925000.0,USA,9,7,2888,13609,16497,0
Developer APIs|Mobile|Online Travel|Transportation,1074524.0,ITA,5,9,1018,15667,16685,0
Customer Service|Industrial,10000000.0,USA,1,1,0,12096,12096,0
Education|Edutainment|K-12 Education,35000.0,IND,1,1,0,16222,16222,0
Corporate IT|Innovation Management,1100000.0,USA,1,4,0,16130,16130,0
Broadcasting|Games|Social Media|Video Streaming,26000000.0,USA,3,6,765,15918,16683,0
Photography|Social Media,984736.0,SWE,3,6,868,15645,16513,0
Direct Sales|Sales and Marketing,7000000.0,SWE,2,5,442,16237,16679,0
Fitness|Health and Wellness|Healthcare Services,400000.0,IND,1,4,0,16743,16743,0
Clean Technology,53030000.0,GBR,1,1,0,14091,14091,0
mHealth,7300000.0,NOR,3,1,637,15980,16617,0
Online Shopping,500000.0,AUS,1,2,0,16412,16412,0
Automotive|Curated Web,1800000.0,USA,3,15,1633,14851,16484,0
Internet|Media|News|Public Relations|Publishing,4000000.0,IND,1,4,0,16664,16664,0
Software,712000.0,DEU,1,1,0,15068,15068,0
E-Commerce,17666667.0,USA,3,3,652,15910,16562,0
E-Commerce,2592330.0,FRA,1,3,0,15671,15671,0
E-Commerce|Internet|Portals|Shipping,40968.0,IRL,1,1,0,16045,16045,0
Comparison Shopping|E-Commerce|Price Comparison|Product Search|Social Buying|Startups,100000.0,IND,1,1,0,16413,16413,0
All Students|Colleges|Curated Web|Education|Entrepreneur|Startups|Training,50000.0,USA,1,1,0,14610,14610,0
Career Management|Colleges|Education|Employment|Freelancers|Marketplaces|Testing,500000.0,IND,1,2,0,16413,16413,0
Social Media Marketing,600000.0,IND,1,1,0,16685,16685,0
Consulting|Internet Marketing|Nonprofits|SEO,1500000.0,USA,1,3,0,13324,13324,0
Entertainment|Games|Online Rental|Video,11500000.0,USA,2,3,151,13088,13239,1
Consulting|Finance|Incubators,2000000.0,USA,1,6,0,15209,15209,0
Mobile,17647446.0,CHN,2,1,392,16071,16463,0
Auctions|E-Commerce|Online Auctions|Service Providers,460000000.0,CHN,3,9,716,15796,16512,0
Mobile,1500000.0,USA,1,1,0,15369,15369,0
Advertising,40000000.0,CHN,4,7,1813,14664,16477,0
Loyalty Programs|Mobile|Mobile Payments|Retail,24010983.0,GBR,4,9,594,15946,16540,0
Software,1300000.0,SGP,1,3,0,16211,16211,0
Mobile,7000000.0,USA,2,9,1033,15611,16644,0
Entertainment|iPhone|Mobile|Mobile Commerce|Startups|Ticketing,37700000.0,GBR,3,23,877,15522,16399,0
Restaurants,66500000.0,CHN,4,11,1694,14610,16304,0
Brand Marketing|E-Commerce|Fashion|Social Media,50000.0,USA,1,1,0,15340,15340,0
Technology,5582184.0,FRA,1,1,0,16702,16702,0
Software,32640.0,CHN,1,1,0,11231,11231,0
E-Commerce,21321218.0,CHN,2,3,1887,12904,14791,0
EdTech|Education,84200000.0,CHN,4,9,971,15553,16524,0
E-Commerce,12000000.0,USA,1,9,0,16028,16028,1
Public Transportation,664000.0,FRA,1,2,0,14973,14973,0
Bridging Online and Offline|Social Network Media,3000000.0,CHN,1,1,0,16300,16300,0
Food Processing,15000000.0,IND,1,1,0,16745,16745,0
Clean Technology,15000000.0,USA,1,1,0,15049,15049,0
Advertising,75816240.0,USA,9,28,2122,13361,15483,1
Food Processing,1000000.0,IND,1,1,0,16465,16465,0
File Sharing|Restaurants|Social Media,111365.0,CHL,2,1,365,14619,14984,0
Cooking|Recipes|Social Media,50000.0,USA,1,1,0,15065,15065,0
Android|Content Discovery|Cooking|Developer APIs|Ediscovery|Fitness|Groceries|Health and Wellness|Hospitality|iOS|Mobile|Mobile Commerce|Personalization|Recipes|Semantic Search,24158698.0,USA,5,11,1828,14851,16679,0
Biotechnology|Events|Nutrition,10000.0,CZE,1,1,0,15775,15775,0
Food Processing,20000000.0,CHN,1,2,0,16209,16209,0
Curated Web,2894000.0,ESP,1,1,0,15076,15076,1
Drones|Technology,60000000.0,USA,1,1,0,16673,16673,0
E-Commerce,1600000.0,CHN,1,6,0,16720,16720,0
Apps|Logistics Company|Transportation,5000000.0,CHN,2,2,137,16431,16568,0
Tea,7227332.0,CHN,1,2,0,13695,13695,0
Storage|Web Hosting,1472100.0,BEL,1,1,0,13879,13879,0
Video Games,1587301.0,CHN,1,1,0,15340,15340,0
Apps|Games|Startups,40000.0,BRA,1,1,0,15380,15380,0
Facebook Applications|Media|Networking|Photography|Printing|Publishing|Social Media,36154.0,MEX,1,1,0,14989,14989,0
Games|Television,7500000.0,USA,2,1,533,16166,16699,0
Audio|Hardware + Software|Music|Sports,10158510.0,USA,4,1,1186,14732,15918,1
Apps|Crowdsourcing|Services,20000.0,USA,1,1,0,16169,16169,0
Games,250000.0,USA,2,1,315,15400,15715,0
Advertising|E-Commerce|Games|Mobile|Mobile Payments,21055586.0,SGP,1,1,0,16685,16685,0
Mobile,7413509.0,CHN,1,1,0,16102,16102,0
Design|Electronics|Manufacturing,2778844.0,CAN,4,4,746,15855,16601,0
Finance|FinTech,5000000.0,HKG,1,1,0,15765,15765,0
Games,6499999.0,USA,3,4,910,14153,15063,1
Finance|Incubators|Internet|Mobile|Software|Startups|Training,7500000.0,USA,3,1,919,15522,16441,0
Android|Databases|E-Commerce|iPhone|Marketplaces|Mobile|Proximity Internet|Startups,15150000.0,USA,2,14,229,15042,15271,0
Curated Web|Local Search|Professional Services|Service Providers,2175449.0,PRT,2,4,579,15857,16436,0
Fashion,15000000.0,USA,1,1,0,16084,16084,0
Cloud Computing|Cloud Data Services|Software,20000000.0,USA,2,3,380,15537,15917,0
Software,3200000.0,USA,1,6,0,15057,15057,0
E-Commerce|Fashion|Supply Chain Management,1350000.0,USA,1,3,0,15765,15765,0
Biotechnology,155180000.0,USA,7,16,2775,13402,16177,1
Banking|Finance Technology|FinTech|Software,20000000.0,CAN,2,3,293,16051,16344,0
Ad Targeting|Analytics|Big Data|Fashion|SaaS,4100000.0,USA,1,2,0,13735,13735,0
Technology,13500000.0,USA,1,1,0,13782,13782,0
E-Commerce,100000.0,GBR,1,1,0,15012,15012,0
FinTech|Public Transportation|Transportation,7163000.0,USA,9,30,1827,14791,16618,0
Health and Wellness,19275000.0,CHE,1,1,0,14866,14866,0
Cloud Data Services|Hotels|Mobile|Software,175000.0,USA,2,1,81,16202,16283,0
Advertising|Digital Media|Real Time,6300000.0,USA,1,1,0,16231,16231,0
Delivery|E-Commerce|Groceries|Retail,2500000.0,UKR,1,2,0,16332,16332,0
Internet,350000.0,IND,1,1,0,16706,16706,0
Biotechnology|Health Care,78500000.0,USA,3,7,3466,11688,15154,1
E-Commerce|Fashion,212000000.0,SGP,3,9,434,15608,16042,0
Internet|Storage|Technology,52600000.0,USA,1,10,0,11631,11631,0
Real Estate,9000000.0,PAK,3,3,1143,15564,16707,0
Communities|Consumer Goods|Distributors,20000.0,ZMB,1,1,0,16495,16495,0
Enterprise Software,20000000.0,CHN,1,2,0,15796,15796,0
Health and Wellness,1000000.0,USA,1,1,0,14935,14935,1
Finance|FinTech,19109869.0,USA,6,6,1879,14836,16715,0
E-Commerce,25700000.0,ZAF,1,1,0,15646,15646,0
Employer Benefits Programs|Health and Insurance|Health Care|Health Care Information Technology|Human Resource Automation|Human Resources|Insurance|Software|Technology,1500000.0,USA,1,2,0,16595,16595,0
Online Dating,200000.0,RUS,1,1,0,16322,16322,0
Internet|Mobile|Software|Video Streaming|VoIP|Wireless,1500000.0,SGP,1,1,0,16130,16130,0
Games|Video,40000000.0,USA,2,1,822,12478,13300,0
Photography,1500000.0,USA,1,3,0,14610,14610,0
Finance|FinTech|Investment Management,503733.0,ESP,2,2,591,15949,16540,0
Messaging|Social Network Media,16000000.0,USA,2,5,607,13425,14032,1
Archiving|Information Services|Risk Management,20000000.0,USA,1,5,0,12423,12423,0
Social Media|Social Recruiting,1300000.0,USA,1,2,0,15519,15519,1
Automotive,25000000.0,USA,1,1,0,14466,14466,0
Analytics|Big Data|Curated Web|Loyalty Programs|Mobile|Trading,850000.0,PHL,3,4,1109,15614,16723,0
Cloud Data Services|Mobile|Web Development,6962500.0,IRL,2,2,18,14410,14428,0
Logistics|Real Time|SaaS|Software|Storage,356406.691958235,AUS,2,4,349,16146,16495,0
Cloud Computing|Data Integration|SaaS|Software,1200000.0,USA,3,5,164,15480,15644,0
Security,5515489.0,SWE,2,2,1016,15279,16295,0
Mobile|Mobile Payments|NFC|QR Codes,576456.0,GBR,1,1,0,15363,15363,0
Mobile|Mobile Commerce|Mobile Payments|Mobile Shopping|Networking|Price Comparison|Shopping|Social Buying,500000.0,USA,1,5,0,14942,14942,1
Curated Web,62750000.0,USA,8,11,2496,10592,13088,1
Cloud Computing|Collaboration|Ediscovery|Productivity Software|SaaS|Software,16550000.0,USA,3,7,2162,14306,16468,0
Health Care,7600000.0,USA,3,11,574,15953,16527,0
Cloud Computing|Cloud Data Services|Data Integration|SaaS,2100000.0,USA,2,3,376,16191,16567,0
EdTech|Education|K-12 Education|Training|Video,1500000.0,USA,1,4,0,16574,16574,0
File Sharing|Peer-to-Peer|Wireless,20000000.0,CHN,1,1,0,16225,16225,0
E-Commerce,24636630.0,USA,5,1,1678,14469,16147,0
Cloud Computing|Employment|Human Resources|Marketplaces|Recruiting|Small and Medium Businesses|Social Recruiting|Software,392504.0,IRL,1,3,0,15322,15322,0
Customer Service|Local Based Services|Loyalty Programs,95000.0,BRA,3,1,167,16055,16222,0
Games|Online Gaming,25500000.0,GBR,3,4,927,14519,15446,0
Analytics|Big Data|Machine Learning|Mobile|Opinions|Semantic Web|Social Television|Software,1000000.0,ARG,1,1,0,15454,15454,0
Curated Web,15036298.0,USA,4,3,1552,13392,14944,1
Advertising|Social Media,2419014.0,JPN,3,2,1368,15229,16597,0
Delivery|Groceries|Online Shopping,2500000.0,USA,1,3,0,16314,16314,0
Data Centers|Internet|Mobile|Mobile Infrastructure|Telecommunications,310000000.0,USA,2,8,78,13755,13833,1
Local Businesses,20000.0,USA,1,1,0,16468,16468,0
Online Rental|Property Management|Real Estate,55000.0,USA,2,3,122,15949,16071,0
Music,3100000.0,ISR,3,2,635,15293,15928,0
Small and Medium Businesses|Software,150000.0,USA,1,1,0,14549,14549,0
E-Commerce,46000000.0,USA,2,4,822,12965,13787,0
Software,10130000.0,GBR,2,10,333,13057,13390,0
E-Commerce,80000000.0,CHN,3,3,1369,13665,15034,0
Consumer Goods|Hardware + Software|Sporting Goods,40000.0,USA,2,2,561,15446,16007,0
Games,1256139.0,USA,2,11,651,14805,15456,0
Clean Technology|Renewable Energies,24600000.0,USA,3,3,940,13710,14650,0
Clean Technology,44000000.0,USA,2,6,799,14585,15384,0
Biotechnology|Incubators|Renewable Energies|Technology,3800000.0,USA,1,4,0,15790,15790,0
Health Diagnostics|Software,1540000.0,SWE,1,3,0,13221,13221,0
News,314795.0,CHN,1,1,0,15522,15522,0
Recruiting|Small and Medium Businesses,96984.0,GBR,4,2,175,15868,16043,0
Business Services|Digital Media|Media,36530105.0,USA,4,5,225,16398,16623,0
Pharmaceuticals,3000000.0,USA,1,1,0,16344,16344,0
E-Commerce,10871040.0,BEL,1,1,0,14616,14616,0
Finance,55000000.0,GBR,2,5,410,15484,15894,0
Internet|Online Shopping|Payments,10000000.0,USA,1,4,0,16734,16734,0
Games,24469821.0,USA,5,4,4074,12557,16631,0
Computer Vision|Human Computer Interaction|Medical,8000000.0,ISR,1,3,0,16531,16531,0
Brokers|Finance|Stock Exchanges|Trading,35000000.0,USA,3,8,669,13149,13818,0
Document Management|File Sharing|Storage|Web Hosting,2515000.0,USA,3,5,927,13665,14592,1
Design|Lifestyle Products|Pets,1000000.0,BRA,1,1,0,15475,15475,0
Consumer Electronics|Education|Emerging Markets,25000000.0,USA,2,1,459,14756,15215,0
E-Commerce|Mobile Commerce,3000000.0,ISR,1,4,0,16573,16573,0
Health and Wellness|Mobile,3200000.0,USA,3,18,1024,15348,16372,0
Apps|Education|Internet,6800000.0,USA,2,2,304,16405,16709,0
Entertainment,1000000.0,IDN,1,2,0,16538,16538,0
Game|Games|Mobile Games,305000.0,PHL,3,2,2129,14126,16255,0
Hardware + Software,3800000.0,USA,1,3,0,16175,16175,0
Advertising|Technology,3000000.0,USA,1,1,0,16469,16469,0
Semiconductors|Software|Wireless,20000000.0,USA,1,6,0,12376,12376,1
Social Media,1000000.0,FRA,1,1,0,13879,13879,0
Enterprise Software|Entertainment|Film|Internet|Video,60062378.0,USA,7,27,1576,14551,16127,0
Games|Mobile,250000.0,USA,1,3,0,15553,15553,0
Software,6847759.94995528,CAN,2,6,922,12795,13717,0
Biotechnology,10746748.0,USA,4,4,2507,12696,15203,0
Biotechnology,70424200.0,USA,3,7,948,13815,14763,1
Advertising|Blogging Platforms|Browser Extensions|Information Services|Information Technology|Internet|Semantic Web|Software|Web Browsers,8950000.0,USA,6,12,2257,13757,16014,0
Billing|E-Commerce,11150000.0,USA,3,1,764,15236,16000,0
Human Resources|Software,2620000.0,USA,3,6,113,16267,16380,0
Medical,120000.0,USA,1,1,0,16267,16267,0
Energy,200000.0,IND,1,3,0,16618,16618,0
E-Commerce|Mobile|Retail,1045958.0,POL,2,1,2,16314,16316,0
Coupons|Delivery|Online Shopping,50000.0,JPN,1,1,0,16556,16556,0
Audio|Cloud Computing|Data Security|SaaS|Software|Video|Web Development,2000000.0,USA,2,17,435,14641,15076,1
Cloud Computing|Mobile|PaaS|SaaS|Services|Software,51000000.0,USA,6,18,3627,12618,16245,1
Events|Mobile|Online Scheduling|Productivity Software|Task Management,260000.0,FRA,1,4,0,15779,15779,0
Customer Service|Customer Support Tools|Enterprise Software|SaaS|Tech Field Support,85500000.0,USA,6,17,2157,14048,16205,1
Automotive,1500000.0,USA,2,10,454,15946,16400,0
Cosmetic Surgery|Dental|Health and Wellness|Healthcare Services,1250000.0,USA,2,5,151,16071,16222,0
Cloud Computing|Cyber Security|Enterprise Software|Network Security,7500000.0,USA,2,4,407,16352,16759,0
Enterprise Software|Health and Insurance|Human Resources,583600000.0,USA,4,35,649,15912,16561,0
Health Care|Medical Devices,120000.0,USA,1,4,0,16405,16405,0
Games|Video Games,310000.0,USA,1,3,0,16696,16696,0
Browser Extensions|Privacy|Security|Software,3265007.0,DEU,3,9,518,15826,16344,0
IT Management,40000.0,CAN,1,1,0,16222,16222,0
Property Management,614000.0,IND,1,2,0,16729,16729,0
Games,588174854.0,USA,9,6,2811,13787,16598,0
Software,1000000.0,USA,1,1,0,14721,14721,0
Enterprises|Minerals|Oil & Gas,100000000.0,GBR,1,1,0,16668,16668,0
Health and Wellness,52000000.0,USA,3,3,860,14071,14931,0
Big Data,25107.0,NLD,1,1,0,16375,16375,0
Games,5240000.0,FRA,2,3,843,12784,13627,0
Corporate IT|Enterprise Software|Information Technology|IT Management,45632042.0,USA,4,13,2251,13371,15622,0
Lifestyle,500000.0,IND,1,1,0,16580,16580,0
Financial Services|Personal Finance|Software,86100000.0,USA,4,39,1160,15371,16531,0
Curated Web,1065294.0,USA,3,4,514,15521,16035,0
Apps|Music|Music Services,10806952.0,USA,2,2,487,14561,15048,0
Mobile|Mobile Devices|Mobile Security|Mobility,64630000.0,USA,6,22,2400,12940,15340,1
Enterprise Purchasing|Enterprise Software|SaaS,30000.0,USA,1,1,0,16314,16314,0
Manufacturing,17021128.0,FIN,2,3,278,15323,15601,0
Beauty|Health and Wellness|Internet|Online Reservations,429564.0,FRA,1,2,0,15949,15949,1
Classifieds|E-Commerce|Internet|Small and Medium Businesses|Stock Exchanges|Web Design,35792.0,GBR,2,3,406,16114,16520,0
SaaS|Tourism|Travel|Web CMS,74447.0,ITA,2,2,111,15979,16090,0
Contact Management|Networking|Web Hosting,250000.0,USA,1,3,0,14123,14123,0
Cloud Computing|Service Providers|Technology,4900000.0,USA,1,1,0,16590,16590,0
Curated Web|Ticketing,106327.0,FRA,1,2,0,14400,14400,0
Analytics|E-Commerce|Enterprise Software|Media|Online Video Advertising|SaaS|Sales and Marketing|Software|Video,3388436.0,USA,2,2,721,15340,16061,0
Enterprise Software|Information Technology|Software|Technology,1000000.0,ESP,1,1,0,15310,15310,0
Semiconductors,112254773.0,USA,9,27,2500,13549,16049,1
Browser Extensions|Mobile,12000000.0,USA,1,2,0,13599,13599,0
Analytics,27138500.0,USA,6,6,870,14593,15463,0
Health Care Information Technology,21500000.0,USA,1,3,0,15952,15952,0
Advertising|Big Data|Mobile,7700000.0,DEU,2,7,252,16399,16651,0
Clean Technology|Renewable Energies|Solar,10571182.0,USA,1,1,0,16029,16029,1
Advertising|Mobile Advertising,350000.0,USA,2,1,162,16429,16591,0
Big Data Analytics|Health Care|Information Technology|Life Sciences|Software,33477051.0,USA,3,6,960,15706,16666,0
Biotechnology,13304965.0,USA,3,4,1401,14432,15833,0
Biotechnology|Hardware|Health Care|Medical Devices,1860000.0,USA,2,8,0,16323,16323,0
Developer Tools|SaaS|Software|User Experience Design,1320000.0,USA,2,3,127,16636,16763,0
Hardware + Software|Sports,15000000.0,USA,1,3,0,16092,16092,0
Analytics|Business Intelligence|Cloud Computing|Finance|FinTech|Mobile|SaaS|Web Development,118000.0,USA,1,1,0,15553,15553,0
Restaurants,77000.0,IND,1,1,0,16717,16717,0
Biotechnology|Health Care|Medical,8323094.0,CHE,1,2,0,11380,11380,0
Content Discovery,4200000.0,USA,2,5,753,15626,16379,0
Mobile,2324998.0,USA,3,1,1575,14720,16295,0
Agriculture|Carbon|Sustainability,959269.0,GBR,1,2,0,16071,16071,0
Consumer Electronics|Fitness|iPad|iPhone|Small and Medium Businesses|Tablets,1000000.0,USA,1,1,0,15653,15653,0
Service Providers|Services|Startups,865288.0,AUS,1,1,0,16394,16394,0
Software,20000.0,USA,1,1,0,15709,15709,0
Automotive|Electric Vehicles,63659978.0,USA,11,6,2374,13979,16353,0
Alumni,41250.0,HKG,1,1,0,16648,16648,0
Hospitality|Internet|Restaurants|Small and Medium Businesses,1500000.0,USA,1,15,0,15196,15196,0
Cloud Computing|Cloud Management|Technology,3000000.0,USA,2,1,432,15340,15772,0
Security,40200000.0,USA,3,17,877,15895,16772,0
Hardware + Software,30000000.0,USA,2,7,483,13670,14153,1
Email|Information Technology|Messaging,40000.0,AUS,2,2,943,15279,16222,0
Finance|Financial Services|Small and Medium Businesses|Software,200000.0,BRA,2,1,334,15492,15826,1
Clean Technology,4620000.0,USA,2,1,446,13784,14230,0
Cloud Computing|Software|Virtualization,21600000.0,USA,2,3,55,16673,16728,0
Software,11000000.0,EST,4,6,1443,15180,16623,0
Cloud Computing|Enterprise Software|Finance|IaaS|PaaS|SaaS|Software|Virtualization,1538000.0,USA,2,1,106,15719,15825,1
Creative|Curated Web|Entertainment Industry|Personal Branding|Recruiting,700000.0,USA,4,5,1370,14791,16161,0
3D Printing|Manufacturing|Marketplaces,40000.0,USA,1,1,0,15887,15887,0
Enterprise Software,60000000.0,USA,5,11,1668,14571,16239,0
Billing|Finance|Freelancers|Internet|Sales and Marketing|Small and Medium Businesses|Software,4468243.0,FIN,4,1,1826,14672,16498,0
E-Commerce,20482500.0,USA,2,3,1915,14469,16384,0
Blogging Platforms|Monetization|Social Media|Specialty Foods,25000.0,USA,1,1,0,16405,16405,0
Health and Wellness,6000000.0,USA,1,6,0,16651,16651,0
Analytics|Big Data|Finance Technology|FinTech|Machine Learning,282000000.0,USA,5,23,1538,15176,16714,0
Leisure|Marketplaces|Travel,100000.0,USA,1,1,0,16718,16718,0
Curated Web|Health Care|Healthcare Services|Online Reservations,9200000.0,GBR,4,11,981,15584,16565,0
Enterprises|Enterprise Software|SaaS,375000.0,USA,1,3,0,16467,16467,0
Health and Wellness|Logistics|Organic Food|Specialty Foods,23264207.0,USA,2,42,360,16266,16626,0
Software,12000.0,USA,3,3,1048,14883,15931,0
Advertising,195000000.0,USA,2,4,1113,15518,16631,0
Web Hosting,13500000.0,USA,1,2,0,12913,12913,0
Advertising|Media|Publishing,1289641.0,DNK,2,3,105,16590,16695,0
Clean Technology IT|Hardware + Software|Product Design,38843.0,IRL,1,1,0,15340,15340,0
Biotechnology,12849998.0,USA,8,7,1960,14743,16703,0
Cloud Computing|Cloud Data Services|Enterprise Software|Service Providers,42700000.0,USA,5,13,2504,14120,16624,0
Design|Manufacturing|Semiconductors,19200000.0,USA,2,15,785,11457,12242,1
Semiconductors,38500000.0,USA,2,11,1938,12437,14375,0
Software,28828327.0,USA,6,16,2185,14425,16610,0
Curated Web,11373300.0,MLT,1,1,0,14799,14799,0
Web Hosting,31500000.0,CAN,2,13,472,13848,14320,0
Software,10855911.000825,GBR,2,4,1205,11645,12850,1
3D Printing|3D Technology|Creative Industries,178716.0,ESP,2,2,123,16191,16314,0
Automated Kiosk|Internet|Software,12500.0,HKG,1,1,0,16252,16252,0
Big Data Analytics|Sales and Marketing|Software,700000.0,USA,2,2,308,15628,15936,0
Application Platforms|Online Identity|Services,35000000.0,CHN,1,4,0,16693,16693,0
Education|Training,89000000.0,CHN,2,3,238,16526,16764,0
Social Media,13000000.0,CHN,2,4,396,13330,13726,0
E-Commerce,37194503.0,CHN,3,9,700,15340,16040,0
Curated Web|Internet,110000000.0,CHN,1,2,0,14073,14073,0
Marketplaces,20000000.0,CHN,1,4,0,16468,16468,0
E-Commerce,1629549.0,CHN,1,1,0,16130,16130,0
Finance,814774.0,CHN,1,1,0,16130,16130,0
Semiconductors,4294788.0,CHN,1,1,0,15918,15918,0
EdTech|Education|Mobile,10000000.0,CHN,1,1,0,16133,16133,0
Health Care,11700.0,TWN,1,1,0,15946,15946,0
Business Services|Legal|Services,3700000.0,CHN,2,2,324,16222,16546,0
Social Media,85000000.0,CHN,3,10,1465,15279,16744,0
Automotive,29030000.0,CHN,1,1,0,14798,14798,1
Consulting,4500000.0,CHN,2,2,1096,10592,11688,0
Photography,240727.0,CHN,2,2,90,15706,15796,0
EdTech|Education,36000000.0,CHN,2,3,610,13300,13910,0
Technology,13856209.0,CHN,1,1,0,13665,13665,0
Search,2000000.0,CHN,2,1,518,12478,12996,0
E-Commerce,32292287.0,CHN,2,3,608,14914,15522,0
E-Commerce,321239.0,CHN,2,1,487,15400,15887,0
Adventure Travel|Online Reservations|Travel,98000000.0,CHN,3,3,471,16236,16707,0
Biotechnology,1762820.0,CHN,2,2,1216,14549,15765,0
Hospitality,304259.0,CHN,1,1,0,15034,15034,0
Software,1623640.0,CHN,1,1,0,15796,15796,0
Manufacturing,5400000.0,USA,1,2,0,12115,12115,0
Biotechnology,40601832.0,USA,2,5,741,15643,16384,0
Biotechnology,8885317.0,GBR,2,3,589,15649,16238,0
Apps|EdTech|Education|Technology,265064.0,ESP,1,1,0,15867,15867,0
Health and Wellness|Health Care Information Technology|Healthcare Services,2400000.0,IND,1,1,0,16342,16342,0
Advertising|SaaS|Sales and Marketing,20879593.0,USA,5,5,1835,14852,16687,0
Enterprise Software|Information Security,35300000.0,USA,3,5,1462,15169,16631,0
Apps|Mobile|Peer-to-Peer|Ride Sharing|Transportation,230000.0,IND,2,5,298,16422,16720,0
Property Management|Real Estate|Search|Startups,18000000.0,KOR,1,2,0,16476,16476,0
Big Data|Big Data Analytics|Business Intelligence|Financial Services|Governments|Predictive Analytics|Public Relations|Real Time|Social Media Monitoring|Sports,29900000.0,USA,4,8,1381,15347,16728,0
Finance|Web Development,3690250.0,IRL,1,3,0,13848,13848,0
CRM|E-Commerce,318000.0,USA,3,1,810,15833,16643,0
Semiconductors,8000000.0,ISR,1,3,0,14228,14228,0
Biotechnology|Health Diagnostics,1546558.0,GBR,1,2,0,15512,15512,0
Marketplaces,1880000.0,SGP,1,4,0,16748,16748,0
Semiconductors,27000000.0,USA,3,8,903,12885,13788,0
Analytics|Big Data|Cloud Infrastructure|Developer Tools,1500000.0,USA,2,8,411,15450,15861,0
Enterprise Software|Optimization|Software,49600000.0,USA,5,23,2835,11974,14809,0
Games|Television,22899998.0,USA,3,3,750,13914,14664,0
Business Services|Marketplaces|Real Estate,96627980.0,USA,5,7,2629,13057,15686,1
Collaboration|Email|Productivity Software|Software|Web Development,14500000.0,USA,1,9,0,13239,13239,1
Home Decor|Home Renovation|Online Scheduling|Plumbers,2400000.0,IND,2,3,30,16615,16645,0
Apps|Enterprises|Mobile|Mobile Security,20000000.0,USA,2,9,513,15979,16492,0
SaaS|Software,600000.0,USA,1,2,0,15337,15337,0
Consumer Electronics|Cooking|Hardware + Software|Health and Wellness|Product Design,18500000.0,SGP,3,4,1692,14944,16636,0
Public Transportation,15000000.0,USA,1,1,0,15735,15735,1
Curated Web,1100000.0,RUS,3,1,295,14711,15006,0
Curated Web|Health Care|Mobile|Software,833170.0,IRL,1,3,0,15799,15799,0
Apps|Colleges|Curated Web,5486842.0,USA,3,3,689,13848,14537,1
Games|Music,26000000.0,USA,2,6,31,13483,13514,1
Customer Service|E-Commerce|Messaging|Telecommunications|VoIP,1150000.0,USA,1,1,0,15273,15273,0
Leisure|Music|Music Services,1500000.0,USA,1,4,0,16416,16416,0
Enterprise Software,13000000.0,USA,1,3,0,13161,13161,0
Finance|Personal Finance|Stock Exchanges|Visualization,15000.0,USA,1,2,0,15826,15826,0
Curated Web,1000000.0,USA,1,1,0,13307,13307,1
Digital Media|News|Publishing,35400000.0,USA,3,8,3347,11954,15301,0
Hardware + Software,35000000.0,USA,1,1,0,15314,15314,0
Internet|Logistics|Marketplaces|Supply Chain Management,6000000.0,IND,1,2,0,16611,16611,0
Marketing Automation|Social + Mobile + Local|Software,720496.0,IRL,1,1,0,16133,16133,0
Mobile,21331144.0,GBR,3,4,1671,12998,14669,1
Games,1300000.0,COL,1,1,0,15029,15029,0
Security,25000.0,USA,1,1,0,14426,14426,0
Software,535000.0,USA,2,3,216,16331,16547,0
Public Transportation,60704370.0,USA,4,6,2917,12041,14958,1
Medical,2600000.0,USA,2,13,124,16632,16756,0
E-Commerce,657000.0,USA,2,1,878,15832,16710,0
Mobile,22583151.0,USA,11,36,2568,13719,16287,0
Games,2000000.0,USA,1,2,0,15527,15527,0
Health Care,16000000.0,USA,4,10,1764,14599,16363,0
Android|Cooking|Curated Web|Ediscovery|iPhone|Productivity Software|Recipes|Startups|Weddings,4500000.0,USA,2,4,327,14610,14937,1
Advertising|Business Services|Internet Marketing|Local Search|Search,14003543.0,CAN,2,2,273,13422,13695,1
Software,2200000.0,USA,1,7,0,16147,16147,0
Billing|Collectibles|Finance|FinTech|Mobile|Payments|Peer-to-Peer,3500000.0,USA,3,13,658,15321,15979,0
E-Commerce|Enterprise Software|Logistics|Mobile|Postal and Courier Services|Retail,2250000.0,USA,3,9,916,15048,15964,1
Financial Services,101000000.0,AUS,2,1,0,16757,16757,0
Curated Web|Health and Wellness|Health Care|Health Care Information Technology|Medical|mHealth,1700000.0,USA,2,1,1705,14690,16395,0
Apps|Employment|Health and Wellness|Health Care|Human Resources|Mobile|Personalization,10028000.0,USA,6,9,1371,15056,16427,0
Utilities,982000.0,IND,1,1,0,16352,16352,0
Delivery|Services|Storage,25000000.0,USA,1,1,0,16591,16591,0
Finance|FinTech|Real Estate,8000000.0,USA,1,4,0,11484,11484,1
Employment|Human Resources|Recruiting|Social Recruiting,63000000.0,USA,1,3,0,16308,16308,0
Advertising|Internet|Mobile|Restaurants|Sales and Marketing|Social Media|Tablets,8750000.0,USA,4,4,1787,14975,16762,0
Consulting|Finance|FinTech|Freelancers|Outsourcing,118000.0,USA,3,3,840,15719,16559,0
Semiconductors,12000000.0,USA,4,11,1847,13006,14853,1
Cloud Computing|Messaging,8100000.0,USA,2,1,1397,15065,16462,0
Financial Services|Mobile|P2P Money Transfer|Payments,3800000.0,USA,3,16,1486,14756,16242,0
Collaborative Consumption|E-Commerce|Professional Services|Virtual Workforces,5463475.0,USA,4,12,918,15719,16637,1
Cars|Parking,36400000.0,USA,3,9,362,16318,16680,0
Mobile,1700000.0,IND,1,1,0,13586,13586,0
Fashion|Internet|Lingerie,49000000.0,IND,3,11,1268,15413,16681,0
Art|Content|Fashion|Photography|Social Media|Social Network Media|Women,8000000.0,USA,2,6,220,13726,13946,0
Enterprise Software,4000000.0,USA,1,1,0,15075,15075,0
Big Data Analytics|Bitcoin,100606.107673245,ITA,1,1,0,16769,16769,0
Leisure|Travel|Travel & Tourism,271028.0,ESP,2,2,156,16082,16238,0
Boating Industry|Marketplaces|Sailing Community|Vacation Rentals,853578.0,AUT,2,1,181,16314,16495,0
Apps|Mobile|Mobile Software Tools,1500000.0,GBR,1,1,0,13879,13879,0
Internet,3500000.0,USA,1,1,0,15932,15932,0
B2B|Financial Services|FinTech|SaaS|Security|Software,450000.0,USA,1,3,0,15492,15492,0
E-Commerce,4000000.0,FRA,1,1,0,13695,13695,0
Brand Marketing|Content Creators|Content Delivery|Enterprise Software|Media|Publishing|Software,18549997.0,USA,6,7,2063,14028,16091,1
Software,13000000.0,USA,2,6,871,12784,13655,1
3D Printing,1000080.0,POL,2,2,836,15803,16639,0
Advertising,2000000.0,SWE,1,7,0,14488,14488,0
E-Commerce|Online Shopping|Software|Web Development,1700000.0,USA,1,2,0,14154,14154,1
Hospitality|Hotels,47000000.0,IND,2,4,15,16636,16651,0
Dental|Doctors|Health and Wellness|Health Care,223000000.0,USA,4,13,2558,14109,16667,0
Health Care,1000000.0,IND,2,3,109,16534,16643,0
Local Search|Reviews and Recommendations|Search,1600500.0,THA,2,10,852,15187,16039,0
Biotechnology|Health Care,167062156.0,USA,6,20,1415,13388,14803,1
Curated Web,48600.0,CAN,1,1,0,14902,14902,1
Analytics|Data Mining|Mobile,2388400.0,FIN,1,1,0,14768,14768,1
Curated Web,210000.0,USA,1,1,0,15126,15126,0
E-Commerce,15849999.0,USA,3,6,737,16014,16751,0
E-Commerce,5500000.0,USA,1,11,0,15980,15980,0
Communications Hardware|Embedded Hardware and Software|Internet of Things|Wireless,322689.0,ESP,2,2,0,16534,16534,0
Curated Web,900000.0,ISR,1,1,0,15887,15887,0
Manufacturing,19000008.0,USA,3,8,1533,12979,14512,0
Marketplaces|Services,553000.0,ARG,3,5,226,16191,16417,0
Content Discovery|Hospitality|Local Search|Restaurants,223800000.0,IND,8,14,1863,14822,16685,0
Health Care,109693276.0,USA,5,17,2330,12601,14931,1
Task Management|Tracking,50000000.0,USA,1,1,0,16624,16624,0
E-Commerce,1200000.0,USA,1,1,0,13514,13514,0
Security,988435.306909163,GBR,1,1,0,16758,16758,0
Delivery|Services|Television,3076837.66050215,CAN,1,1,0,16755,16755,0
Mobile|Mobile Payments|Payments,15000000.0,CHE,1,1,0,14725,14725,1
Web Hosting,500000.0,USA,1,1,0,15050,15050,0
Home Automation|Software,35600000.0,USA,2,4,593,15814,16407,0
Curated Web,1517619.0,USA,4,4,757,15867,16624,0
Games,2600000.0,USA,1,1,0,14741,14741,0
Software,1000000.0,IND,2,2,460,16205,16665,0
E-Commerce|Education|Textbooks,2060000.0,AUS,3,4,669,15309,15978,0
Internet,8000000.0,USA,1,3,0,11344,11344,0
Advertising,30000000.0,USA,1,1,0,14304,14304,0
Web Hosting,1000000.0,USA,1,1,0,15442,15442,0
Collaboration|Enterprise Software,45500000.0,USA,4,22,1344,15126,16470,0
Logistics,850000.0,AUS,1,2,0,16615,16615,0
Curated Web,330000.0,LBN,3,6,1019,15536,16555,0
Automotive|Consumers|E-Commerce|Transportation,22200000.0,IND,5,21,828,15796,16624,0
Big Data Analytics|Data Visualization|Software,898628.0,LVA,2,2,551,15807,16358,0
Analytics|Big Data Analytics|Data Visualization,22200000.0,USA,3,26,692,15657,16349,0
Web Development,1300000.0,USA,1,2,0,16254,16254,0
Curated Web|E-Commerce|Photography,32350000.0,USA,6,9,2493,13818,16311,0
Big Data Analytics|Business Services|Contact Management|Databases|Data Integration|Lead Generation|Recruiting|Sales and Marketing|Search,7000000.0,USA,1,5,0,12600,12600,0
E-Commerce|Games,2475000.0,USA,2,4,4,16010,16014,0
Software,7130000.0,DNK,1,3,0,13866,13866,1
Internet,6000000.0,IND,2,3,202,16416,16618,0
Information Technology,100000.0,IND,1,1,0,16773,16773,0
Fleet Management|Mobile|Risk Management,3350000.0,USA,4,3,736,14304,15040,1
Real Estate,612533.107981647,AUT,2,6,605,16124,16729,0
Hardware + Software,87000000.0,USA,5,13,1640,12983,14623,0
Advertising|Digital Media|Entertainment|Games|Internet,88000.0,USA,1,1,0,15764,15764,0
FinTech|Mobile,4000000.0,ZAF,1,2,0,15401,15401,0
Curated Web,75000.0,USA,1,1,0,15707,15707,0
Curated Web|File Sharing|Photography,50000.0,USA,1,1,0,13180,13180,0
Property Management|Real Estate,13387373.8236279,GBR,3,6,1452,13514,14966,1
Advertising|Contests|Crowdsourcing|Design|Digital Media|Sales and Marketing|Video,3400000.0,USA,2,1,3009,13545,16554,0
E-Commerce|Social Commerce|Social Media Marketing|Software,20000.0,USA,2,2,337,15385,15722,0
Social Media,61600000.0,USA,6,14,1767,13573,15340,0
B2B|Social Media|Startups,110000.0,USA,1,1,0,16174,16174,0
Advertising|App Marketing|Mobile,59139710.0,USA,7,12,2815,13319,16134,1
Developer APIs|E-Commerce|Payments|Startups|Venture Capital,16500000.0,ISR,3,17,988,15279,16267,0
Finance|FinTech,56628771.0,GBR,6,14,3315,12784,16099,0
Software,450000.0,IND,1,2,0,16737,16737,0
Chat|E-Commerce|Messaging,392000.0,SGP,3,1,1130,13757,14887,1
Groceries|Logistics,10000000.0,IND,2,4,1563,14975,16538,0
Mobile,20000000.0,IND,1,2,0,16590,16590,0
Biotechnology,158688887.0,USA,9,11,2637,13832,16469,1
E-Commerce,1000000.0,IND,1,1,0,16203,16203,0
Electronics,11083197.0,SWE,1,1,0,16619,16619,0
Batteries|Email|Forums|Franchises|Hardware + Software|Legal|Mobile|Price Comparison|Reviews and Recommendations,73166307.0,USA,4,4,1729,13558,15287,0
Hardware|Internet|Manufacturing|Mobile|Sensors|Software|Wireless,147761.0,GBR,1,1,0,15979,15979,0
Advertising,650000.0,KOR,2,2,681,15218,15899,0
E-Commerce|Marketplaces|Online Rental|SaaS|Tourism|Travel & Tourism,44300000.0,USA,4,41,2525,14092,16617,0
Batteries|Clean Technology|Medical Devices,133437465.0,USA,8,3,3515,12703,16218,0
Games,4220018.0,USA,1,1,0,13848,13848,0
Electronics,2500000.0,ISR,2,3,365,14610,14975,0
Biotechnology,122987972.0,USA,5,16,1312,14957,16269,1
Cloud Computing|Cloud Security|Data Security|Email|Internet|Mobile|Security,148000000.0,USA,3,6,1118,15582,16700,0
Health Care|Medical|Medical Devices,250000.0,USA,1,1,0,16561,16561,0
Billing|Mobile Commerce|Wireless,4000000.0,USA,1,1,0,13717,13717,0
Advertising|Direct Marketing|Sales and Marketing|Social Media,12000000.0,USA,2,4,701,14207,14908,0
Hardware + Software,19869969.0,USA,4,9,1130,15461,16591,0
Consulting,3919186.37690815,GBR,1,1,0,13553,13553,0
Application Platforms|Entertainment|Games|Graphics|Online Gaming,132351.0,ITA,1,1,0,15912,15912,0
Hardware + Software,350000.0,USA,2,2,446,15422,15868,0
Human Resources|Mobile|Software,3200000.0,USA,1,3,0,16721,16721,0
Mobile,30000.0,USA,1,1,0,15522,15522,0
Mobile,4000000.0,USA,3,13,385,15847,16232,0
iPad|iPod Touch|Mobile|Nightclubs|Payments|Restaurants|Startups,80000.0,USA,3,1,427,15441,15868,0
Home Automation|Internet of Things|Mobile Software Tools|Technology,1650000.0,USA,4,14,955,15540,16495,0
Babies|E-Commerce|Flash Sales|Kids|Retail|Specialty Retail|Women,138600000.0,USA,4,6,1064,14595,15659,1
Chat|Entertainment|Interest Graph|Messaging,140000.0,IND,3,1,367,15798,16165,0
Curated Web|Internet,28300000.0,USA,4,6,1478,14053,15531,0
Advertising|Analytics|Apps|Ediscovery|Mobile|Promotional,500000.0,USA,1,1,0,15979,15979,0
Information Services|Location Based Services,7720000.0,USA,3,3,1333,14971,16304,0
Android|Apps|Identity|iOS|Messaging|Mobile|Social Media,50000.0,GBR,1,1,0,15482,15482,0
Mobile,12000000.0,USA,1,2,0,13640,13640,0
Online Rental|Real Estate|Rental Housing,14600000.0,USA,3,15,1121,15490,16611,0
Education,10000000.0,USA,1,2,0,11332,11332,0
Billing|SaaS|Software,242500000.0,USA,6,41,2554,13951,16505,0
Games|Mobile,700000.0,ARG,2,2,1369,15218,16587,0
Food Processing,2000000.0,IND,1,2,0,16716,16716,0
E-Commerce|Restaurants,1440000.0,USA,4,2,762,15659,16421,0
Health Care,11146457.0,USA,4,4,1157,15096,16253,0
Data Mining|Market Research|Search,25000.0,USA,1,1,0,16191,16191,0
E-Commerce|Furniture,1503926.0,GBR,1,1,0,15446,15446,0
Financial Services,4700000.0,JPN,2,3,400,16306,16706,0
Apps|Enterprise Software|Mobile,650000.0,USA,1,1,0,15689,15689,0
E-Commerce,1515151.0,CHN,1,1,0,14975,14975,0
Concerts|Curated Web|Entertainment|Events|Kids|Music|Nightlife|Restaurants|Social Media|Ticketing,55200000.0,USA,4,11,2186,13061,15247,1
3D|3D Printing|Content,5000000.0,USA,2,2,568,16071,16639,0
Music,20000000.0,RUS,2,1,1175,15126,16301,0
Messaging|Software,651000.0,DEU,1,1,0,13545,13545,0
Mobile,8500000.0,NOR,2,1,672,16049,16721,0
News,870000.0,USA,2,2,122,16040,16162,0
Mobile|Networking|Social Network Media,3845100.0,DNK,2,2,608,12784,13392,1
Health Care|Medical Devices,75750000.0,USA,8,11,2601,14158,16759,0
Design|Hardware + Software|Health and Wellness,3384225.0,FRA,4,1,2647,12784,15431,1
Hardware|Hardware + Software,12039999.0,USA,5,3,3153,13038,16191,0
Biotechnology,44000000.0,USA,2,11,531,16071,16602,0
Biotechnology,2257464.0,USA,3,2,1126,13514,14640,0
Biotechnology,64674400.0,CAN,7,5,2552,13941,16493,0
Crowdsourcing|Knowledge Management,198493.0,GBR,2,3,212,16102,16314,0
Cloud Computing|Enterprise 2.0|Enterprise Software|MicroBlogging|Social Business,3805520.0,ESP,2,4,304,15069,15373,1
Facebook Applications|Games|Networking|Technology,866550786.0,USA,9,31,1509,13514,15023,1
Biotechnology,25000000.0,USA,1,1,0,14861,14861,0
Software,14750000.0,GBR,4,6,858,15402,16260,0
Biotechnology,34275015.0,USA,4,3,1517,14638,16155,0
Cloud Computing|Mobile Advertising|Video|Video Streaming,3300000.0,USA,2,11,209,16526,16735,0
Public Transportation,2150000.0,USA,2,2,61,15912,15973,0
Biotechnology,15419877.0,MYS,4,4,1872,13879,15751,0
E-Commerce,1510500.0,USA,4,2,728,14903,15631,0
Biotechnology,8500000.0,USA,1,7,0,12768,12768,1
Biotechnology,2686600.0,AUT,1,1,0,15734,15734,0
Analytics|Android|Developer APIs|Education|Gamification|iOS,1120000.0,GBR,3,4,338,16153,16491,0
Enterprise Software,1587301.0,CHN,1,1,0,15431,15431,0
Advertising|Mobile|Web Development|Wireless,114304.0,HRV,4,3,851,15279,16130,0
Consumer Electronics|Internet of Things|Telecommunications,18192.0,USA,1,1,0,16436,16436,0
